account_id,age,login_attempts,failed_attempts,SuccessfulAttempts,under_threat
SBI90PGT6240208,69,30,28,2,1
SBI63MWQ8141277,89,16,9,7,1
SBI72EZI7874900,70,22,18,4,1
SBI07USO1120652,19,21,13,8,1
SBI78AGM7572143,19,29,24,5,1
SBI35USB2673484,81,24,21,3,1
SBI64FWO8336348,77,30,25,5,1
SBI85XBG9916104,93,30,19,11,1
SBI60YWT6079099,75,17,12,5,1
SBI78SOS7941362,66,28,27,1,1
SBI26KSK2828715,97,23,21,2,1
SBI29SBH9839907,64,26,25,1,1
SBI92LZL5247957,68,26,17,9,1
SBI49SOP3461664,72,29,22,7,1
SBI64EUT2559399,81,29,18,11,1
SBI82JFS5789386,68,24,21,3,1
SBI71HKE3318049,90,26,25,1,1
SBI72ZYN4896655,21,32,31,1,1
SBI92PPM2243205,77,28,24,4,1
SBI57DGD3985232,19,22,21,1,1
SBI28CZE1291856,88,30,20,10,1
SBI04BVE9145082,64,22,16,6,1
SBI90FQA9655756,98,31,23,8,1
SBI12PCQ9343395,67,31,26,5,1
SBI05QBB1478952,21,29,28,1,1
SBI18DZG0231638,19,24,21,3,1
SBI69XKP6845311,80,28,20,8,1
SBI03VVI1899364,95,21,19,2,1
SBI36LXW6043820,79,25,23,2,1
SBI73SWG2040007,70,22,12,10,1
SBI68WEH3247304,62,26,23,3,1
SBI70YTV1819918,82,9,6,3,1
SBI02BQY7468964,88,19,17,2,1
SBI01ASF4083867,18,32,28,4,1
SBI76IUK9897181,25,22,20,2,1
SBI75PJK0945263,25,23,22,1,1
SBI32GMM2723899,22,28,20,8,1
SBI65OUO5124898,24,24,14,10,1
SBI28KTK4424828,90,30,18,12,1
SBI77DGL1731939,89,24,20,4,1
SBI64WHH8635254,64,25,13,12,1
SBI02EFR6255737,95,19,18,1,1
SBI08AKP9078703,22,23,17,6,1
SBI02NLS2763846,96,21,13,8,1
SBI37QAV0515476,68,31,19,12,1
SBI72CUA7546343,69,21,12,9,1
SBI22CMW4676984,60,22,20,2,1
SBI71EQE4623877,76,28,15,13,1
SBI70GTR2936343,62,13,12,1,1
SBI36QBZ1731720,74,22,17,5,1
SBI14ALU2266881,23,28,17,11,1
SBI11KDL0352478,61,20,16,4,1
SBI24XGA5357673,92,26,14,12,1
SBI07NLP0182925,79,22,17,5,1
SBI58DHL1536908,18,25,19,6,1
SBI66DLR6821478,20,29,24,5,1
SBI12XSZ8403222,87,26,14,12,1
SBI42CGK0895013,79,29,24,5,1
SBI18LFJ6643738,96,21,15,6,1
SBI25YQU6399212,76,28,21,7,1
SBI81COS2073372,69,24,15,9,1
SBI18DCC1373513,79,31,27,4,1
SBI24GLR8915275,73,27,23,4,1
SBI13SWE4397578,19,28,25,3,1
SBI26KOW8421619,19,29,25,4,1
SBI14LSV9806470,61,26,20,6,1
SBI46CJG3825798,85,33,29,4,1
SBI68XQR5181228,92,18,17,1,1
SBI85HED8532310,87,24,13,11,1
SBI03RHE9278483,76,21,16,5,1
SBI59XIP8000528,97,19,11,8,1
SBI67YEB5591362,88,16,10,6,1
SBI54BDO2817562,69,30,16,14,1
SBI69PWL2421912,99,25,22,3,1
SBI55RAO2064260,67,32,17,15,1
SBI23GTR9988857,24,24,16,8,1
SBI20OTZ8960077,92,20,19,1,1
SBI63RXD7750822,89,14,11,3,1
SBI83NFB5528312,99,26,22,4,1
SBI52UUE7408403,83,17,11,6,1
SBI63JAX1828769,97,23,22,1,1
SBI55QVZ4496498,65,27,19,8,1
SBI29GJB2158916,25,33,18,15,1
SBI88GWO7251167,24,18,11,7,1
SBI83TSS3430811,65,18,16,2,1
SBI88TOJ8606103,76,30,18,12,1
SBI64KYZ0646996,71,22,15,7,1
SBI89LTC6929381,25,22,14,8,1
SBI83HWN2016675,81,27,22,5,1
SBI84JCB1565016,86,30,25,5,1
SBI70DTD4877994,78,21,16,5,1
SBI19PNU2855071,65,27,18,9,1
SBI56AVJ9325326,81,19,13,6,1
SBI87CPN7337426,23,23,21,2,1
SBI56UEG2483001,63,28,18,10,1
SBI94PSP9478455,70,20,17,3,1
SBI52WHH5348622,80,18,16,2,1
SBI47LKQ0505426,84,27,14,13,1
SBI64DMK0915717,64,23,16,7,1
SBI95OLA9462491,19,20,13,7,1
SBI72BYP8884048,60,36,29,7,1
SBI74DRQ3527961,65,27,23,4,1
SBI17KLZ4491167,24,29,25,4,1
SBI65DFN0470461,62,12,8,4,1
SBI52BXV7526562,25,29,20,9,1
SBI08CCM1768525,93,21,19,2,1
SBI24JPK7483279,80,34,30,4,1
SBI72HNA5207585,75,18,13,5,1
SBI16MKF8669634,79,25,13,12,1
SBI33SPK9077357,75,18,12,6,1
SBI84WYF5165333,66,31,28,3,1
SBI12HVR5393674,69,23,17,6,1
SBI80YES3318433,87,29,25,4,1
SBI19JUN7859488,70,21,19,2,1
SBI01TQR9820312,85,23,12,11,1
SBI28OER5418768,23,11,10,1,1
SBI90QJA7068796,64,25,23,2,1
SBI24CJB4700853,75,25,19,6,1
SBI47UFV4743815,18,25,22,3,1
SBI53ZGD7876987,75,27,23,4,1
SBI56TJA6117676,78,38,32,6,1
SBI76XDJ9994981,81,24,19,5,1
SBI23WEL3034138,80,18,10,8,1
SBI70AZJ2397697,86,27,20,7,1
SBI03HGY9397413,84,26,22,4,1
SBI82VGO8848343,95,13,8,5,1
SBI00PUK7006677,86,23,20,3,1
SBI89NRW9937719,64,20,12,8,1
SBI98RFH0035285,79,20,18,2,1
SBI30PMB0775059,65,36,22,14,1
SBI80YCN0749252,75,22,19,3,1
SBI67YPH5615425,86,27,22,5,1
SBI45CHE2545433,21,24,15,9,1
SBI33HMH7142886,97,16,12,4,1
SBI36DVG3931203,19,22,13,9,1
SBI09WAL1158242,67,22,18,4,1
SBI31ZBP4421696,78,24,13,11,1
SBI16JTY3672321,84,21,14,7,1
SBI03TTF8795311,91,25,16,9,1
SBI89QJH3135667,61,19,17,2,1
SBI04NYL7478358,63,21,13,8,1
SBI03BDR8309450,19,24,17,7,1
SBI47WGQ3904846,98,33,29,4,1
SBI15JYZ6429438,92,19,17,2,1
SBI26EHG6088306,90,34,27,7,1
SBI51GPR6057362,66,19,16,3,1
SBI78EPP3158914,79,26,17,9,1
SBI92OPE6609458,76,31,17,14,1
SBI03RYT3051957,66,23,13,10,1
SBI84MEZ7715908,93,18,15,3,1
SBI35RCV4264559,69,36,27,9,1
SBI04JEA0169471,86,22,15,7,1
SBI15YPI9558326,69,27,19,8,1
SBI00BFI2021897,74,24,19,5,1
SBI73OAY9705436,24,20,11,9,1
SBI26ZIC0468486,63,31,28,3,1
SBI72EMU9717106,67,29,21,8,1
SBI24YXK2475992,83,19,11,8,1
SBI07SQA6443281,22,29,28,1,1
SBI30IRM9185210,25,21,12,9,1
SBI11KWR6463571,82,29,15,14,1
SBI89CEK0359809,88,21,20,1,1
SBI98BPD1470346,62,30,20,10,1
SBI95UBB2501496,21,18,17,1,1
SBI42BNA4266082,87,20,11,9,1
SBI79COE0045985,78,20,17,3,1
SBI43XJG8581960,91,22,19,3,1
SBI77JCL1747651,62,24,23,1,1
SBI27COR5954838,75,25,17,8,1
SBI47CJV8912221,89,19,10,9,1
SBI11INB5864903,78,26,18,8,1
SBI22UXH2663190,18,27,17,10,1
SBI12OAE0291003,73,34,26,8,1
SBI45XPK0215061,61,30,20,10,1
SBI10TYV8522972,62,28,24,4,1
SBI60BLF8435648,92,25,14,11,1
SBI18YBC7403012,91,19,15,4,1
SBI29XFH3209187,89,28,22,6,1
SBI42FZO7992216,93,31,29,2,1
SBI52LTZ9860646,25,22,14,8,1
SBI37NGX0321574,25,22,18,4,1
SBI08RQT2404613,75,25,16,9,1
SBI25YDL7398525,67,28,16,12,1
SBI82IKF7351864,81,17,12,5,1
SBI91CGY5105646,80,26,25,1,1
SBI69SHF9294969,90,25,19,6,1
SBI20PQI8762828,63,27,14,13,1
SBI27VOO6771748,23,29,20,9,1
SBI11KHZ8207136,86,9,6,3,1
SBI87FRX0843738,66,30,25,5,1
SBI37SQA6570631,76,20,16,4,1
SBI92SFV4188412,66,32,23,9,1
SBI70OFN4053150,94,25,21,4,1
SBI19NQF1232681,18,31,24,7,1
SBI52WPQ8503526,86,20,17,3,1
SBI43JDA6590776,70,16,11,5,1
SBI04AYY9609875,70,36,29,7,1
SBI71AQX3611955,91,19,15,4,1
SBI14HON2751206,90,29,22,7,1
SBI80QPH1820558,18,9,7,2,1
SBI61MHB5407313,94,17,14,3,1
SBI21ZON1130454,21,13,11,2,1
SBI48DUH2718238,82,31,25,6,1
SBI64DQQ7470183,89,27,15,12,1
SBI57FXK1189252,71,18,10,8,1
SBI84WHZ9393413,64,21,14,7,1
SBI86TAU1382874,96,21,16,5,1
SBI19RQX7363581,83,34,18,16,1
SBI63EPZ9467227,68,20,13,7,1
SBI87PCA6231405,99,23,16,7,1
SBI82WYI8059006,80,23,21,2,1
SBI42INL3929757,22,24,14,10,1
SBI58EIH3940163,21,20,11,9,1
SBI69JNR2371428,91,29,25,4,1
SBI90QKV4321250,23,19,14,5,1
SBI77GRV8896648,83,26,15,11,1
SBI84LIW2134235,94,27,14,13,1
SBI31RIR1995409,92,26,17,9,1
SBI54FUP4267388,25,20,14,6,1
SBI99ZXY9266952,21,28,26,2,1
SBI77GCJ2902112,21,34,20,14,1
SBI68YDP8957549,73,25,21,4,1
SBI76BDF4617421,84,29,19,10,1
SBI29SSV7360037,84,21,11,10,1
SBI36ZCI1942521,99,30,29,1,1
SBI40AZS2765319,87,30,20,10,1
SBI52SVR5883223,18,16,14,2,1
SBI48BYX3067219,62,20,17,3,1
SBI74FXL1929632,64,41,27,14,1
SBI93KPG2109621,73,24,23,1,1
SBI74ZVK9717564,65,31,28,3,1
SBI81DPB9601381,78,22,13,9,1
SBI16KSX8227424,98,29,20,9,1
SBI21DGW7749066,69,23,15,8,1
SBI70NOK1526190,96,22,17,5,1
SBI83IYF1397612,64,23,18,5,1
SBI62XKT5863222,81,24,18,6,1
SBI98BTQ6328665,74,22,21,1,1
SBI96BCX9420800,81,23,22,1,1
SBI42BFO3200411,76,17,9,8,1
SBI66BIU7990449,73,22,16,6,1
SBI57SQR2089489,76,15,12,3,1
SBI63POB4668460,87,28,23,5,1
SBI74OJY5165466,21,25,16,9,1
SBI12ZNQ2982878,79,16,13,3,1
SBI08RKT5916063,72,23,21,2,1
SBI45NVL9552668,20,20,15,5,1
SBI85KIT2335040,21,31,16,15,1
SBI30NAT0913199,68,25,14,11,1
SBI06JDV2618589,79,24,20,4,1
SBI69ORL2624997,74,35,18,17,1
SBI99BYV4542691,68,30,26,4,1
SBI18CJE9451324,85,26,20,6,1
SBI74MQU3580031,64,22,21,1,1
SBI66GSN1848256,81,22,20,2,1
SBI85NWU0755352,94,35,33,2,1
SBI31HMV4586921,61,28,23,5,1
SBI41AEW4648448,19,26,18,8,1
SBI68HJI9272479,19,25,19,6,1
SBI03SGY5735137,82,14,10,4,1
SBI21USU2624433,80,27,14,13,1
SBI78OIT9504840,90,20,14,6,1
SBI51UVQ0371691,66,27,24,3,1
SBI30SZF5130150,86,20,16,4,1
SBI21KKA5350649,79,25,20,5,1
SBI12SKA1708464,92,18,10,8,1
SBI51GGX5329159,18,27,22,5,1
SBI94ISI8915568,81,31,30,1,1
SBI66XYV5722028,81,18,10,8,1
SBI95IWZ3759628,22,23,13,10,1
SBI93QFN3235001,95,29,28,1,1
SBI08ELV7227489,68,22,12,10,1
SBI03NTJ1598954,80,33,25,8,1
SBI91LTD4451915,68,14,11,3,1
SBI16OAK6976884,68,33,28,5,1
SBI15MHM2643502,23,25,14,11,1
SBI69BBW0846631,24,23,14,9,1
SBI22IBL4845961,68,27,23,4,1
SBI91KLS0096132,89,25,21,4,1
SBI50OJF9972384,72,24,21,3,1
SBI63KDX2280595,22,25,19,6,1
SBI45XME1281843,91,19,17,2,1
SBI26YZA8857781,64,18,13,5,1
SBI56SKW0957973,69,19,15,4,1
SBI89MNF8837254,73,24,15,9,1
SBI97TJX3300207,25,22,21,1,1
SBI73LAI1942030,64,34,22,12,1
SBI73ZVD6017148,89,26,19,7,1
SBI65LQS0753551,79,30,26,4,1
SBI05ITA5312097,99,34,19,15,1
SBI00UQN8187175,77,25,23,2,1
SBI30ZGG1859107,22,27,18,9,1
SBI14DKD9709462,68,21,18,3,1
SBI97OYO9787238,63,27,18,9,1
SBI79LDM4627128,18,24,15,9,1
SBI66SYU9903167,80,31,26,5,1
SBI21WXE8854364,64,29,27,2,1
SBI33BLW9386034,90,27,23,4,1
SBI68WLR5280397,70,24,22,2,1
SBI78RFY4528241,92,36,26,10,1
SBI38TWP5585806,19,23,17,6,1
SBI42EMO6217991,24,28,21,7,1
SBI14EUK4602578,99,25,20,5,1
SBI27CHX1626725,88,27,23,4,1
SBI52JDR5006003,87,21,16,5,1
SBI70QMN3266286,80,27,17,10,1
SBI95WKE6486535,66,22,21,1,1
SBI59GPU2932515,88,24,17,7,1
SBI12WZG4211638,98,25,23,2,1
SBI25TXI0098821,66,24,16,8,1
SBI85UKT7958558,80,25,17,8,1
SBI72LUY6851926,66,25,23,2,1
SBI17LEF9069608,88,22,12,10,1
SBI89UPB2402293,73,21,11,10,1
SBI57TDZ5070178,62,25,15,10,1
SBI70GCA5834797,80,30,19,11,1
SBI32KEO5697418,18,24,21,3,1
SBI83FBA1857434,25,23,19,4,1
SBI70GEA8763419,91,32,22,10,1
SBI69VSK5759259,84,24,22,2,1
SBI96MGC7640278,89,16,15,1,1
SBI53HNJ0259625,71,26,21,5,1
SBI88DFM5757711,25,25,14,11,1
SBI48IKN3497283,71,26,24,2,1
SBI79FHR3984982,72,22,15,7,1
SBI99OAL7060643,65,33,17,16,1
SBI22MEV1219094,99,33,20,13,1
SBI79RCS6983126,24,29,24,5,1
SBI60MQZ6492737,91,20,19,1,1
SBI03CBL2188686,24,22,16,6,1
SBI34ASU6751383,99,22,15,7,1
SBI31WZE1182716,19,30,25,5,1
SBI56SNP9678081,18,29,24,5,1
SBI87PDL4528110,19,24,21,3,1
SBI92RJQ0466328,70,17,14,3,1
SBI01WUO0948035,61,20,13,7,1
SBI89LVV1071751,91,24,13,11,1
SBI82YXK1243848,76,26,22,4,1
SBI58RCK8521019,90,24,14,10,1
SBI72YJV8723137,75,27,24,3,1
SBI43UMB6658985,93,22,21,1,1
SBI25NYI1233498,74,23,12,11,1
SBI41PFP8451121,79,25,17,8,1
SBI58KYW8875460,63,26,18,8,1
SBI77YGG0915325,81,16,11,5,1
SBI59ZWA3723678,19,20,14,6,1
SBI54KRG2164634,71,31,28,3,1
SBI05FHD4376196,82,31,26,5,1
SBI93TKD2756939,68,18,14,4,1
SBI40HWD6212324,70,29,17,12,1
SBI12HTZ5854422,76,26,17,9,1
SBI29IKT6502874,71,19,13,6,1
SBI12VJV6676023,72,30,19,11,1
SBI53DPK0143928,86,27,24,3,1
SBI49UGR7645981,79,22,16,6,1
SBI43CFG9839685,90,27,20,7,1
SBI22MRD5406048,83,29,28,1,1
SBI31WAL0908187,20,27,22,5,1
SBI05USN8319075,68,23,15,8,1
SBI10GYT1265165,61,28,19,9,1
SBI68IOP9566650,66,14,10,4,1
SBI16MQC4825691,78,17,14,3,1
SBI75HHI7295325,74,18,12,6,1
SBI32ZXF4684202,72,27,15,12,1
SBI50LUA8256080,79,19,17,2,1
SBI33PUF3600758,97,23,21,2,1
SBI40YDL5210147,25,19,17,2,1
SBI49IWG8562117,98,29,15,14,1
SBI01EVD5452683,89,26,14,12,1
SBI18HQL4943688,99,28,23,5,1
SBI73DGP2100773,64,27,18,9,1
SBI16LTC3891683,88,27,16,11,1
SBI29TQQ8495979,89,23,21,2,1
SBI92UON7447602,76,30,18,12,1
SBI75MDV2927017,99,20,14,6,1
SBI99EMA6787747,77,17,15,2,1
SBI16EPR8330179,20,25,16,9,1
SBI98HBI4380250,21,11,9,2,1
SBI07BPY4526856,63,19,17,2,1
SBI36QXA1047155,79,25,19,6,1
SBI39RCQ6073798,74,27,26,1,1
SBI81RVP7017807,73,19,15,4,1
SBI41AIN4306057,22,27,14,13,1
SBI14KEW7381183,62,27,18,9,1
SBI60TKS1771498,85,29,25,4,1
SBI70OFT2351780,79,31,27,4,1
SBI73IAH7645877,65,26,19,7,1
SBI96KYC5246372,96,20,19,1,1
SBI19CYB4638004,60,18,11,7,1
SBI87MCU3819240,87,17,14,3,1
SBI97HCG5189926,73,21,15,6,1
SBI60EFC9187396,63,33,32,1,1
SBI47PEG7145926,79,15,14,1,1
SBI40UQY9201926,94,21,13,8,1
SBI46WKC4794617,88,33,20,13,1
SBI42OER2915466,69,24,14,10,1
SBI86MGD5809966,76,16,12,4,1
SBI76NRJ4183295,71,25,15,10,1
SBI79PVI2977094,74,26,24,2,1
SBI67IEH1246141,20,27,17,10,1
SBI74QRE3032291,22,25,21,4,1
SBI20VID4792725,71,23,22,1,1
SBI21BQF9412878,64,25,19,6,1
SBI10PTS8651391,78,31,21,10,1
SBI34KAO0296989,79,23,14,9,1
SBI72QJO1891589,20,18,13,5,1
SBI97QCD2948409,90,21,20,1,1
SBI97VYJ3341852,85,30,27,3,1
SBI79FNG1999512,84,32,18,14,1
SBI09DTW3154415,89,17,10,7,1
SBI42IRZ0915767,87,23,19,4,1
SBI05ZXA2851144,77,25,15,10,1
SBI91FUG7243325,94,20,12,8,1
SBI93JLI2776412,86,21,20,1,1
SBI80YBV9004315,98,14,13,1,1
SBI80EYS9921633,62,22,12,10,1
SBI09YRQ1187685,79,20,18,2,1
SBI82HBR7323127,84,24,18,6,1
SBI37FEW3570374,94,24,18,6,1
SBI62YXC1161633,23,21,18,3,1
SBI86LOT5672459,62,24,23,1,1
SBI11LHT7442072,70,28,15,13,1
SBI06GEI9268334,24,21,11,10,1
SBI89YFE6520344,75,25,24,1,1
SBI22JPJ3394944,70,24,17,7,1
SBI51UBD9769152,19,26,17,9,1
SBI44VVH9933658,63,20,19,1,1
SBI75CDH8530877,77,19,18,1,1
SBI53BED6346409,81,24,19,5,1
SBI54QWH0075037,85,29,22,7,1
SBI51HYT2907962,81,26,16,10,1
SBI17NVD3089590,64,26,16,10,1
SBI62PEP9775546,93,25,24,1,1
SBI70QLI4741514,69,23,18,5,1
SBI17KOP3530641,68,11,7,4,1
SBI40TIG6443424,63,31,18,13,1
SBI96GVF5021614,21,29,21,8,1
SBI76ZWW3666186,92,20,18,2,1
SBI90VCG7492084,64,22,14,8,1
SBI71QQT2448703,95,19,18,1,1
SBI31DSQ5505172,98,24,16,8,1
SBI79WDW0115706,64,24,19,5,1
SBI43NSP7898652,23,19,15,4,1
SBI58MFO5733040,74,20,19,1,1
SBI83VQX6218285,86,33,22,11,1
SBI93SPX5296611,20,30,26,4,1
SBI53ZOX3258749,18,23,16,7,1
SBI60DDE5868260,81,13,12,1,1
SBI83MHJ0024276,25,21,16,5,1
SBI50FAY5078772,67,15,14,1,1
SBI46KHC0035246,88,26,24,2,1
SBI22DKZ5090589,81,17,14,3,1
SBI03MVU7340452,70,24,20,4,1
SBI83DQF5484108,77,17,11,6,1
SBI92XIK1418096,19,22,13,9,1
SBI03JEK1456777,89,24,14,10,1
SBI18ZUS1106903,81,22,20,2,1
SBI66CBZ1273208,25,26,21,5,1
SBI86VWA6452475,63,28,16,12,1
SBI27GLS3632153,96,18,13,5,1
SBI43ZGC7675285,97,21,18,3,1
SBI35FGT1166592,71,27,17,10,1
SBI60UHU8852630,91,19,12,7,1
SBI49DMO4417392,94,20,19,1,1
SBI65VQT6674504,83,21,13,8,1
SBI64WCM5573316,63,17,14,3,1
SBI51ACN4412957,61,26,21,5,1
SBI98MTH3435937,66,32,31,1,1
SBI39UAP2669272,92,25,23,2,1
SBI77LGS7694682,84,22,20,2,1
SBI93LNT5020405,90,25,24,1,1
SBI91AHJ2211078,25,16,9,7,1
SBI87BIE2506116,89,14,12,2,1
SBI84XSB6785219,79,26,22,4,1
SBI79WWV2025474,79,27,23,4,1
SBI39AVS4783113,24,37,26,11,1
SBI92CHB7680777,21,17,11,6,1
SBI54KMU7053132,23,27,18,9,1
SBI65QJJ5346586,75,19,15,4,1
SBI82DZU2181849,62,33,30,3,1
SBI15PJK9617840,72,28,26,2,1
SBI51DUJ6836488,25,34,33,1,1
SBI03DNI1592100,72,21,12,9,1
SBI35DYV2964528,61,22,18,4,1
SBI88KWN7887394,87,14,8,6,1
SBI80UDZ5690949,76,28,23,5,1
SBI52RQU5811248,80,24,20,4,1
SBI26RWF0271761,96,20,11,9,1
SBI00QCT4556514,24,24,15,9,1
SBI23CXO6666340,93,27,18,9,1
SBI62MUD5863441,68,24,13,11,1
SBI92GAI2662432,96,18,11,7,1
SBI86RWQ5479313,75,20,18,2,1
SBI91CTS7260857,77,14,10,4,1
SBI63HAB2486999,83,17,9,8,1
SBI08VAQ7040036,64,25,20,5,1
SBI67CJS4185959,91,32,25,7,1
SBI38WLA1479432,18,33,30,3,1
SBI66VIG9319246,93,22,13,9,1
SBI78CIN9506569,66,24,20,4,1
SBI08QJP1046864,96,22,20,2,1
SBI61TOR3311617,23,22,19,3,1
SBI15TTL7544754,19,23,18,5,1
SBI40EHL8630461,90,28,16,12,1
SBI31ZYH5820165,87,23,19,4,1
SBI24RQZ5739555,86,18,12,6,1
SBI25ZYQ6369035,68,29,19,10,1
SBI28MCX0632069,70,21,20,1,1
SBI45MKK2330126,60,20,19,1,1
SBI12USM5624356,67,20,14,6,1
SBI14ZKV1656726,60,26,19,7,1
SBI83SUI6635879,67,19,17,2,1
SBI01PJA8635697,97,16,12,4,1
SBI71KSH0562564,67,19,13,6,1
SBI84ZHC2714188,25,22,21,1,1
SBI19QYE8720832,72,23,12,11,1
SBI14CFD0646453,25,29,21,8,1
SBI93VGA2651356,64,26,22,4,1
SBI41UMO6210277,89,22,16,6,1
SBI26CQS6886888,85,19,18,1,1
SBI56ANU6452461,18,22,14,8,1
SBI21ZZD0708137,70,23,20,3,1
SBI82SKL6797439,86,24,17,7,1
SBI94IHV4022108,83,20,14,6,1
SBI76LBE6035251,87,29,18,11,1
SBI18BFY6373489,80,17,16,1,1
SBI19AHE0175777,90,32,25,7,1
SBI57BTK2710780,90,20,18,2,1
SBI80XPN6400303,94,20,16,4,1
SBI85ASE7028029,92,24,15,9,1
SBI14UWC2619723,85,33,25,8,1
SBI34XPW8791342,21,23,21,2,1
SBI38GFG6245379,87,18,13,5,1
SBI31ZTK1598267,99,25,14,11,1
SBI36EWD3883895,92,34,18,16,1
SBI63PGT7224578,18,29,18,11,1
SBI59MXJ8131550,71,26,15,11,1
SBI72OTE0471685,88,33,24,9,1
SBI99XDG0428255,82,32,24,8,1
SBI73JYU6941810,66,33,18,15,1
SBI93OBS5383252,61,29,23,6,1
SBI91FZL2150173,91,20,11,9,1
SBI46EGD8991966,89,16,15,1,1
SBI96GJI0141658,96,17,16,1,1
SBI88KBS9202258,60,28,20,8,1
SBI43XPS8491407,87,24,22,2,1
SBI54DDA1092282,97,20,19,1,1
SBI96UNR2927428,95,11,9,2,1
SBI90PDZ8549981,25,25,13,12,1
SBI64JAN6276873,66,19,11,8,1
SBI19DCG5321182,94,26,18,8,1
SBI76KZI1806891,21,24,15,9,1
SBI36XDN8923963,80,27,24,3,1
SBI67XQV7370786,73,26,20,6,1
SBI63MRR9420929,78,31,28,3,1
SBI19ATA1351315,73,22,12,10,1
SBI97OYO3861340,71,28,16,12,1
SBI01KAV6580230,61,24,19,5,1
SBI93JNU7750237,62,23,22,1,1
SBI12YFK4971499,89,24,13,11,1
SBI74VYZ7674029,97,27,26,1,1
SBI08NNB1645759,64,24,18,6,1
SBI41ZHF9322435,66,23,21,2,1
SBI41UTA6921091,98,29,20,9,1
SBI75CNE1350561,65,25,14,11,1
SBI86JLX7290635,88,33,21,12,1
SBI23WJD8867614,94,33,30,3,1
SBI86HHE4464297,74,31,28,3,1
SBI19XDV7577301,81,15,10,5,1
SBI41KYX2086588,24,18,13,5,1
SBI61MDT1874298,63,19,13,6,1
SBI83OOW2441571,87,34,33,1,1
SBI79HUZ8144411,66,16,9,7,1
SBI24OOA2797581,77,19,10,9,1
SBI85LOL8746637,19,20,17,3,1
SBI06MLZ4363183,22,22,12,10,1
SBI95EHN7318405,84,28,17,11,1
SBI97DFO8306545,61,22,21,1,1
SBI64BIO0123549,20,29,25,4,1
SBI27WCG8314102,87,21,15,6,1
SBI35SXH9553327,61,27,14,13,1
SBI24PUV8000635,98,27,25,2,1
SBI00ISM7628282,75,21,18,3,1
SBI55YLD4779192,86,29,23,6,1
SBI39DDF5524464,79,20,16,4,1
SBI27IRU0592435,72,22,19,3,1
SBI47CKV5264918,25,23,16,7,1
SBI74FUT0868277,82,26,23,3,1
SBI48KWJ2994807,83,26,23,3,1
SBI85CYR9025081,19,23,17,6,1
SBI96SQV8804179,82,25,15,10,1
SBI98IXM7277431,84,19,17,2,1
SBI37NBU2192753,85,33,22,11,1
SBI88NCK9865356,72,23,21,2,1
SBI17EDS7484265,77,20,18,2,1
SBI41ZKG4614762,66,28,18,10,1
SBI68PAQ7882028,62,24,19,5,1
SBI20BKX3746636,95,26,21,5,1
SBI34DMF0559041,23,22,16,6,1
SBI89XNY9730624,97,18,11,7,1
SBI82DFE7376252,69,26,21,5,1
SBI85XZD0560195,90,31,21,10,1
SBI70UML5883705,83,27,24,3,1
SBI32CPW8225328,83,23,15,8,1
SBI11HVB9913689,71,24,16,8,1
SBI60VKU7622513,82,31,19,12,1
SBI39WUW7091469,97,26,17,9,1
SBI47GFR0953139,71,28,22,6,1
SBI61RCC4027570,20,27,17,10,1
SBI75FYE4639429,23,26,24,2,1
SBI43RXI1887602,85,26,18,8,1
SBI79EDP4581617,96,32,19,13,1
SBI74IIP4005644,77,28,22,6,1
SBI12IPM2837004,77,30,29,1,1
SBI98SEL4678158,19,28,17,11,1
SBI84MHL6193869,73,15,10,5,1
SBI80ONP4570915,96,22,15,7,1
SBI62KWX1597748,79,27,18,9,1
SBI84COV9787463,97,30,19,11,1
SBI81QIP9778559,80,29,24,5,1
SBI51KJZ2668375,79,18,12,6,1
SBI75TWE5442140,24,27,16,11,1
SBI35WMU1546962,88,21,19,2,1
SBI99PNS5204971,22,25,19,6,1
SBI92JOV2397173,19,20,17,3,1
SBI30EVQ6856550,79,29,27,2,1
SBI45NCR7595925,96,21,16,5,1
SBI00LJW0719471,75,17,9,8,1
SBI05CDJ2118527,82,31,25,6,1
SBI44QNZ1318376,62,20,16,4,1
SBI64WZR0024429,77,26,22,4,1
SBI11FOO4769373,69,19,17,2,1
SBI94CKK6195370,72,29,17,12,1
SBI07VOH7670378,85,25,22,3,1
SBI12YDV3881260,69,25,14,11,1
SBI16DUA6654498,81,23,18,5,1
SBI03DAF8200608,18,21,12,9,1
SBI67LJI7137488,19,27,23,4,1
SBI39GFP2157524,92,20,14,6,1
SBI44CMU1970709,76,29,21,8,1
SBI37UKN6478319,66,26,19,7,1
SBI30RZM1583823,77,28,20,8,1
SBI03SES3071731,62,25,20,5,1
SBI49BGX9973418,94,18,10,8,1
SBI60YBE6968676,22,30,16,14,1
SBI23FWO8048628,69,27,22,5,1
SBI39ZPW1920168,24,22,14,8,1
SBI85IQR7595553,75,24,20,4,1
SBI22VHJ4780340,25,24,20,4,1
SBI02GZP4458571,81,33,27,6,1
SBI02UXV6832872,98,17,13,4,1
SBI72AFH8416931,25,15,9,6,1
SBI33UTL2937328,90,29,21,8,1
SBI17ZEG9132744,83,28,20,8,1
SBI00VVQ2718550,96,27,19,8,1
SBI98WGL6663040,79,17,11,6,1
SBI56DDN7188418,61,23,21,2,1
SBI97ZFO9249698,63,16,10,6,1
SBI88DPP6398122,25,23,17,6,1
SBI70WER4112357,92,32,30,2,1
SBI61LNC1249277,99,27,20,7,1
SBI74ULP6640482,19,28,17,11,1
SBI21VRN1086595,69,24,19,5,1
SBI28TDP3639522,61,21,17,4,1
SBI95TMO1570064,94,22,17,5,1
SBI67MWV0247438,73,27,16,11,1
SBI33JKF6155627,20,32,24,8,1
SBI76VIN3726222,80,27,22,5,1
SBI31XNL5437325,25,12,9,3,1
SBI23AYL0694534,75,26,23,3,1
SBI45IPK3006524,18,24,18,6,1
SBI62VSQ1651308,22,21,14,7,1
SBI03FEO4990562,82,26,15,11,1
SBI80KKO1492233,21,28,16,12,1
SBI89TYR2391962,81,20,17,3,1
SBI51ZNO8278298,83,26,22,4,1
SBI51UEZ0506225,75,23,15,8,1
SBI11WXG0315447,92,21,16,5,1
SBI67FFL8954020,73,16,14,2,1
SBI66DHX9570510,71,26,16,10,1
SBI91ZQI1664315,77,26,24,2,1
SBI73GHO9532080,74,22,19,3,1
SBI49PJL4313835,62,22,17,5,1
SBI83VOS9799648,88,18,14,4,1
SBI89QQI8687055,21,20,15,5,1
SBI39GPY8030069,75,24,23,1,1
SBI41VCF9518562,72,24,21,3,1
SBI52VYG5137955,77,27,21,6,1
SBI40GHT4366938,66,22,19,3,1
SBI28SBH0461043,80,26,25,1,1
SBI57ANU2027789,81,28,15,13,1
SBI69NQX6154907,65,19,15,4,1
SBI17GMJ3658218,62,20,19,1,1
SBI57ZUU5966033,92,22,13,9,1
SBI48RTO9590247,21,23,16,7,1
SBI54WJV8782320,95,24,17,7,1
SBI02QCO1061916,67,28,24,4,1
SBI96SZF1471450,87,19,16,3,1
SBI48NGL5731578,98,20,12,8,1
SBI38SHS1342619,68,27,20,7,1
SBI43AJE8981370,63,25,23,2,1
SBI30PBP9727199,86,32,22,10,1
SBI01UVV1376787,66,33,26,7,1
SBI06OFT8140789,81,20,17,3,1
SBI99XLX6784835,22,19,13,6,1
SBI22EZB0468024,87,18,16,2,1
SBI02FSN4780177,21,22,16,6,1
SBI82DGD0632842,87,30,29,1,1
SBI66TYL8420725,63,21,19,2,1
SBI88PSA8520180,77,29,28,1,1
SBI06ZCM2546137,72,22,20,2,1
SBI74RJP7579297,71,35,27,8,1
SBI59GAH7416422,61,21,11,10,1
SBI08LUX4318736,90,12,10,2,1
SBI05PBQ0062528,73,27,25,2,1
SBI66UJG7163381,99,26,25,1,1
SBI37FQH5237428,74,30,16,14,1
SBI32YND4617328,85,29,19,10,1
SBI88BSY1996766,67,28,23,5,1
SBI64UUS8064365,99,29,18,11,1
SBI30ZYY8212649,92,31,30,1,1
SBI44KXA3925485,88,29,20,9,1
SBI77ERT5103314,86,30,23,7,1
SBI80MVA3494641,66,27,22,5,1
SBI80VBE1025534,67,30,17,13,1
SBI79KGJ3189837,85,28,24,4,1
SBI39BYG7372191,88,25,24,1,1
SBI04PXA7985158,66,30,24,6,1
SBI39DQE0292162,87,24,15,9,1
SBI24QNE8447488,82,23,15,8,1
SBI31NMT8275714,22,22,18,4,1
SBI87WDG6075494,19,24,13,11,1
SBI93WKS7722398,76,27,21,6,1
SBI44ZGP2813629,85,27,15,12,1
SBI97KXH0575785,96,27,17,10,1
SBI68UPF0162761,69,16,15,1,1
SBI89MYF4516870,86,21,17,4,1
SBI64IDD3267269,68,18,15,3,1
SBI64PEP4679813,91,27,26,1,1
SBI20KGR0223288,25,23,14,9,1
SBI75KAT5976342,89,18,10,8,1
SBI87IML4731209,77,26,17,9,1
SBI74XVI2819992,87,26,21,5,1
SBI19XPE7934415,97,31,22,9,1
SBI43GZF3191816,20,14,13,1,1
SBI75MFR3763859,20,35,19,16,1
SBI03EZU4729243,65,18,16,2,1
SBI99SUT7552496,21,26,21,5,1
SBI62UZA5624810,87,28,21,7,1
SBI12IYV3758474,63,26,25,1,1
SBI19IFO7370913,80,28,15,13,1
SBI87RKU2939203,76,23,21,2,1
SBI20YGN1999262,86,25,13,12,1
SBI62IPV0920583,85,20,11,9,1
SBI36LBP6128172,78,22,20,2,1
SBI68GFY5429184,67,30,28,2,1
SBI18PXU3929893,64,21,18,3,1
SBI92SWB0883696,79,31,23,8,1
SBI65HDR7002423,68,14,9,5,1
SBI12YFA0734429,99,32,21,11,1
SBI58MUD2937382,83,21,20,1,1
SBI65PIT7479453,64,25,16,9,1
SBI90ECY0894219,90,21,17,4,1
SBI70VPS2076839,89,24,13,11,1
SBI98DSE5879481,80,34,18,16,1
SBI97OBV2576841,84,29,24,5,1
SBI25HZD6591079,74,29,24,5,1
SBI87QJQ2706696,70,24,19,5,1
SBI05WUV9667412,93,21,19,2,1
SBI01TWN0031370,94,28,26,2,1
SBI49CEO0946401,63,34,24,10,1
SBI71XUE6336216,89,29,15,14,1
SBI82ELE5425454,95,19,12,7,1
SBI28UJZ4725907,65,23,13,10,1
SBI44MSL4688306,20,19,10,9,1
SBI08LUQ0649299,90,18,11,7,1
SBI93OIZ5306966,62,26,21,5,1
SBI74TLY0912901,90,27,25,2,1
SBI75TXG5971791,70,27,25,2,1
SBI18QZO4310907,81,24,13,11,1
SBI02VBZ5893426,69,20,14,6,1
SBI27ZVF6319714,92,31,28,3,1
SBI36LKL4696885,70,19,17,2,1
SBI37JMJ1058349,95,32,20,12,1
SBI58JXE7711625,79,25,18,7,1
SBI00LYU5152820,65,14,9,5,1
SBI34PUA3937962,81,21,17,4,1
SBI44TZZ7343083,67,22,18,4,1
SBI32LLB6188125,90,29,27,2,1
SBI99ZOA7767711,98,34,29,5,1
SBI77RLC8946298,82,22,15,7,1
SBI55IED9309176,25,29,19,10,1
SBI83CWN1211500,62,19,13,6,1
SBI26EHL1143343,93,27,15,12,1
SBI16EBR3960515,63,25,23,2,1
SBI92VPU5438033,64,29,20,9,1
SBI51XYK5998423,68,23,20,3,1
SBI38NSX8092045,72,28,25,3,1
SBI26LOY1877415,21,30,22,8,1
SBI32EXP6785395,84,21,16,5,1
SBI53DNE5515846,18,17,13,4,1
SBI94TAD7151958,89,19,13,6,1
SBI99CSC9159632,23,31,27,4,1
SBI34AHH9006986,82,25,13,12,1
SBI26IRA3407588,73,27,23,4,1
SBI36HNH0842473,78,14,11,3,1
SBI49RPM4283008,66,27,17,10,1
SBI75CBW5192914,63,37,35,2,1
SBI01KJS9912957,79,17,9,8,1
SBI10GVF5318105,60,21,19,2,1
SBI82JSB5758936,66,20,19,1,1
SBI56FRW9847863,79,34,28,6,1
SBI57PCH6444572,76,24,18,6,1
SBI51MGR5454152,63,17,10,7,1
SBI28FNT2700173,18,19,16,3,1
SBI32HGS8181316,89,21,16,5,1
SBI71QHM1641641,89,31,18,13,1
SBI04OOI9261171,78,18,17,1,1
SBI05KPL2619885,78,28,23,5,1
SBI79OJP7303040,86,27,24,3,1
SBI90SQE8039327,25,25,14,11,1
SBI77QSX6634724,64,28,23,5,1
SBI35BVU4806046,66,21,16,5,1
SBI81JYE2662558,99,28,27,1,1
SBI34MMC8145248,83,34,29,5,1
SBI57CYF3782166,19,27,24,3,1
SBI37SHS6918872,80,22,16,6,1
SBI48OYG8902263,83,22,16,6,1
SBI04HEG5078778,68,32,29,3,1
SBI51RPW4504780,92,36,21,15,1
SBI47KYJ1594666,94,28,19,9,1
SBI54JDE6825851,99,27,24,3,1
SBI15TYC7934980,68,20,13,7,1
SBI00WUS9773661,87,25,22,3,1
SBI54GQE2178685,98,29,22,7,1
SBI23MVX5744857,82,30,25,5,1
SBI73XOJ2108183,79,31,27,4,1
SBI55JCQ8007433,71,25,19,6,1
SBI08CRT5032119,70,25,15,10,1
SBI62LQE4999478,84,26,23,3,1
SBI56DCG6515681,84,23,15,8,1
SBI06QKR2897952,80,25,22,3,1
SBI19RRC7845844,92,19,14,5,1
SBI11VBW2121033,74,12,9,3,1
SBI79JOP1140267,24,26,20,6,1
SBI25BIV7090578,85,27,23,4,1
SBI78YYI2730902,73,21,12,9,1
SBI44AKX9787546,82,26,21,5,1
SBI62CLQ1766781,64,30,28,2,1
SBI70ZXS8216231,91,23,22,1,1
SBI61IWD4307487,77,25,23,2,1
SBI69TRS1487227,66,18,11,7,1
SBI71ERL2388201,81,23,13,10,1
SBI06KDI2461252,25,22,15,7,1
SBI17FQI4223339,65,18,14,4,1
SBI51ORI2254143,93,25,17,8,1
SBI41SNK3392868,82,27,24,3,1
SBI54TCZ6026627,21,25,24,1,1
SBI67JAE7217612,76,19,14,5,1
SBI95OEF5440465,92,24,21,3,1
SBI17LLT1012974,68,24,21,3,1
SBI50YNI5262893,23,23,13,10,1
SBI79XTX1182836,23,32,17,15,1
SBI11CHK4820665,85,29,17,12,1
SBI53FBT3161171,76,30,25,5,1
SBI23PYP3859561,85,21,15,6,1
SBI29ZYU1283221,66,29,21,8,1
SBI99KQJ9586108,70,20,12,8,1
SBI48CDD8202192,20,27,20,7,1
SBI21EPF2375521,63,14,9,5,1
SBI34ZVN3290713,61,25,16,9,1
SBI45WSB3458160,85,30,27,3,1
SBI73CPF4057706,80,24,23,1,1
SBI56SCF9525252,71,25,15,10,1
SBI43PXO6136486,64,13,11,2,1
SBI18JFQ1254824,22,29,23,6,1
SBI45OOQ5144685,63,28,17,11,1
SBI73MMJ3747054,92,26,14,12,1
SBI75RNO7453856,79,33,25,8,1
SBI01EWD6133451,92,23,16,7,1
SBI22VNM3707871,98,28,17,11,1
SBI10FWP0798555,70,23,18,5,1
SBI38SXL0153213,21,27,26,1,1
SBI93EMR9512055,24,22,21,1,1
SBI13XNI5868327,65,17,14,3,1
SBI04YIN4317220,89,24,21,3,1
SBI44MQJ3277874,98,25,21,4,1
SBI53IDE2307202,98,27,15,12,1
SBI61MTM5587902,89,25,20,5,1
SBI61DYR2270305,84,30,28,2,1
SBI83IOX9390550,86,20,17,3,1
SBI00YYJ1208714,78,29,28,1,1
SBI01AMS9442715,97,27,25,2,1
SBI68BVU4218003,60,25,20,5,1
SBI77AVH3895430,84,31,26,5,1
SBI01UOJ3995549,71,24,14,10,1
SBI46VGV8157935,97,28,19,9,1
SBI24RIC1001769,93,21,11,10,1
SBI57MKR3914672,83,27,16,11,1
SBI25AVY7900478,25,35,29,6,1
SBI77RZG5035289,88,22,19,3,1
SBI90ADT9116310,84,27,24,3,1
SBI33CDD4407445,25,26,14,12,1
SBI59YRZ6682980,22,20,11,9,1
SBI67BVW8086531,77,25,20,5,1
SBI17XRO2187422,90,28,25,3,1
SBI30PJY9935403,83,27,16,11,1
SBI21CQM3404965,63,17,14,3,1
SBI04RCC2093206,95,20,12,8,1
SBI05KMM6976659,92,26,24,2,1
SBI31FBU2089633,20,21,19,2,1
SBI00BYY2639061,62,16,10,6,1
SBI45YCC0027321,78,22,20,2,1
SBI36AGI3871895,83,14,9,5,1
SBI66JOD1250224,73,20,17,3,1
SBI32ZCG5359741,72,28,21,7,1
SBI75HBK2513052,70,24,14,10,1
SBI33XSU3850121,98,26,25,1,1
SBI09HHG5149625,72,20,15,5,1
SBI83WEW6955738,79,24,22,2,1
SBI03CXC2618075,89,22,21,1,1
SBI89TIP5644013,71,22,16,6,1
SBI89XRN0848787,67,18,10,8,1
SBI09WHS2620426,70,17,13,4,1
SBI37RZA6818545,96,26,22,4,1
SBI25GPA3162425,21,27,20,7,1
SBI70MTV9509485,94,21,18,3,1
SBI90XFC9863600,76,24,23,1,1
SBI67ZCQ7529849,99,34,29,5,1
SBI88SZD6337743,95,25,20,5,1
SBI34XED3541631,92,22,15,7,1
SBI59SJG8118340,98,35,20,15,1
SBI54KFY9408548,23,31,22,9,1
SBI23UIB9074410,61,29,20,9,1
SBI03ESQ5996745,81,28,21,7,1
SBI74AGD0183277,61,25,19,6,1
SBI07IAH5660275,85,21,13,8,1
SBI16CPG2627386,68,35,28,7,1
SBI09JEF1466356,66,23,22,1,1
SBI54DXZ3084398,87,29,18,11,1
SBI68BAE0395084,73,25,20,5,1
SBI81QQI6951625,93,38,31,7,1
SBI26KLT0508109,68,22,19,3,1
SBI57LUE3941548,72,32,24,8,1
SBI29ORN5212600,85,21,12,9,1
SBI97XIQ3170675,90,24,17,7,1
SBI65WBV3244823,65,20,16,4,1
SBI56QXD0704646,64,24,21,3,1
SBI68LYM5725124,95,26,18,8,1
SBI48TXJ2089365,99,31,26,5,1
SBI48GWB6009276,90,16,13,3,1
SBI26EED1698936,73,24,23,1,1
SBI57WGI5482118,25,16,10,6,1
SBI97IEM4134804,87,23,18,5,1
SBI19NHH0143522,71,14,11,3,1
SBI45ULD0175953,82,24,19,5,1
SBI69HRT7497558,66,20,13,7,1
SBI89MRT9610485,64,22,21,1,1
SBI44DDT8147497,91,27,21,6,1
SBI31JYC4504197,63,14,12,2,1
SBI49GIG7491230,19,27,14,13,1
SBI72VDV3994958,98,29,18,11,1
SBI06ATV7023471,60,33,17,16,1
SBI68EAV5875110,82,25,15,10,1
SBI89ZDB6716299,98,28,22,6,1
SBI68BBJ0738141,76,19,17,2,1
SBI71XES6485175,64,25,13,12,1
SBI23HAT6655646,24,23,13,10,1
SBI02HNI4060054,72,22,19,3,1
SBI78ABE8709211,74,18,13,5,1
SBI78KCM4938140,60,21,11,10,1
SBI57LOO0518947,94,22,17,5,1
SBI70ADZ9904119,25,26,15,11,1
SBI60FFP5841697,89,30,17,13,1
SBI36SPN6162962,21,25,23,2,1
SBI82KCF8002490,96,21,13,8,1
SBI42QWE8946087,22,26,16,10,1
SBI73OXT4944222,73,25,13,12,1
SBI38QYM1513208,92,29,23,6,1
SBI43TDX4942133,76,19,15,4,1
SBI59EIC1444992,88,21,17,4,1
SBI64VDF9125384,74,32,27,5,1
SBI74PTE6862178,85,18,12,6,1
SBI45EUV9027631,63,20,12,8,1
SBI91RSU0114640,22,19,10,9,1
SBI40ZIM1086136,92,23,17,6,1
SBI73PTS6402695,71,31,26,5,1
SBI95HLJ3445343,78,22,13,9,1
SBI84HMX7006145,63,24,16,8,1
SBI77EWU0499176,86,28,21,7,1
SBI29SAF0415300,23,17,10,7,1
SBI38VAQ9836218,79,26,14,12,1
SBI58VBH3407895,95,20,13,7,1
SBI06GWV7955515,20,25,16,9,1
SBI29GLS9613160,61,23,16,7,1
SBI74KJI6110551,98,31,26,5,1
SBI72KQY1506796,67,18,11,7,1
SBI57ZWM4603540,87,23,20,3,1
SBI21BQV8871188,85,32,28,4,1
SBI45QTF3328563,65,23,22,1,1
SBI94WMN9674315,81,22,16,6,1
SBI39DII5884103,76,27,24,3,1
SBI87APX2794187,93,22,19,3,1
SBI78ORL5577145,99,19,16,3,1
SBI83LKL5273238,23,27,23,4,1
SBI53MCB7348673,76,33,24,9,1
SBI48KUF9002635,60,21,19,2,1
SBI05SRR3140669,25,28,18,10,1
SBI60QXF3470057,25,23,18,5,1
SBI77CHW0515467,60,34,21,13,1
SBI54HEI9110077,18,21,14,7,1
SBI62CIY9563355,95,30,29,1,1
SBI18LNM2020173,70,25,15,10,1
SBI61GTA8189998,18,22,13,9,1
SBI90SJO9147077,75,26,20,6,1
SBI93LXO8308166,92,31,27,4,1
SBI38CME3757011,22,18,14,4,1
SBI94NGB8272475,82,27,19,8,1
SBI62ASH1352458,64,25,17,8,1
SBI90URA1784083,88,23,13,10,1
SBI70GJH6672476,95,20,17,3,1
SBI27YBW3560573,21,26,22,4,1
SBI00INJ7078271,18,16,13,3,1
SBI08UFE7234316,80,24,23,1,1
SBI13QJP0300254,78,26,15,11,1
SBI33FJU2915686,21,21,12,9,1
SBI50PDE1793903,84,33,19,14,1
SBI36QPL8292859,86,25,23,2,1
SBI44KSD1268495,79,27,24,3,1
SBI44VMG8530408,74,20,13,7,1
SBI76YFR9451646,77,28,22,6,1
SBI56VNU5920048,24,24,23,1,1
SBI68PXN3822503,85,27,22,5,1
SBI70BFT9712754,93,28,26,2,1
SBI84PBV1864425,86,24,23,1,1
SBI33QBU9451799,75,28,17,11,1
SBI17LUM3144941,95,18,15,3,1
SBI59XTF5003000,71,24,17,7,1
SBI40DMZ0383033,89,19,18,1,1
SBI18MSI6146009,91,37,23,14,1
SBI90URA9489123,76,21,11,10,1
SBI56DBH2524006,85,26,20,6,1
SBI42CEM8397398,82,18,13,5,1
SBI84CMS4250324,80,25,18,7,1
SBI79PVL6270942,83,17,10,7,1
SBI26IER5223706,87,24,20,4,1
SBI53HQE5626416,18,24,13,11,1
SBI55MVH8893758,74,18,10,8,1
SBI88LJU4022683,87,15,9,6,1
SBI52DIH0547232,20,25,22,3,1
SBI24ABX7339430,98,21,19,2,1
SBI33XUF8306223,93,27,16,11,1
SBI07UNX6316344,64,20,13,7,1
SBI45IGF8785703,72,25,24,1,1
SBI67JQL4742457,98,21,16,5,1
SBI97FBX5213023,60,22,19,3,1
SBI66PFX1226079,95,28,18,10,1
SBI58EHR7075271,75,21,14,7,1
SBI09OEC5785781,78,24,23,1,1
SBI14EFK5064601,76,34,18,16,1
SBI65OLQ0844159,66,25,15,10,1
SBI16FWL5990712,86,28,25,3,1
SBI12WKQ2817268,97,23,14,9,1
SBI58NWD7170604,79,25,16,9,1
SBI44GUJ7359714,97,25,20,5,1
SBI47NCX4055957,91,21,15,6,1
SBI94QAP4028229,85,25,20,5,1
SBI41YPG3867332,61,30,21,9,1
SBI32PKC8169375,74,16,13,3,1
SBI68ILK9828223,89,27,26,1,1
SBI28XTT0274534,24,26,23,3,1
SBI03WTC6488418,84,29,16,13,1
SBI94EUM8159264,99,25,21,4,1
SBI72HNG3265936,89,25,15,10,1
SBI26RKD1525066,92,21,17,4,1
SBI13YDS3937587,22,24,23,1,1
SBI72UHV4208544,74,21,20,1,1
SBI16PUL5552662,95,31,24,7,1
SBI72CFL4406389,76,35,25,10,1
SBI63SOP5922056,79,29,27,2,1
SBI99NLJ9299635,86,24,20,4,1
SBI91KRY0364093,85,26,22,4,1
SBI49CXT9184570,79,25,14,11,1
SBI68CKK5374044,86,22,19,3,1
SBI17NMH2428584,79,27,15,12,1
SBI47EGG3147940,99,33,21,12,1
SBI11ZAG6442408,66,23,12,11,1
SBI60WDH2289025,20,22,21,1,1
SBI58TVK6698479,91,29,21,8,1
SBI34YDF2630752,72,40,37,3,1
SBI41HQW4677641,71,28,25,3,1
SBI76FBY0192157,70,34,22,12,1
SBI71POE9662828,96,29,27,2,1
SBI70YHQ6033488,65,26,14,12,1
SBI06MCM0704930,76,22,20,2,1
SBI37SPF4351858,19,23,16,7,1
SBI65ZAH5987665,85,32,28,4,1
SBI46JGC7079211,82,16,13,3,1
SBI35UZZ5216605,85,23,18,5,1
SBI96ZRG4214293,18,32,17,15,1
SBI87RLZ1426900,90,27,25,2,1
SBI12ESL3012947,63,24,16,8,1
SBI95ZMT9916855,91,23,22,1,1
SBI61VKK8500314,71,22,16,6,1
SBI43JXZ6626022,90,25,20,5,1
SBI16CNJ3438937,69,22,12,10,1
SBI37OYM3330142,80,29,19,10,1
SBI45BCX1237338,86,25,19,6,1
SBI41ASK3629705,60,29,23,6,1
SBI67KBD3824061,92,26,20,6,1
SBI05BBO1050761,67,24,18,6,1
SBI88CFJ9887018,79,20,11,9,1
SBI51UIL2214666,75,35,22,13,1
SBI87XYU2414156,65,25,15,10,1
SBI32UYN5041238,99,30,18,12,1
SBI10HKD0728344,80,26,16,10,1
SBI44SSQ5866719,94,14,11,3,1
SBI62AER0962102,20,30,21,9,1
SBI32CMP2955863,82,22,14,8,1
SBI42ZHN4753623,98,31,17,14,1
SBI24KRR6059624,90,22,13,9,1
SBI01SNV6604590,71,22,15,7,1
SBI49MEK1532364,99,20,15,5,1
SBI40MHO1875637,73,20,11,9,1
SBI24BUB8162000,78,17,10,7,1
SBI07TRO8216966,75,17,9,8,1
SBI95EVM7544862,96,28,18,10,1
SBI65GEV4801737,75,27,18,9,1
SBI98NDK1384091,21,31,16,15,1
SBI60APE6444101,24,20,12,8,1
SBI01DCJ8924358,78,15,13,2,1
SBI11NST5392726,96,25,23,2,1
SBI83BWC6391279,22,22,14,8,1
SBI34NYI0456770,91,25,13,12,1
SBI93QWW4088135,84,22,21,1,1
SBI50TRA7308725,64,19,17,2,1
SBI37QGM1965966,18,24,16,8,1
SBI75WVT5522593,80,25,14,11,1
SBI15AYI8991232,69,16,14,2,1
SBI15WEC4164855,22,15,10,5,1
SBI51NKJ3835853,66,19,16,3,1
SBI32CRF0360230,97,27,14,13,1
SBI71PJC9310377,23,23,22,1,1
SBI78CVE8792940,93,14,12,2,1
SBI30PNM9668105,84,26,20,6,1
SBI10SAK4733358,74,23,22,1,1
SBI47ZRV8163229,90,33,27,6,1
SBI74SEL0278900,63,26,16,10,1
SBI55TDM7767058,62,22,14,8,1
SBI61LSZ5585367,95,29,15,14,1
SBI97GUD2599335,95,30,28,2,1
SBI36ZIB6952719,64,29,21,8,1
SBI29QFN8066549,89,23,22,1,1
SBI93UKO0724845,64,28,17,11,1
SBI28BTZ5987375,64,19,18,1,1
SBI81LWX7076452,82,20,13,7,1
SBI19HVQ6742645,65,33,27,6,1
SBI68GCB8602513,94,23,18,5,1
SBI14RGQ4877042,81,28,25,3,1
SBI13LQQ7818206,86,18,11,7,1
SBI08BHU0191389,66,27,18,9,1
SBI00QVK6980416,84,35,21,14,1
SBI94BNX2584012,24,20,12,8,1
SBI98SYV8470452,75,25,13,12,1
SBI83EAE9673458,66,17,15,2,1
SBI06BIT3654032,96,24,13,11,1
SBI65HIU8465421,71,11,7,4,1
SBI91AAS9925071,97,22,21,1,1
SBI43UUL3396721,68,16,12,4,1
SBI96ZQW0999904,88,21,13,8,1
SBI53ZRZ5068518,83,27,18,9,1
SBI43SXV3649444,63,30,23,7,1
SBI47JBS4602992,68,26,21,5,1
SBI26MAX6555515,25,19,18,1,1
SBI25AEC1267529,23,26,23,3,1
SBI47THW1576084,66,33,31,2,1
SBI19JOC4481380,62,25,17,8,1
SBI46UZN0270090,83,25,21,4,1
SBI84QYF9420479,94,25,21,4,1
SBI65LQE7082512,62,29,18,11,1
SBI32WLI4807602,96,25,22,3,1
SBI03IER1580442,84,17,15,2,1
SBI79ASI6786563,20,32,20,12,1
SBI94KGA4158793,71,25,18,7,1
SBI46GDO2636165,95,26,25,1,1
SBI68HEK4229702,76,28,27,1,1
SBI37CIX4031167,79,34,19,15,1
SBI80OQX2949450,21,20,15,5,1
SBI49DVR1130503,19,33,18,15,1
SBI23KGK2259075,66,39,32,7,1
SBI15JIP1257548,78,26,22,4,1
SBI93KUD7891297,96,31,29,2,1
SBI38MPV4317401,75,35,26,9,1
SBI57FEZ9580457,79,42,32,10,1
SBI88DZT7656356,75,27,16,11,1
SBI13ZPC7319148,81,22,13,9,1
SBI16QVS8301986,61,17,16,1,1
SBI87QSY4075057,23,17,16,1,1
SBI13WLX9615533,75,22,12,10,1
SBI62RRB2324681,79,20,16,4,1
SBI92NON7920380,93,31,26,5,1
SBI67GJR0657623,76,22,18,4,1
SBI85IOI6210978,74,20,14,6,1
SBI49SHY0793325,76,30,16,14,1
SBI09LEO9953514,93,20,17,3,1
SBI96NRF5138351,97,21,12,9,1
SBI14KKP0654917,84,16,10,6,1
SBI67AJT4011430,84,23,21,2,1
SBI06BNK9100408,96,9,7,2,1
SBI41BYG0196955,96,34,23,11,1
SBI05NZF1672167,21,24,18,6,1
SBI32QSD6210481,93,27,17,10,1
SBI39XBU6044662,18,27,14,13,1
SBI85ZJA3926442,87,20,13,7,1
SBI71FTI9044143,96,24,13,11,1
SBI88UOI9005853,77,32,27,5,1
SBI80RYD2812392,73,21,18,3,1
SBI89HFX7255672,76,23,15,8,1
SBI21XTT0567380,19,21,13,8,1
SBI30GNH4696920,92,29,26,3,1
SBI69YJV7110634,71,21,12,9,1
SBI90RKN3692903,60,20,18,2,1
SBI48WZW4334581,65,32,20,12,1
SBI25QPM4737471,66,16,13,3,1
SBI67UQI4649792,75,35,18,17,1
SBI27YTY1738000,97,20,12,8,1
SBI73BDE6472349,78,36,27,9,1
SBI59OKS9296992,91,22,17,5,1
SBI98DCJ0136969,78,22,19,3,1
SBI96NFV9654607,60,25,20,5,1
SBI00AUC6654387,65,17,16,1,1
SBI65MXG2417797,72,25,17,8,1
SBI60GEJ6143818,92,17,10,7,1
SBI25ZYK9239691,72,25,23,2,1
SBI58BFN1247010,92,24,19,5,1
SBI91JLY4623971,22,23,14,9,1
SBI51MOY2129610,71,29,25,4,1
SBI17BHP6577789,81,20,17,3,1
SBI19EUA7595730,88,32,26,6,1
SBI31FVS4858427,82,22,19,3,1
SBI25FVO7534968,64,34,31,3,1
SBI63XUZ8824341,63,23,13,10,1
SBI16FAB5174389,67,22,17,5,1
SBI65DUM8696685,60,28,23,5,1
SBI26VLA5728624,94,22,20,2,1
SBI92ZIG9016635,92,30,23,7,1
SBI79HER6083654,89,19,18,1,1
SBI54NJE9900928,79,29,19,10,1
SBI64MUA2524404,97,22,19,3,1
SBI03ZBF7102649,62,33,30,3,1
SBI20RLB8856916,90,27,19,8,1
SBI18ZQN0264963,96,34,28,6,1
SBI65BBY1707185,70,23,18,5,1
SBI64TLX4937533,67,31,25,6,1
SBI73DMX1206418,20,27,22,5,1
SBI89URH4919162,77,24,15,9,1
SBI59WSX8081470,66,25,13,12,1
SBI91XFY5596956,21,26,19,7,1
SBI57ZKL7455256,81,22,14,8,1
SBI67WUG7416992,19,16,9,7,1
SBI78DTB0989737,63,27,21,6,1
SBI77EGS5676708,81,28,23,5,1
SBI01XGD1638235,77,27,16,11,1
SBI04LXP4331549,70,28,26,2,1
SBI71EUU5774432,96,13,12,1,1
SBI13TST3592890,80,21,18,3,1
SBI39FQE4596245,94,18,15,3,1
SBI66RAD8836723,97,30,20,10,1
SBI59WMC3604833,80,23,18,5,1
SBI79YYH9478324,93,28,18,10,1
SBI80LAW9911435,77,23,13,10,1
SBI04TYK5926494,72,23,13,10,1
SBI50FNT2036372,76,21,11,10,1
SBI54QNM0084889,89,25,13,12,1
SBI55JTE1110745,80,31,17,14,1
SBI92TSZ1493455,20,29,17,12,1
SBI12PPQ4214453,89,25,19,6,1
SBI68DMQ7231156,89,20,19,1,1
SBI39BMM7701249,79,14,13,1,1
SBI11FZS0300662,74,20,11,9,1
SBI81QYW2687812,20,37,30,7,1
SBI17ECC0599351,76,27,22,5,1
SBI10AYB8414913,66,19,12,7,1
SBI41HDY3988878,76,27,23,4,1
SBI19CHU1536387,86,23,16,7,1
SBI68RNG3343565,69,24,19,5,1
SBI84BOV1691645,62,30,23,7,1
SBI27NKU2164388,66,19,17,2,1
SBI60WSX8951173,94,36,26,10,1
SBI50CNC1514427,75,28,18,10,1
SBI07NDP4497717,89,22,14,8,1
SBI03ISD8384722,63,30,16,14,1
SBI21WHG7038278,89,25,20,5,1
SBI21ZHT8361210,25,21,11,10,1
SBI59APO8602803,76,26,20,6,1
SBI13CAW3940417,78,21,18,3,1
SBI86DDD8114749,72,20,17,3,1
SBI96ILF6361572,90,23,18,5,1
SBI03CJH6390762,69,26,17,9,1
SBI22UDO1626331,91,28,18,10,1
SBI68FRE9396411,70,29,22,7,1
SBI16QCV6630326,69,33,22,11,1
SBI78JCP5342461,69,31,17,14,1
SBI47FRH0004764,18,26,25,1,1
SBI19HMO7315795,61,22,17,5,1
SBI37INR5386622,92,37,35,2,1
SBI07XBB2665827,74,23,16,7,1
SBI22WQG9573651,25,29,28,1,1
SBI92UBT4272232,82,29,24,5,1
SBI26OPC8728454,81,25,21,4,1
SBI54ZYG4986595,71,34,28,6,1
SBI54UVI6576196,80,21,11,10,1
SBI95EGV8790061,23,25,24,1,1
SBI96KQS0192512,83,19,14,5,1
SBI97PBA5229127,60,18,10,8,1
SBI23DJO5030569,98,23,14,9,1
SBI85JEF7253254,77,29,15,14,1
SBI06VCL7299281,75,25,16,9,1
SBI89AQH4710277,93,22,16,6,1
SBI50BZY5319884,97,37,20,17,1
SBI83SJF0091033,21,14,8,6,1
SBI48SNS7598419,93,32,19,13,1
SBI54XZY3553274,84,25,19,6,1
SBI41NDB7585141,81,22,18,4,1
SBI83VLE2928043,22,12,9,3,1
SBI60KYO7273203,97,28,27,1,1
SBI40TSP0947388,93,16,11,5,1
SBI72IIS7994340,70,25,15,10,1
SBI52VNL7869117,61,28,23,5,1
SBI79JCB1484672,65,26,16,10,1
SBI40GTW0035697,83,22,17,5,1
SBI13EUI1167834,20,26,25,1,1
SBI36PGB9979214,66,30,26,4,1
SBI05XZI5356116,79,29,16,13,1
SBI42UDA6169449,63,25,20,5,1
SBI18IGQ5467209,22,27,25,2,1
SBI57DNP6100888,64,14,12,2,1
SBI46PWB7700410,84,22,15,7,1
SBI58ZMN0144335,78,23,20,3,1
SBI43WBY5048884,81,35,29,6,1
SBI93YRU5856112,22,16,11,5,1
SBI00HLA6385875,70,29,20,9,1
SBI66TKG5974255,86,25,21,4,1
SBI66GVP2932174,90,27,15,12,1
SBI66PLU1457285,19,22,19,3,1
SBI33AMH1766925,82,21,12,9,1
SBI70QGP0464358,90,29,26,3,1
SBI32ZWN4424825,18,35,31,4,1
SBI07JMS9320690,80,18,12,6,1
SBI79DBH0432731,71,26,21,5,1
SBI45LON5403808,98,22,15,7,1
SBI32ASI0326786,79,20,16,4,1
SBI63EYH2255281,23,31,16,15,1
SBI80PJH3612082,78,32,24,8,1
SBI29JEM3500430,86,32,24,8,1
SBI61TGS6856436,64,35,33,2,1
SBI66HGY9724744,87,20,11,9,1
SBI39ATT8351846,98,27,14,13,1
SBI90ZJE2152203,65,20,11,9,1
SBI35HBV8406271,61,22,14,8,1
SBI30IBB5872364,67,25,18,7,1
SBI48ELN3717159,96,27,21,6,1
SBI39RBY5279955,76,19,16,3,1
SBI93UPB1596881,97,22,18,4,1
SBI25NHU8073303,20,23,19,4,1
SBI85LJE6869929,60,25,17,8,1
SBI13KUZ0284462,77,30,23,7,1
SBI17FHD9213049,62,34,19,15,1
SBI22JEF1723719,23,28,19,9,1
SBI29SBY9503524,23,20,18,2,1
SBI45YFW4950697,90,24,14,10,1
SBI55QQT5199489,91,10,6,4,1
SBI10FTR2526219,84,22,16,6,1
SBI10NDA1131011,60,23,12,11,1
SBI34AUD1114657,21,22,16,6,1
SBI55XKD5962580,98,24,19,5,1
SBI46OYS2034599,22,22,20,2,1
SBI84QPI9573982,87,29,23,6,1
SBI00FPL5996362,90,20,14,6,1
SBI70SXE7658447,91,26,18,8,1
SBI46IHM5230206,64,24,13,11,1
SBI10ZQW7551224,86,21,19,2,1
SBI08TVD5661677,64,20,12,8,1
SBI06FWA7690328,75,24,17,7,1
SBI04IJR3106832,24,19,13,6,1
SBI65IXL3592544,98,36,28,8,1
SBI57AGD9890574,81,29,20,9,1
SBI93EIY5103858,19,16,15,1,1
SBI24CDK7310064,92,29,25,4,1
SBI62DQV7560351,76,23,16,7,1
SBI55JZJ9561684,74,18,17,1,1
SBI41DAG1054028,64,22,18,4,1
SBI84DEA5441870,21,24,20,4,1
SBI86IJU6513540,89,30,23,7,1
SBI34TFD0502678,80,24,21,3,1
SBI80QJT7826870,60,30,28,2,1
SBI88MZF8638783,80,29,22,7,1
SBI28WXJ8424940,98,25,20,5,1
SBI87KUJ6822946,86,27,18,9,1
SBI20HRU3451689,93,27,21,6,1
SBI37VQV3241994,84,27,26,1,1
SBI33NCW7702276,69,21,19,2,1
SBI05YUF9353340,81,26,22,4,1
SBI33IXJ8536706,71,21,13,8,1
SBI22OMW1710828,69,21,19,2,1
SBI95THE8882571,90,22,14,8,1
SBI36GOV8378239,96,16,12,4,1
SBI01OJT8632810,74,25,23,2,1
SBI45GAI8682779,21,18,17,1,1
SBI62IVG0877459,67,23,17,6,1
SBI14QTE0235004,99,21,19,2,1
SBI98VGD9582455,92,35,23,12,1
SBI07DKA4412899,75,25,18,7,1
SBI08AMT6264069,85,29,18,11,1
SBI06ERH4091302,94,21,17,4,1
SBI26ZNO3043899,85,28,25,3,1
SBI11GPT1966995,70,28,16,12,1
SBI11QBL0006157,83,16,15,1,1
SBI38UXY1111933,76,31,16,15,1
SBI46ESI6770638,18,25,13,12,1
SBI22SNN0036190,92,18,11,7,1
SBI79XDO3111913,82,21,11,10,1
SBI67CER1240313,70,24,17,7,1
SBI15UQX5337924,88,23,15,8,1
SBI86EHB8238232,19,16,10,6,1
SBI59QVW4923368,92,32,18,14,1
SBI05XFH2929308,67,20,17,3,1
SBI54ATY8156532,60,24,16,8,1
SBI88JEW5016830,84,32,22,10,1
SBI19WWN6731163,71,26,24,2,1
SBI64VGZ4353845,77,27,15,12,1
SBI13SAL1562295,71,30,29,1,1
SBI78UKY2269244,94,22,13,9,1
SBI06BPB1828297,64,17,16,1,1
SBI42AKS8031893,97,16,10,6,1
SBI71XFH9623037,97,25,22,3,1
SBI66SJW6207523,93,31,23,8,1
SBI77LBT7253230,90,19,17,2,1
SBI34UFS5963406,77,27,15,12,1
SBI51IPM0512776,82,24,13,11,1
SBI31LDI4735368,68,29,18,11,1
SBI81EUF6933848,74,30,27,3,1
SBI29NQI1908249,83,12,8,4,1
SBI49JTS1202891,95,24,14,10,1
SBI80FIB8651420,87,24,17,7,1
SBI42COA6625484,62,23,21,2,1
SBI67STG1970788,97,24,20,4,1
SBI14ZYI7243484,62,29,18,11,1
SBI22MXX1563362,84,24,19,5,1
SBI43WHE8329834,76,20,19,1,1
SBI90BUL4198118,95,23,12,11,1
SBI97ZMK6127289,98,30,22,8,1
SBI63EOB6612080,78,28,21,7,1
SBI37FTE1844140,61,17,12,5,1
SBI42PIN1696176,61,25,21,4,1
SBI79PDM0982003,96,25,21,4,1
SBI45RHA5189456,60,22,14,8,1
SBI62GQN0459547,71,27,26,1,1
SBI96JAO4374799,79,20,14,6,1
SBI38CQG2687409,22,20,18,2,1
SBI75YEW7652354,61,22,14,8,1
SBI14WWB7572613,92,19,12,7,1
SBI00LDO9328509,71,24,13,11,1
SBI90MLF3811305,63,26,25,1,1
SBI80AIF2315034,82,24,13,11,1
SBI24KZX1530963,70,29,16,13,1
SBI08GTS7396085,18,36,29,7,1
SBI22PKQ9879420,98,20,13,7,1
SBI30GLR4787603,83,27,24,3,1
SBI94KBR5819071,87,28,22,6,1
SBI52MXE3681408,68,24,15,9,1
SBI78NQI6520264,77,19,11,8,1
SBI57URL5705241,93,25,16,9,1
SBI78YFK7680384,90,21,16,5,1
SBI20DWF6915352,62,28,15,13,1
SBI33XYU5220197,69,25,18,7,1
SBI16VMV7472572,89,24,15,9,1
SBI47NBG7869596,60,24,17,7,1
SBI13DRC8977984,94,31,23,8,1
SBI41WCG6187899,72,21,12,9,1
SBI45NZW7350294,95,22,15,7,1
SBI23XMP2123045,60,27,19,8,1
SBI09ALC1402417,23,29,15,14,1
SBI11FAY6242904,89,19,13,6,1
SBI16CLW4331824,69,17,14,3,1
SBI27ORP0036893,64,26,22,4,1
SBI32STK3397661,78,17,15,2,1
SBI14JRO8625346,60,28,22,6,1
SBI80SIW6186513,68,20,12,8,1
SBI27ILY1497543,63,24,16,8,1
SBI20TUB5286889,71,30,26,4,1
SBI81TGS8260619,21,24,21,3,1
SBI04KAS9959384,92,27,18,9,1
SBI69ALL3541537,66,20,12,8,1
SBI16SGP8526793,24,22,21,1,1
SBI16NQU9913293,71,31,27,4,1
SBI72JPI7370304,84,23,13,10,1
SBI58JXZ2901235,97,30,22,8,1
SBI53KIW7914911,62,31,25,6,1
SBI18NFZ0535193,68,19,11,8,1
SBI46IEC3616606,64,24,13,11,1
SBI46CXY4182768,81,31,20,11,1
SBI10LOK5902750,91,17,16,1,1
SBI24ISP2726850,67,24,14,10,1
SBI30XAV6904624,18,25,15,10,1
SBI92BNM1730412,77,14,10,4,1
SBI36PDL3918671,60,28,23,5,1
SBI30YCB0672144,88,18,13,5,1
SBI90XYD8434724,67,27,26,1,1
SBI10GGJ1132979,25,24,17,7,1
SBI38GAU8839574,67,23,15,8,1
SBI86DKN9838373,60,32,26,6,1
SBI64UPP4141569,95,29,27,2,1
SBI95HPI9854598,64,25,13,12,1
SBI64YVI4027230,76,21,16,5,1
SBI67HCJ5313822,65,23,12,11,1
SBI31NPG3640491,63,20,17,3,1
SBI27TBG5385315,65,27,16,11,1
SBI98LZI1190935,21,21,14,7,1
SBI98CKB1630423,83,23,21,2,1
SBI47JYR0166989,88,26,23,3,1
SBI18COL3559678,18,25,13,12,1
SBI46TFF5075367,75,26,19,7,1
SBI98TUR3484111,23,27,21,6,1
SBI25HSK7647423,87,24,14,10,1
SBI16LPK4769164,89,25,15,10,1
SBI53NYX2842486,91,27,20,7,1
SBI61OEW5745018,93,26,18,8,1
SBI80YEH2268385,69,18,17,1,1
SBI80BFO8911468,61,28,20,8,1
SBI63JMY6919671,24,26,19,7,1
SBI50TTT8663718,60,25,24,1,1
SBI48FDO6135396,99,23,20,3,1
SBI29NMK7796019,76,29,28,1,1
SBI51JIB1910981,99,31,18,13,1
SBI51KTA4814469,85,23,22,1,1
SBI54HTC5287000,68,24,22,2,1
SBI69LSH5503907,75,26,15,11,1
SBI43NTU0526427,62,33,22,11,1
SBI01UDS5213024,86,23,13,10,1
SBI19NKL7885727,70,22,21,1,1
SBI81UVX5828675,88,25,18,7,1
SBI41VPC3676787,20,35,34,1,1
SBI25KCB0456706,94,25,20,5,1
SBI29HHJ9536730,64,31,28,3,1
SBI35ACB3372103,84,32,26,6,1
SBI39GYY8926747,25,29,18,11,1
SBI54OLO6346813,77,29,24,5,1
SBI63APG1818728,95,26,23,3,1
SBI36UAS5721059,61,30,20,10,1
SBI96UFT5541644,97,19,13,6,1
SBI16CIW0320944,89,25,21,4,1
SBI71SMD9820777,73,20,13,7,1
SBI65VFR6709186,95,27,25,2,1
SBI18IKK9676113,60,26,21,5,1
SBI63OLQ1679299,60,25,13,12,1
SBI26TTV4874780,95,30,29,1,1
SBI36PUG6590796,76,19,15,4,1
SBI84EZN9163472,77,31,26,5,1
SBI10IFB2733484,80,31,25,6,1
SBI00UDO3126565,68,21,19,2,1
SBI22NHU7011958,73,24,23,1,1
SBI42LFF9038778,85,28,21,7,1
SBI54TUN7396771,63,26,21,5,1
SBI06ZMM2877175,84,30,25,5,1
SBI49QSB5310688,23,20,17,3,1
SBI20NEX7653335,65,21,19,2,1
SBI15KDJ2442562,99,26,17,9,1
SBI77ZXW9729086,80,28,15,13,1
SBI67PCK6644176,72,26,18,8,1
SBI40ACE3188070,92,27,16,11,1
SBI35KHS5595214,70,24,14,10,1
SBI70JKL0102857,62,32,25,7,1
SBI47UNK5665762,61,20,14,6,1
SBI11ZNM7091265,60,28,24,4,1
SBI13TJG2056218,99,28,21,7,1
SBI37UGL6602096,72,18,16,2,1
SBI04ATA9362258,69,22,19,3,1
SBI32YPX2806336,97,24,23,1,1
SBI13PZC1654298,62,19,12,7,1
SBI79WCC9450228,63,31,18,13,1
SBI68YES3594844,89,26,22,4,1
SBI89PKD4354661,81,13,8,5,1
SBI89QTB7582093,96,20,14,6,1
SBI80SFZ5695914,99,25,19,6,1
SBI70SFX6434563,23,25,24,1,1
SBI19NLV9527396,74,27,15,12,1
SBI76XAV4017479,62,22,19,3,1
SBI85MLC1239617,94,16,11,5,1
SBI47NBC2770869,83,12,10,2,1
SBI91APN6911055,75,26,15,11,1
SBI34SNW6212331,92,18,17,1,1
SBI85ATS9182746,23,25,15,10,1
SBI44FQW0366295,62,23,17,6,1
SBI42NDL0463094,83,27,15,12,1
SBI00IYY1076835,20,27,17,10,1
SBI65YGA4786719,81,20,12,8,1
SBI22URU5014593,79,25,15,10,1
SBI62DNS6367760,18,12,7,5,1
SBI83XHK9972579,62,25,20,5,1
SBI81VJC5148444,66,21,12,9,1
SBI88TBH4377060,90,25,17,8,1
SBI97DSO4106206,72,27,26,1,1
SBI59KUZ6823591,23,26,23,3,1
SBI15FLT0183900,77,14,10,4,1
SBI52ROZ1325851,21,26,15,11,1
SBI99NSF1308188,80,28,20,8,1
SBI98KQR2250677,86,34,19,15,1
SBI68PXG5784730,22,26,17,9,1
SBI73YCR2176314,96,35,34,1,1
SBI30WYQ5870464,84,28,21,7,1
SBI54AWR4873515,80,21,20,1,1
SBI14IUX8939049,69,22,15,7,1
SBI10NRK8988031,86,18,16,2,1
SBI60URL6724917,67,37,19,18,1
SBI54AWA4531573,72,26,20,6,1
SBI55QJZ8348376,19,14,11,3,1
SBI99GNW5774215,84,23,16,7,1
SBI98AFK4569684,75,29,21,8,1
SBI57EBK0871689,99,26,19,7,1
SBI27ZMG2926661,81,22,14,8,1
SBI13PWO4004412,86,23,15,8,1
SBI10UOM0933401,77,29,23,6,1
SBI51XMQ7777022,85,22,14,8,1
SBI70KGK7188411,72,22,19,3,1
SBI05ZFC9306708,24,24,18,6,1
SBI25RUN7089988,68,27,19,8,1
SBI99MRB6506668,89,27,20,7,1
SBI93EBJ3988385,62,18,15,3,1
SBI46JFU5187289,72,24,17,7,1
SBI16UBA3242023,92,31,25,6,1
SBI45ZWV8489694,92,27,16,11,1
SBI38CDX9476756,68,25,24,1,1
SBI72VTQ3894904,65,31,26,5,1
SBI34WDK4323797,71,17,10,7,1
SBI16ZWB2979043,89,18,17,1,1
SBI72ZZB1889446,89,25,14,11,1
SBI36LOD2978989,73,20,13,7,1
SBI78CEZ2506834,67,25,15,10,1
SBI06RNX5610966,80,22,18,4,1
SBI08HLT8383729,76,21,14,7,1
SBI51NZR3307104,65,25,23,2,1
SBI17VHQ2032823,22,14,13,1,1
SBI43VYV7481928,20,27,19,8,1
SBI16VJE7300333,79,34,24,10,1
SBI48GGL2358908,78,30,24,6,1
SBI58MPP4751338,67,23,15,8,1
SBI40MMN3520682,95,27,24,3,1
SBI38PGA7404879,96,22,13,9,1
SBI81WBO0489996,87,31,28,3,1
SBI86ULP6072752,67,25,18,7,1
SBI12GFZ1555780,78,28,26,2,1
SBI00YDZ2421880,18,39,24,15,1
SBI84IRE9158368,79,23,21,2,1
SBI52KXK8230558,95,25,16,9,1
SBI16THQ7914158,88,33,31,2,1
SBI68ZUJ8404275,25,26,18,8,1
SBI71PDZ8709353,71,20,16,4,1
SBI30FEX8518708,19,17,11,6,1
SBI97QGS6055977,98,29,18,11,1
SBI76WRU9867838,78,13,10,3,1
SBI93NQF1952123,97,27,25,2,1
SBI19LAV1493654,21,33,28,5,1
SBI38XCW1424287,68,18,15,3,1
SBI82BUW0535057,90,22,13,9,1
SBI11ELL9455986,74,24,17,7,1
SBI28EKJ5227495,83,14,8,6,1
SBI54KCA4137346,81,25,24,1,1
SBI84FTK9946361,72,26,21,5,1
SBI20AQD3393364,82,30,29,1,1
SBI58QPO2216352,18,30,28,2,1
SBI90OUK3984790,21,26,17,9,1
SBI97ODI7135725,99,19,11,8,1
SBI85AMY6217558,76,32,25,7,1
SBI96JWJ7546126,77,23,13,10,1
SBI97RKU2112557,79,29,16,13,1
SBI10ERH7641110,73,29,20,9,1
SBI66YLK2464843,73,18,11,7,1
SBI64JSY4538371,71,21,16,5,1
SBI33TQR7627895,94,27,15,12,1
SBI64CRT8673551,96,30,26,4,1
SBI25UWU6290847,71,25,14,11,1
SBI27RHL2393039,84,14,10,4,1
SBI92PEH7948649,88,25,24,1,1
SBI25CBK4614293,24,27,26,1,1
SBI56HOL4094623,87,31,27,4,1
SBI25WDS5749253,69,28,24,4,1
SBI65SRU3314820,95,11,9,2,1
SBI87TOB6117384,68,27,23,4,1
SBI16YZI1464143,68,26,18,8,1
SBI06AOZ7775049,87,31,21,10,1
SBI61BFZ3393596,64,24,18,6,1
SBI13OSY4133403,80,13,8,5,1
SBI24HKC8053521,96,24,14,10,1
SBI91NYN7839814,84,18,11,7,1
SBI96HBO6322865,74,27,17,10,1
SBI60SPP5765650,82,30,28,2,1
SBI64QPX8056496,18,19,15,4,1
SBI20JEG6894668,91,21,14,7,1
SBI51ZOF1374788,88,33,20,13,1
SBI79LJF2629757,85,19,15,4,1
SBI30PTD9996030,95,25,16,9,1
SBI32TWL3035654,67,27,20,7,1
SBI01CMX6493623,98,31,20,11,1
SBI54YVJ8209520,87,26,16,10,1
SBI37HTN9657358,18,32,22,10,1
SBI10BWC8343540,71,17,13,4,1
SBI86CHH7032366,62,30,29,1,1
SBI34BUL2724956,94,29,21,8,1
SBI32HDT4396526,24,23,20,3,1
SBI17LQA2296516,74,25,24,1,1
SBI46UFP6992910,86,23,13,10,1
SBI84XNH6513844,97,25,14,11,1
SBI15MYC3962317,97,31,22,9,1
SBI46FKY8939360,95,29,27,2,1
SBI42PMH0116362,99,24,23,1,1
SBI06DNP3635095,60,31,22,9,1
SBI13NGF4943278,69,33,17,16,1
SBI86OKQ5030369,88,17,10,7,1
SBI34FUF7846923,77,24,21,3,1
SBI83ORG8741980,98,13,8,5,1
SBI41RKM0428666,81,24,21,3,1
SBI62WBU7316659,73,25,13,12,1
SBI31EUJ1483499,98,23,21,2,1
SBI79YHE8471476,76,15,8,7,1
SBI99WZE0514465,88,28,16,12,1
SBI58HNY4320865,77,23,19,4,1
SBI63DKV8455619,80,29,19,10,1
SBI16GEE3320555,60,31,29,2,1
SBI00BBQ7736227,98,20,18,2,1
SBI90JLU5128508,99,22,19,3,1
SBI60ENI5747154,64,27,24,3,1
SBI66VNU4783625,66,26,22,4,1
SBI02TCP3126531,99,23,12,11,1
SBI24GDQ6924612,70,32,27,5,1
SBI63CLJ6907916,83,33,26,7,1
SBI91WPJ6797782,66,26,25,1,1
SBI67WBR2527114,73,12,10,2,1
SBI85PDU0765809,20,24,14,10,1
SBI75MEP9060328,66,22,18,4,1
SBI02IRS6011554,89,27,15,12,1
SBI82CBU6035130,69,31,28,3,1
SBI43GMQ4013857,18,31,28,3,1
SBI01BTD5233306,97,33,30,3,1
SBI51HXB6684445,88,18,17,1,1
SBI08EPR6348025,95,18,14,4,1
SBI27OUO4044000,95,25,20,5,1
SBI53JTI0014988,62,28,23,5,1
SBI15KYF6885436,80,25,20,5,1
SBI49CXH7382736,92,28,15,13,1
SBI11IKQ7702993,19,15,12,3,1
SBI62GLL8592039,95,32,23,9,1
SBI26TJE2752202,83,21,11,10,1
SBI02DPM9924455,94,26,18,8,1
SBI81RIA4169642,63,23,13,10,1
SBI72IDE0308520,20,17,12,5,1
SBI07KUU5721695,95,21,14,7,1
SBI92XVW8088564,61,26,15,11,1
SBI51OKD2510081,23,20,18,2,1
SBI79KPG0100290,65,21,13,8,1
SBI66CNS2337382,76,21,12,9,1
SBI91KIG8934609,89,37,22,15,1
SBI58DUI2082838,84,24,15,9,1
SBI52CFL5339468,21,25,15,10,1
SBI74RTT5834284,98,26,22,4,1
SBI35GIG5254620,25,21,13,8,1
SBI43KZC4353054,80,22,15,7,1
SBI34AGB7519692,74,22,21,1,1
SBI79SCW9249406,25,26,15,11,1
SBI61CVH5637623,71,24,18,6,1
SBI34KLH8602265,18,27,23,4,1
SBI48WHD2341119,78,29,28,1,1
SBI56UWN1733027,61,26,23,3,1
SBI51UPJ5511006,91,31,21,10,1
SBI18HMO0467517,68,26,15,11,1
SBI34TTV7122651,89,23,16,7,1
SBI20TED4469130,74,21,12,9,1
SBI55QQH1573128,73,21,12,9,1
SBI16EQO3989836,69,34,23,11,1
SBI43KWL0718740,92,24,19,5,1
SBI72EKI5717155,81,20,16,4,1
SBI98ELR6526824,64,22,18,4,1
SBI28SPF2392370,89,35,19,16,1
SBI16TZY6859277,64,31,24,7,1
SBI77TCK7934937,85,18,10,8,1
SBI58CNQ7562512,99,29,15,14,1
SBI38KVV4667465,97,28,17,11,1
SBI75UAI7819783,82,18,10,8,1
SBI46MSS0754764,25,32,18,14,1
SBI27MSR6030632,74,26,23,3,1
SBI18SLW0963653,20,28,16,12,1
SBI05ACH8618139,92,28,19,9,1
SBI81NUA3998124,99,25,24,1,1
SBI70HQF0409517,93,22,17,5,1
SBI46KKP2494460,93,24,16,8,1
SBI69TSY2835444,91,22,21,1,1
SBI37QIM5034906,85,24,20,4,1
SBI17QTD9501214,70,14,8,6,1
SBI38OWX9344472,86,26,16,10,1
SBI71MHY5725911,71,29,24,5,1
SBI12OSW5861594,73,20,16,4,1
SBI09CXV7879792,86,23,19,4,1
SBI28IUE8176584,94,32,24,8,1
SBI52NUJ6759540,75,17,12,5,1
SBI97DGD3787071,88,15,14,1,1
SBI98BDW7714722,89,33,29,4,1
SBI19KDM6540367,60,32,17,15,1
SBI46RPU8842473,68,17,13,4,1
SBI31UXX3002298,97,31,30,1,1
SBI35ATY3215896,93,19,14,5,1
SBI48KPR3582896,60,31,16,15,1
SBI07FEC8563836,80,27,21,6,1
SBI24GVW9830620,21,30,27,3,1
SBI84LKP9225408,62,24,19,5,1
SBI41YGA3682227,97,22,18,4,1
SBI39LFX7486422,86,21,15,6,1
SBI49PTU5404387,63,22,13,9,1
SBI45PLB0614887,79,30,16,14,1
SBI13EFC8748438,21,19,11,8,1
SBI01NIW2693992,90,30,18,12,1
SBI57GGO9218789,88,20,19,1,1
SBI11SLQ8710755,19,23,16,7,1
SBI80TAF5902964,60,26,23,3,1
SBI95BRS0776873,72,9,7,2,1
SBI06SIW0037169,97,23,13,10,1
SBI44ZKW8552213,74,25,14,11,1
SBI32WON6360777,94,12,7,5,1
SBI52OUQ2004962,85,19,13,6,1
SBI80DYA1407959,81,14,8,6,1
SBI46BZB8831198,66,25,18,7,1
SBI08GKY8639458,72,23,14,9,1
SBI11GPP0498017,85,25,22,3,1
SBI08YAH1200295,61,29,21,8,1
SBI23AEZ5326600,75,24,22,2,1
SBI23JIN0720647,70,32,30,2,1
SBI54VOT1305132,96,26,19,7,1
SBI64BVT9923268,69,38,28,10,1
SBI40FPJ6248282,61,27,24,3,1
SBI72SZP3557027,83,25,21,4,1
SBI28GMK0441522,72,19,18,1,1
SBI09TWR3869443,86,20,18,2,1
SBI31HJN4894615,77,22,20,2,1
SBI81DNX4337481,66,21,17,4,1
SBI42EMT1743276,86,32,19,13,1
SBI20HTB7103945,75,21,20,1,1
SBI03PYM8030715,74,24,13,11,1
SBI55NJE1753253,60,25,20,5,1
SBI96TMD4304256,80,19,14,5,1
SBI03CZW5320047,67,19,12,7,1
SBI24CCE1966091,79,24,18,6,1
SBI02MWR6603281,60,32,31,1,1
SBI54ZRX9978849,66,23,17,6,1
SBI44NBX3218512,97,23,18,5,1
SBI00SRJ3790742,73,33,28,5,1
SBI04DKP3961758,71,19,17,2,1
SBI06KZN7049138,74,25,17,8,1
SBI54XFF1848953,82,23,19,4,1
SBI73HUL6487759,84,23,17,6,1
SBI07IQB1644721,69,29,15,14,1
SBI84FVO2435023,61,27,17,10,1
SBI36MPC3804152,73,32,27,5,1
SBI26OLL4890808,72,27,25,2,1
SBI15LHJ8179081,94,26,23,3,1
SBI52OYB7819002,83,23,22,1,1
SBI42CBP1031863,76,31,26,5,1
SBI64SPI0151033,90,26,18,8,1
SBI01XVR7516681,79,30,26,4,1
SBI68VEQ5809950,86,35,29,6,1
SBI42HBI2946465,99,20,16,4,1
SBI53SEM7475608,98,23,22,1,1
SBI86DFF4778602,21,27,20,7,1
SBI37ZDU7757281,93,18,11,7,1
SBI30IUU3565063,86,19,17,2,1
SBI71LPJ1122938,74,28,26,2,1
SBI18LUT8018726,77,37,32,5,1
SBI84JVY2221228,93,31,19,12,1
SBI84RMN9808928,64,23,12,11,1
SBI35GXC6907507,99,27,24,3,1
SBI78BZK8604529,88,30,29,1,1
SBI73OKI7648550,68,21,18,3,1
SBI45DFG6225393,99,17,14,3,1
SBI50KHL5583551,21,29,26,3,1
SBI30NBP8123471,81,26,23,3,1
SBI55GTS1997650,83,22,13,9,1
SBI46CXO7676026,95,27,14,13,1
SBI13IVL2439431,72,18,13,5,1
SBI13TZA7423085,24,26,14,12,1
SBI97MTO0034125,74,25,24,1,1
SBI89NXA2464972,22,29,23,6,1
SBI68NZP1858581,83,26,16,10,1
SBI36XAD3813912,91,25,14,11,1
SBI72RJC8515533,79,24,14,10,1
SBI07VPD3631545,87,29,27,2,1
SBI09YBF8184461,75,25,13,12,1
SBI08HLQ6589316,95,17,13,4,1
SBI99LAX1925143,87,27,21,6,1
SBI52MCJ0274580,91,27,16,11,1
SBI30DDK9545817,84,19,10,9,1
SBI93NFO9909808,93,26,25,1,1
SBI24ZMP8170665,65,23,21,2,1
SBI06ESB2675879,24,21,18,3,1
SBI59BEQ5482348,83,34,29,5,1
SBI28ERM8332313,21,29,22,7,1
SBI27GTK4914175,86,26,20,6,1
SBI48VSN4905217,91,18,17,1,1
SBI46LRT2403334,20,18,11,7,1
SBI78HTI6074519,85,23,20,3,1
SBI50JIA2175119,65,20,12,8,1
SBI85UEQ5179033,71,20,16,4,1
SBI42CVH8424583,73,28,19,9,1
SBI27JET6132125,94,19,11,8,1
SBI58NXB2027199,23,19,14,5,1
SBI02LPD8533305,19,23,16,7,1
SBI84XJL5160969,94,28,20,8,1
SBI00UFC6648838,83,28,26,2,1
SBI22MPE9660980,69,32,27,5,1
SBI37FYW7766463,77,15,11,4,1
SBI94NSJ7638237,75,25,23,2,1
SBI21HEZ5576888,86,21,17,4,1
SBI11SON2718995,70,15,9,6,1
SBI79ZDI2520630,73,26,16,10,1
SBI10AIJ9279897,84,28,19,9,1
SBI43MFP2765267,89,26,22,4,1
SBI99AXB9428288,92,26,19,7,1
SBI33BLL3410283,87,26,23,3,1
SBI06LSW3082674,74,25,17,8,1
SBI79CTM3610966,97,24,13,11,1
SBI02HEA9063454,87,19,13,6,1
SBI94UPW0547161,87,19,15,4,1
SBI12MCC0368602,89,28,27,1,1
SBI63GKJ0526861,81,23,18,5,1
SBI07TXP2037078,96,29,16,13,1
SBI38BSR3894984,99,22,14,8,1
SBI31CKC4419476,71,26,22,4,1
SBI09JBG1387006,19,29,16,13,1
SBI74EUA0692858,97,29,25,4,1
SBI89VBX0087744,70,27,21,6,1
SBI04BQF1725431,62,23,20,3,1
SBI52MFD4080219,24,32,18,14,1
SBI65EJZ0697000,70,26,14,12,1
SBI75WLH3559384,71,20,14,6,1
SBI45MAN9947330,20,27,15,12,1
SBI74YGO1015312,92,33,22,11,1
SBI86OPO2290128,63,27,18,9,1
SBI80WJO6371243,83,23,13,10,1
SBI58AUY6584942,99,24,21,3,1
SBI06XQC9233520,18,39,26,13,1
SBI27UHV4822180,19,24,18,6,1
SBI73LBT4418090,99,14,9,5,1
SBI64QDB9259440,81,30,27,3,1
SBI83FFJ8909794,91,29,21,8,1
SBI34XRZ3126444,86,15,9,6,1
SBI93JNA5954652,78,19,11,8,1
SBI71GOU0520944,93,28,26,2,1
SBI51FXS6876884,66,25,14,11,1
SBI75TMQ0683442,78,26,24,2,1
SBI04OWB0817087,18,27,18,9,1
SBI36XJJ3150780,20,24,15,9,1
SBI61DBZ8659260,69,21,12,9,1
SBI85GCF8487735,97,17,13,4,1
SBI05DXH7171399,75,26,18,8,1
SBI04PZA1803452,79,20,15,5,1
SBI45TBU6154179,89,19,12,7,1
SBI70QMP0138544,88,23,19,4,1
SBI70VPW6379353,89,21,17,4,1
SBI31JFD7608619,80,23,13,10,1
SBI08OFC9258056,75,25,22,3,1
SBI55KWS0917095,88,29,26,3,1
SBI35XTV2916553,97,27,26,1,1
SBI27YMN3936842,65,31,16,15,1
SBI36EIV8104168,68,26,25,1,1
SBI02EFH0175608,66,18,15,3,1
SBI75DNF1293365,60,16,10,6,1
SBI11XZQ4322167,22,26,16,10,1
SBI79DCC4405469,24,26,16,10,1
SBI20PZX2460591,71,29,16,13,1
SBI07JFY5830403,87,28,22,6,1
SBI13FWF9142011,70,33,29,4,1
SBI51XMT0415196,82,14,8,6,1
SBI25BIM6748177,82,22,18,4,1
SBI46KND2988361,63,28,17,11,1
SBI89ZDK2325422,72,26,22,4,1
SBI80SJS0668146,92,31,27,4,1
SBI95HYL6256415,62,25,20,5,1
SBI30RGJ4071379,82,26,17,9,1
SBI31AYS1929061,76,27,16,11,1
SBI70AQZ2254085,96,21,18,3,1
SBI70LJS2112760,85,15,10,5,1
SBI26FYG7096041,86,24,13,11,1
SBI51BYN2783381,99,19,18,1,1
SBI49FGP3013967,20,25,23,2,1
SBI79FYM8477805,93,17,12,5,1
SBI78LYA2145568,65,23,19,4,1
SBI55WRO7010071,96,21,14,7,1
SBI87JNI9491531,19,22,19,3,1
SBI63XPL5153269,88,29,21,8,1
SBI32NKB7366795,21,29,21,8,1
SBI32KXH2380285,94,22,13,9,1
SBI75SEM1269410,77,23,18,5,1
SBI58FDC3764569,71,27,20,7,1
SBI06ORB4423018,72,14,12,2,1
SBI72JWF3983902,86,21,12,9,1
SBI04MDR8024092,85,24,22,2,1
SBI02EIE1054002,69,33,20,13,1
SBI35LSF4862879,67,27,20,7,1
SBI34QFN8193029,83,25,23,2,1
SBI59HPP4908646,61,19,12,7,1
SBI58OYJ4490333,97,20,16,4,1
SBI36FTY7982255,77,25,16,9,1
SBI01FWT8715313,95,28,20,8,1
SBI93BQC6749515,66,20,18,2,1
SBI33OEY4735633,19,20,13,7,1
SBI00DJT3535834,76,21,14,7,1
SBI29UWL9601193,75,21,20,1,1
SBI81PQN5658441,68,18,14,4,1
SBI63ZNH0721391,21,21,11,10,1
SBI27RXZ5760163,24,21,15,6,1
SBI74EWZ3587737,22,31,21,10,1
SBI86QUI3433976,98,27,15,12,1
SBI08YHI5232761,86,22,21,1,1
SBI76CYE7448799,66,25,19,6,1
SBI32FKW5698799,95,35,28,7,1
SBI46IZC8201052,23,18,16,2,1
SBI72ACT2452099,96,27,26,1,1
SBI17IDX0103404,74,27,17,10,1
SBI75SOK0496726,79,18,14,4,1
SBI37ZRA2940078,81,23,20,3,1
SBI15DDV3671996,62,30,22,8,1
SBI10GIE2057196,99,18,12,6,1
SBI78OOX9016285,75,25,17,8,1
SBI08LGY9908971,74,35,23,12,1
SBI85USS4937556,69,30,28,2,1
SBI60AFF0045286,25,13,8,5,1
SBI05BCI2029678,22,22,19,3,1
SBI79RKC6252418,86,28,16,12,1
SBI05PHU6888599,84,27,25,2,1
SBI67UOX7808341,93,17,14,3,1
SBI01HAV0068772,68,20,19,1,1
SBI77SUL8495146,72,27,16,11,1
SBI26GAM1767702,61,35,24,11,1
SBI52YNH0960493,81,29,25,4,1
SBI45LHN7464214,64,25,18,7,1
SBI43XOP6589825,99,19,11,8,1
SBI55EYY0692361,75,13,11,2,1
SBI52BJP0059991,61,24,13,11,1
SBI70RCC5741630,88,24,16,8,1
SBI26BCI7185083,87,30,24,6,1
SBI99ERD7620824,72,23,22,1,1
SBI06BIQ0095604,87,17,15,2,1
SBI30SLY5133384,75,26,19,7,1
SBI32AUC7158653,93,27,18,9,1
SBI36TYB3963654,63,37,30,7,1
SBI03EMI0518781,70,25,20,5,1
SBI02YQK4303585,90,19,18,1,1
SBI67QRJ9464449,79,22,21,1,1
SBI58IMB4396802,67,30,28,2,1
SBI62LQT0481713,66,23,16,7,1
SBI37FVL0647933,94,24,14,10,1
SBI81TUG9507944,67,16,13,3,1
SBI93HRP3697249,89,24,13,11,1
SBI55HUW2162855,95,20,13,7,1
SBI92PTF5684955,67,20,16,4,1
SBI13RUL2351965,72,28,16,12,1
SBI56JBK8568007,19,25,17,8,1
SBI52YYX9360006,76,23,20,3,1
SBI48UDL8294754,87,24,14,10,1
SBI66DTV5288136,65,18,13,5,1
SBI04VXJ5945102,99,27,19,8,1
SBI12YWL8402047,90,29,24,5,1
SBI79HNU2093417,84,28,18,10,1
SBI78ILJ8066484,85,32,29,3,1
SBI39KGT6432334,86,28,18,10,1
SBI27URK2555070,80,30,23,7,1
SBI79FOQ9315762,99,31,18,13,1
SBI75YAY5793541,94,28,17,11,1
SBI31TGU5501031,75,32,30,2,1
SBI31RYQ5958774,63,24,13,11,1
SBI33VDS6750961,91,34,19,15,1
SBI14MHS4250882,81,29,28,1,1
SBI91QFL9105087,19,24,18,6,1
SBI27BWS9500176,83,29,26,3,1
SBI07SHF2808433,95,21,13,8,1
SBI50GMP8070625,82,20,11,9,1
SBI24DLM3284977,87,20,19,1,1
SBI52QGS0402991,61,24,16,8,1
SBI67ZBM6010143,20,25,14,11,1
SBI08WHQ0027345,93,27,21,6,1
SBI89VDP5543043,93,17,12,5,1
SBI37ZSL8882109,83,25,14,11,1
SBI46UBB2681258,63,33,24,9,1
SBI75MEW5672741,83,24,19,5,1
SBI03TGL0287045,77,20,11,9,1
SBI90EDY0622742,19,36,31,5,1
SBI62YRI1262102,19,21,14,7,1
SBI94MHC8581431,69,17,16,1,1
SBI14SLO7979410,78,24,13,11,1
SBI33MYF9600241,87,17,14,3,1
SBI35ZGG1488028,84,25,23,2,1
SBI29DGR5039667,94,18,16,2,1
SBI93MNM7307612,74,36,21,15,1
SBI53GDN7911404,64,24,20,4,1
SBI74SVE9777448,20,25,23,2,1
SBI05JME7154164,86,26,23,3,1
SBI09RMY1343260,89,23,22,1,1
SBI10PYQ6097584,67,25,15,10,1
SBI62LET2924133,94,23,18,5,1
SBI28WZV5264425,94,24,19,5,1
SBI02SVN4954517,77,27,16,11,1
SBI97TWT6610404,86,33,20,13,1
SBI21FYE8700439,91,22,19,3,1
SBI22WFZ1279638,99,19,12,7,1
SBI05KPO6278375,66,32,22,10,1
SBI51PJW0122897,77,29,24,5,1
SBI04ZTZ7787633,96,25,18,7,1
SBI91ITH5793475,74,17,15,2,1
SBI41LHE8518673,75,15,11,4,1
SBI34YJM3833933,94,20,18,2,1
SBI41WDU8740664,71,32,31,1,1
SBI75HFQ8365683,87,18,15,3,1
SBI63PXC1529376,91,26,19,7,1
SBI27YPJ7112488,78,31,30,1,1
SBI93QPV0187588,24,16,13,3,1
SBI59MOX2562221,67,28,25,3,1
SBI45XBZ6105671,23,17,9,8,1
SBI01SHL9988486,70,22,13,9,1
SBI69IEG4791557,78,26,17,9,1
SBI96EMK1134021,20,22,13,9,1
SBI07GBO4950458,87,27,25,2,1
SBI79URA1022645,18,29,28,1,1
SBI06YQQ5635191,88,19,18,1,1
SBI04TJA2666579,63,30,16,14,1
SBI27KPD6655980,80,18,13,5,1
SBI38JSD3619004,99,20,15,5,1
SBI29CVT9076036,81,25,22,3,1
SBI99PNV4882272,89,19,12,7,1
SBI21WNF4245639,60,18,13,5,1
SBI43ERS3737578,96,25,20,5,1
SBI05SWX0256648,67,33,20,13,1
SBI84FLS5219770,92,13,10,3,1
SBI09OCU3498298,83,20,13,7,1
SBI12BWE8008382,72,26,25,1,1
SBI44XQW5532655,80,16,13,3,1
SBI45LEC9363013,93,14,10,4,1
SBI12DLH8447331,84,18,11,7,1
SBI71HTD2027266,95,14,11,3,1
SBI01IGH8929171,65,20,18,2,1
SBI51MFB6376964,86,29,16,13,1
SBI05POQ9616251,95,29,26,3,1
SBI00GUR3214929,89,28,27,1,1
SBI13VEM5598187,75,23,17,6,1
SBI21WXR0044696,60,27,24,3,1
SBI79DEN6729152,83,29,16,13,1
SBI78SRT4581901,98,24,15,9,1
SBI84QVZ6392832,61,24,21,3,1
SBI00RNW2389775,87,28,16,12,1
SBI60QIE5333977,23,22,13,9,1
SBI42RBU1556811,64,30,22,8,1
SBI26DAJ6948949,61,26,20,6,1
SBI64HMV6491290,88,16,13,3,1
SBI55MSL9208316,95,25,14,11,1
SBI60XKS3739367,99,37,30,7,1
SBI82NOD7110747,21,32,17,15,1
SBI93NAV6756963,66,27,15,12,1
SBI98QDH0286318,89,29,28,1,1
SBI52PED0193594,74,15,13,2,1
SBI68ZHY8184416,24,35,29,6,1
SBI72IAB0323659,21,19,17,2,1
SBI65ZWR6535451,24,31,23,8,1
SBI77VZN3737198,84,32,22,10,1
SBI16PAZ1211349,88,29,20,9,1
SBI95PHI0399217,65,29,25,4,1
SBI05QWE3318903,97,22,21,1,1
SBI50AFB5138291,91,21,20,1,1
SBI80GDB3110467,80,27,16,11,1
SBI52MCQ2862375,20,18,13,5,1
SBI48KJZ1331953,99,30,17,13,1
SBI61QNR7916331,92,17,16,1,1
SBI33OFR4956870,19,31,26,5,1
SBI71GWS9444962,72,21,13,8,1
SBI08PNC5242443,86,22,15,7,1
SBI70CNS0142971,74,29,27,2,1
SBI27MMP4961610,84,27,15,12,1
SBI12ZGS5281777,63,33,21,12,1
SBI27JDZ1068302,63,24,18,6,1
SBI59VSF6621249,25,27,19,8,1
SBI15PCU7490113,64,18,10,8,1
SBI58RQI0895667,69,31,29,2,1
SBI09JOT7570396,77,29,20,9,1
SBI54JXU2735672,94,27,25,2,1
SBI69WMX9729021,86,23,12,11,1
SBI20REB0357178,23,15,10,5,1
SBI52RYR2389703,82,22,18,4,1
SBI64RLP9666541,74,15,10,5,1
SBI62KCK7620736,95,17,13,4,1
SBI91AZT8608472,18,35,26,9,1
SBI91NBT5566128,73,31,26,5,1
SBI61ESQ8155026,21,15,14,1,1
SBI20FYR1480475,69,19,11,8,1
SBI41OOC4248471,85,28,26,2,1
SBI04UWG8743425,69,24,21,3,1
SBI08VXF8058691,97,34,19,15,1
SBI45FKW1071549,24,18,15,3,1
SBI05YIC8076966,73,28,22,6,1
SBI61OCS4433646,75,14,9,5,1
SBI01GFV1088579,72,20,13,7,1
SBI01THS6456282,79,24,19,5,1
SBI92YTS0060519,90,24,20,4,1
SBI25UML5579174,94,26,23,3,1
SBI81VLY2589243,96,23,18,5,1
SBI08PFJ9636087,90,27,16,11,1
SBI04YKI8374444,89,22,19,3,1
SBI15IDS7869646,71,27,16,11,1
SBI72SGO5071294,22,18,13,5,1
SBI37SFL4804821,60,24,15,9,1
SBI34UFO4751641,84,34,23,11,1
SBI33XRH2554446,79,24,18,6,1
SBI21ZYL1362449,98,19,16,3,1
SBI30YEV7510937,69,29,23,6,1
SBI03EHR1631535,93,18,17,1,1
SBI73DKP1825745,70,29,27,2,1
SBI58TBQ6551798,61,24,16,8,1
SBI51EHP6115979,77,22,12,10,1
SBI23TMP6013477,90,20,19,1,1
SBI29BAE0622253,99,18,13,5,1
SBI79HLQ5242242,25,29,28,1,1
SBI06HTI4803787,93,26,14,12,1
SBI74HRE1190671,87,22,18,4,1
SBI23LQL7196594,22,31,17,14,1
SBI69NNQ8433619,97,25,20,5,1
SBI68RRO5934082,63,24,18,6,1
SBI67RDO0235160,81,20,12,8,1
SBI58BAA3076724,25,24,21,3,1
SBI78VAS9689814,68,23,16,7,1
SBI57VDR0885136,67,23,13,10,1
SBI85VEQ7410554,71,19,12,7,1
SBI72QID9555038,79,28,21,7,1
SBI68WBE7899319,24,22,16,6,1
SBI14GSA7238166,20,27,24,3,1
SBI64ENM6250133,61,24,23,1,1
SBI93GNF8058231,62,25,13,12,1
SBI29SUT0263629,79,26,14,12,1
SBI67KVY6293523,79,23,20,3,1
SBI31WQK4768310,64,25,22,3,1
SBI84FYX8787523,93,33,25,8,1
SBI86AXA7733622,99,25,22,3,1
SBI68TQS9048830,81,23,22,1,1
SBI26CWH6812345,64,20,12,8,1
SBI46WPB0064716,69,26,18,8,1
SBI71RXE9831794,60,28,23,5,1
SBI45NCA2041349,72,22,16,6,1
SBI56HGW6897136,24,39,30,9,1
SBI08DGW2343693,88,31,19,12,1
SBI17JRH4916026,88,25,19,6,1
SBI24VOG5366729,80,27,20,7,1
SBI49LEO7810680,85,25,20,5,1
SBI20CQF7900759,74,27,25,2,1
SBI52LFP2127934,79,25,22,3,1
SBI86GVP6765915,19,25,13,12,1
SBI54LKE7256360,74,22,20,2,1
SBI89BUY6860563,92,16,13,3,1
SBI65QNO6744701,85,27,18,9,1
SBI92GSP8270470,92,20,16,4,1
SBI47AVQ8476109,94,21,14,7,1
SBI51HKC2682195,98,22,15,7,1
SBI45IRJ8988982,61,24,16,8,1
SBI40OUD8634094,88,15,9,6,1
SBI66BUS4424248,87,27,26,1,1
SBI29YSA7953860,87,30,22,8,1
SBI12WSK7124035,83,28,18,10,1
SBI14XYN4353431,85,29,23,6,1
SBI90SOU4501794,75,25,14,11,1
SBI16NPS4983739,74,21,15,6,1
SBI93LUM0050753,78,27,23,4,1
SBI59TZX1829648,88,29,17,12,1
SBI97DSN3966400,90,27,22,5,1
SBI16IOQ8485875,82,28,27,1,1
SBI55BRL4741967,23,20,18,2,1
SBI48IQM9115558,82,30,19,11,1
SBI22QRK7026758,94,31,16,15,1
SBI77HHB1971467,70,26,25,1,1
SBI04OBD6707520,19,14,9,5,1
SBI09TUD0488845,22,18,17,1,1
SBI66OYM8876522,23,31,20,11,1
SBI21XQY5329660,94,28,17,11,1
SBI68VYU4549465,72,33,31,2,1
SBI77ZYL6163546,25,13,10,3,1
SBI67IDJ4968336,96,26,23,3,1
SBI92YXN4817402,91,26,14,12,1
SBI93DIF2072595,63,26,18,8,1
SBI16JTE4101177,22,26,15,11,1
SBI52HYU6190329,80,30,18,12,1
SBI64SNP5476093,61,28,25,3,1
SBI45GDE2152463,92,29,15,14,1
SBI54TNM4220199,91,24,15,9,1
SBI04GEB2123493,87,23,21,2,1
SBI32QMO8785670,60,25,16,9,1
SBI49BVN4227518,82,25,13,12,1
SBI31DOD8324921,23,23,16,7,1
SBI50HOE6844264,96,23,16,7,1
SBI33JCW1846788,89,29,22,7,1
SBI32EIM0004724,77,23,20,3,1
SBI57QCU8644758,75,19,15,4,1
SBI65LSN1899091,88,25,16,9,1
SBI61XSU2268112,73,19,14,5,1
SBI56AWR5692549,90,29,17,12,1
SBI42OLK5581436,19,26,17,9,1
SBI51QES8320221,87,16,12,4,1
SBI41WHO8437970,84,22,20,2,1
SBI15RSP0055008,80,26,21,5,1
SBI70FFW1320961,64,30,23,7,1
SBI09GIZ3656596,74,25,14,11,1
SBI79OPF5329991,88,29,16,13,1
SBI26EEO7203255,99,32,30,2,1
SBI34BRC7780182,19,32,18,14,1
SBI18BYH9352708,82,24,18,6,1
SBI07LZC7512154,18,24,18,6,1
SBI43PRU8206976,19,28,25,3,1
SBI45QQU2721144,92,27,25,2,1
SBI28GPU1473718,77,23,15,8,1
SBI87GUN3704237,94,20,18,2,1
SBI64EZI2538186,97,27,26,1,1
SBI06QRY8698705,94,19,16,3,1
SBI88STV1543836,71,19,17,2,1
SBI49DBB9569159,83,22,12,10,1
SBI79OBB2096819,97,20,13,7,1
SBI98PQJ6258908,82,25,23,2,1
SBI82NZC9441262,98,25,21,4,1
SBI44IXR4356322,71,26,25,1,1
SBI66BPP8679244,60,33,21,12,1
SBI39QUI0738754,20,24,20,4,1
SBI15LUT0611437,76,23,20,3,1
SBI02YRT7736539,64,24,16,8,1
SBI04UJZ4964099,88,19,11,8,1
SBI35FWF7617348,69,23,16,7,1
SBI56IAP2958088,18,21,12,9,1
SBI38FLH3156641,85,20,17,3,1
SBI89BNO4305963,60,22,18,4,1
SBI52KNM3099957,65,29,22,7,1
SBI71HQY9344742,97,27,19,8,1
SBI64PVZ3883099,98,21,12,9,1
SBI26JYT0091534,83,24,18,6,1
SBI30WDK5619819,99,28,18,10,1
SBI85VIE0955205,91,24,13,11,1
SBI00ZWN6630102,83,18,17,1,1
SBI72DXH5048792,65,18,14,4,1
SBI58NCU2060810,90,18,17,1,1
SBI31SFS1515119,82,24,21,3,1
SBI36LKV3962477,77,16,14,2,1
SBI02LWA2743087,74,17,11,6,1
SBI29WEJ6023204,81,25,13,12,1
SBI95HPO1245599,88,27,26,1,1
SBI25YCF5264945,73,29,26,3,1
SBI04UHJ8087962,66,28,18,10,1
SBI09QJN2454612,68,20,13,7,1
SBI49JRY1243472,77,33,32,1,1
SBI03JWX7244122,96,23,12,11,1
SBI63KUY0889368,25,24,16,8,1
SBI64HWI6587756,85,19,14,5,1
SBI31KYT8913777,93,34,33,1,1
SBI91OXQ7144150,97,28,26,2,1
SBI30GRR4878813,68,22,20,2,1
SBI24NNO6213633,99,24,13,11,1
SBI75QHJ1963280,21,26,18,8,1
SBI04NPY0572664,77,28,25,3,1
SBI48GKH8781112,78,32,26,6,1
SBI30VSC6954594,65,31,28,3,1
SBI51XSN1280163,78,17,16,1,1
SBI35WGF9041576,82,30,19,11,1
SBI64ODM2958157,78,22,12,10,1
SBI07FIY5560199,81,27,23,4,1
SBI41AHE5239673,90,22,16,6,1
SBI23CSW5355345,25,28,15,13,1
SBI61LMI3096092,94,28,22,6,1
SBI49HUI8969803,67,20,19,1,1
SBI16USZ3217578,86,24,16,8,1
SBI74SDW4366621,65,33,21,12,1
SBI88AVJ1742659,21,23,17,6,1
SBI06FGQ9225870,20,30,21,9,1
SBI97QBJ4301320,93,20,17,3,1
SBI72CYS2053034,60,11,8,3,1
SBI03GKR1374079,91,24,16,8,1
SBI99SYK4807793,87,23,17,6,1
SBI25LAS2925059,19,20,13,7,1
SBI14HNH6839615,18,32,29,3,1
SBI14ORQ4915125,67,34,32,2,1
SBI28LLE6531513,61,24,15,9,1
SBI67VDJ8840046,91,24,21,3,1
SBI05UKY7408912,99,31,19,12,1
SBI36MLX5574853,90,29,24,5,1
SBI06SNG0691361,85,19,10,9,1
SBI07UIH7454778,87,30,16,14,1
SBI15ZDW4718291,80,23,15,8,1
SBI17XWD4595365,92,24,16,8,1
SBI83SNF4436324,88,17,13,4,1
SBI17GEN2744787,73,31,17,14,1
SBI15FKR9858629,64,34,20,14,1
SBI32LOX0884679,83,20,12,8,1
SBI28JMV9492064,94,15,13,2,1
SBI79RPH3737650,94,18,14,4,1
SBI26YHT6737898,71,28,23,5,1
SBI64ZSS1204526,83,24,15,9,1
SBI73YYN0524928,71,28,20,8,1
SBI93UES5792527,82,25,19,6,1
SBI55VXY2756033,72,18,10,8,1
SBI32JKI9119046,62,19,14,5,1
SBI86EQR1439102,97,31,26,5,1
SBI44EKU9506635,92,23,16,7,1
SBI03WFG2504078,84,12,11,1,1
SBI77CTG2061235,66,37,24,13,1
SBI20QKK2894509,71,15,14,1,1
SBI53YTV8273103,75,27,22,5,1
SBI63JWX0611952,99,24,19,5,1
SBI48QWT6796248,80,22,21,1,1
SBI07QYF5796856,89,17,15,2,1
SBI11QUR6474457,84,26,22,4,1
SBI47IWU4292686,79,28,23,5,1
SBI30FHY5055581,93,23,22,1,1
SBI23OWP7395341,64,20,13,7,1
SBI47RKN7037676,92,26,19,7,1
SBI98EZZ3618940,25,33,22,11,1
SBI36CJQ0298361,61,28,16,12,1
SBI31HRC0814806,61,33,23,10,1
SBI56BEO7818214,65,17,14,3,1
SBI81VNK9469237,85,25,23,2,1
SBI78NBT7858609,94,29,24,5,1
SBI24JQC2608737,90,23,18,5,1
SBI61XXC5521934,93,33,18,15,1
SBI13FXL0458926,94,24,14,10,1
SBI07ZEQ4419531,90,22,18,4,1
SBI74ZGK2560128,79,21,12,9,1
SBI99TMI5018195,64,30,19,11,1
SBI82WHV3783675,98,15,10,5,1
SBI13XUA0738173,60,22,14,8,1
SBI17MVH9930926,97,31,16,15,1
SBI21JJZ0464372,66,25,13,12,1
SBI80PCK9538914,80,20,14,6,1
SBI95IUC9869815,93,28,15,13,1
SBI81WDM5648382,95,23,19,4,1
SBI97DTZ5591060,88,23,17,6,1
SBI68BGA3273217,81,22,20,2,1
SBI03NSH6031900,63,26,21,5,1
SBI58ISP0829597,61,27,17,10,1
SBI12CNR7355331,92,25,20,5,1
SBI90DES8462150,79,30,17,13,1
SBI22FAC5035839,22,21,15,6,1
SBI12CAU1552032,72,35,31,4,1
SBI77GMQ8070837,25,22,19,3,1
SBI00MEJ0517659,82,23,18,5,1
SBI23QWQ3926009,20,29,16,13,1
SBI45GLU1586070,71,28,20,8,1
SBI54DMF4652085,99,19,11,8,1
SBI21WYZ3650030,82,14,8,6,1
SBI28MNH5267306,74,24,18,6,1
SBI82EZU2472079,92,21,12,9,1
SBI36FQI2710361,22,23,17,6,1
SBI36OZG0163952,88,26,25,1,1
SBI15EFD3213544,74,31,19,12,1
SBI90YGD1751759,93,22,20,2,1
SBI26VXY1867709,90,27,24,3,1
SBI52OUT7937849,19,21,19,2,1
SBI73ZYR6348755,81,16,11,5,1
SBI66MDQ1825223,69,21,13,8,1
SBI99GIY6261371,68,30,16,14,1
SBI29MDM7320782,72,23,13,10,1
SBI44YRL8702003,96,27,26,1,1
SBI87EHF0993011,61,17,11,6,1
SBI75HCX7187831,85,25,21,4,1
SBI43NKX5611055,92,24,13,11,1
SBI88GPC3009131,79,31,28,3,1
SBI03LIK8627681,80,13,11,2,1
SBI00VCE3241998,79,29,28,1,1
SBI01PVW5921969,66,25,17,8,1
SBI63SEC7599476,18,27,22,5,1
SBI24HLD5847704,76,26,24,2,1
SBI25IHN3197676,18,19,18,1,1
SBI67UYD9320834,61,27,19,8,1
SBI69UUQ2175388,97,23,20,3,1
SBI14INZ9188952,72,23,18,5,1
SBI10VMU9011176,89,19,11,8,1
SBI17IYT2496253,19,23,16,7,1
SBI12LHC2990750,91,23,22,1,1
SBI17LCU3096713,85,18,12,6,1
SBI81ZTT0065951,80,20,17,3,1
SBI96JNB9216725,82,19,12,7,1
SBI16GCT9158257,80,28,17,11,1
SBI10UZP8248662,98,19,14,5,1
SBI84SZR1415153,96,25,13,12,1
SBI16MWX2166087,83,31,27,4,1
SBI00JIY6710693,76,18,17,1,1
SBI37DCK8185714,90,23,20,3,1
SBI00VFI3210627,69,29,15,14,1
SBI92GGI0724931,61,27,17,10,1
SBI28FQU9899700,80,21,14,7,1
SBI89SGV6905650,64,21,11,10,1
SBI84XQO9487261,87,19,10,9,1
SBI96GAY4798018,93,24,16,8,1
SBI28HHK8332666,91,19,17,2,1
SBI76XKZ6231106,71,26,24,2,1
SBI25OXA6603645,60,21,12,9,1
SBI20WOK0433291,93,19,17,2,1
SBI30FZD3651787,85,34,29,5,1
SBI79CUX8407777,80,20,11,9,1
SBI07LDK0980517,78,26,22,4,1
SBI63RCY4964740,79,34,24,10,1
SBI85IFI3224497,87,24,16,8,1
SBI99RAT8880455,74,23,14,9,1
SBI42QEP8943725,88,28,15,13,1
SBI58FXI7724987,20,17,12,5,1
SBI61VZK2606133,23,21,14,7,1
SBI85VAB5946711,69,27,18,9,1
SBI05ITF4506211,96,20,18,2,1
SBI68TJI5214429,68,30,20,10,1
SBI00RGP8775133,75,23,20,3,1
SBI95EZK7262984,60,30,22,8,1
SBI14UFT5098858,93,23,22,1,1
SBI84QSJ9278929,85,29,15,14,1
SBI40NYV0424361,18,26,24,2,1
SBI19EQH3340672,85,23,20,3,1
SBI04NYI5687325,25,27,20,7,1
SBI77DVA4851376,73,27,22,5,1
SBI06UFN3194443,92,29,19,10,1
SBI42LWP2224065,86,27,15,12,1
SBI88TZF7322433,60,23,13,10,1
SBI61BAH9245839,90,23,18,5,1
SBI27EOY5973890,76,31,23,8,1
SBI48RUN8235748,19,24,19,5,1
SBI23WEM2724001,81,23,13,10,1
SBI79ITA9883625,88,23,14,9,1
SBI78GQG7547860,80,14,8,6,1
SBI15NKA8357402,96,24,22,2,1
SBI52LZX0445019,79,30,20,10,1
SBI36KQI7528405,73,14,12,2,1
SBI93RFX4261999,92,32,22,10,1
SBI58SQC8939613,18,25,20,5,1
SBI16YUA4642673,94,25,17,8,1
SBI09IKE7067373,64,35,18,17,1
SBI33BWR1800990,95,14,13,1,1
SBI35ZQZ2185248,75,32,19,13,1
SBI68LKV7979599,81,28,17,11,1
SBI64AQI9121321,88,26,21,5,1
SBI03OYR5709306,65,29,16,13,1
SBI23VDD4278119,91,22,19,3,1
SBI90BRS7918245,98,25,14,11,1
SBI80HRG9951300,18,33,30,3,1
SBI69YDQ0134626,94,31,17,14,1
SBI43VIW2359660,76,25,21,4,1
SBI50HVP1662620,65,19,14,5,1
SBI67WLZ2694503,66,23,16,7,1
SBI04HBQ4825630,64,16,13,3,1
SBI65VXD3263222,82,28,17,11,1
SBI33TZE7967630,86,17,9,8,1
SBI95KWJ6831585,23,31,16,15,1
SBI03DBL3123725,82,28,21,7,1
SBI18IZJ0403370,20,27,25,2,1
SBI80QBW1287761,19,21,14,7,1
SBI69BJH3870843,77,33,28,5,1
SBI53YMQ8800893,78,19,12,7,1
SBI09MPT5676145,66,32,19,13,1
SBI97CHO9636804,77,24,18,6,1
SBI04UBQ4569764,20,25,24,1,1
SBI00UUI7856302,74,21,13,8,1
SBI47SUD4678623,85,9,8,1,1
SBI72YXB8921643,63,27,24,3,1
SBI02FVM3367517,81,17,14,3,1
SBI66UXK8785624,82,26,23,3,1
SBI39KTH8255998,78,27,24,3,1
SBI92EDN5708422,75,28,27,1,1
SBI75PBY9386561,97,27,16,11,1
SBI02SSB1749915,24,22,20,2,1
SBI24CHT7012316,21,31,21,10,1
SBI79DLG0576321,69,16,11,5,1
SBI66LPV3683037,71,19,10,9,1
SBI14FFM3656039,71,22,20,2,1
SBI55KUM2769940,92,32,25,7,1
SBI85VTX2220331,60,25,19,6,1
SBI32OYO4637493,21,24,22,2,1
SBI42TNX2422755,97,30,28,2,1
SBI74NBK1522856,98,24,16,8,1
SBI03ICS9150296,60,20,19,1,1
SBI21QMF4524536,78,23,12,11,1
SBI50SGQ2401559,97,27,23,4,1
SBI71HNL6525361,19,19,13,6,1
SBI73GPH5503116,89,20,12,8,1
SBI42KJF3782401,74,33,22,11,1
SBI08WNE1925375,98,26,25,1,1
SBI46NHV9330537,24,25,22,3,1
SBI12AFG6741097,71,25,18,7,1
SBI79HYF6360405,92,25,24,1,1
SBI01CQQ2523571,95,22,14,8,1
SBI57QBM8581291,24,26,14,12,1
SBI86SHY6469346,70,21,14,7,1
SBI32ESP3334891,97,13,10,3,1
SBI65ARX6131751,98,22,20,2,1
SBI29FAW1685238,67,16,13,3,1
SBI03RVL9356280,71,18,15,3,1
SBI07ULP3793939,76,34,27,7,1
SBI83PJZ5312882,20,27,22,5,1
SBI21FKI4715008,75,24,14,10,1
SBI79CCK8640853,74,27,19,8,1
SBI98YQO1726628,85,19,10,9,1
SBI52ZLS2334013,62,24,18,6,1
SBI36ZMV2715484,18,25,17,8,1
SBI99LNA0275221,99,35,18,17,1
SBI74AXQ7018218,96,20,14,6,1
SBI14HOH0091311,85,19,14,5,1
SBI40AUT8335424,21,19,13,6,1
SBI70JNM5395374,84,25,18,7,1
SBI90RMA4804946,81,29,28,1,1
SBI89KQO3933511,20,20,17,3,1
SBI64RIY4000895,84,18,12,6,1
SBI82LWT6674960,78,19,13,6,1
SBI71AIG1837749,21,22,16,6,1
SBI27QPS0698635,85,26,18,8,1
SBI07LGL4399267,78,28,15,13,1
SBI42EEU6618748,63,24,21,3,1
SBI86IXS5733865,66,18,13,5,1
SBI54CDQ6810030,95,17,11,6,1
SBI63DAS9458334,74,28,22,6,1
SBI64EPO6261254,61,8,7,1,1
SBI09JYF7773974,68,17,11,6,1
SBI48CLG8330371,86,15,10,5,1
SBI18ACI9127935,69,25,15,10,1
SBI70AXU9645078,94,28,25,3,1
SBI88TBL2678577,20,28,20,8,1
SBI20HMN2816591,76,24,13,11,1
SBI33LYC6145714,69,19,13,6,1
SBI90JVI8197200,78,26,22,4,1
SBI97ABJ6441616,77,29,25,4,1
SBI71HGS1305894,80,22,19,3,1
SBI96JWM1846867,78,24,17,7,1
SBI96ACS1864150,73,27,20,7,1
SBI16OJV3981671,70,18,11,7,1
SBI32JPD7107940,24,15,8,7,1
SBI10HKM5301646,89,21,20,1,1
SBI45XTN0428395,21,28,20,8,1
SBI45UMD7545225,86,23,12,11,1
SBI29QKS1584874,89,25,14,11,1
SBI85TJP9017556,62,23,15,8,1
SBI28ZPY2678743,99,15,10,5,1
SBI91MIG3764442,79,28,18,10,1
SBI14BOK0351777,82,23,13,10,1
SBI53MIR5547718,20,20,13,7,1
SBI86ZCE0957124,68,27,26,1,1
SBI86FUR5793583,90,33,21,12,1
SBI02SUA7299218,64,27,19,8,1
SBI48MYV2377344,92,21,18,3,1
SBI89RPA2365702,81,25,14,11,1
SBI24TWV3145386,85,30,26,4,1
SBI76IXF2068130,68,26,17,9,1
SBI78CYC4184302,99,24,16,8,1
SBI67TEP1486836,21,29,16,13,1
SBI87WYH9874335,88,26,15,11,1
SBI86FVK5869329,89,18,13,5,1
SBI46HPQ5028950,74,19,16,3,1
SBI72URJ5702171,77,28,18,10,1
SBI41BUS9969439,97,21,12,9,1
SBI90MJL0276055,81,22,20,2,1
SBI40LMB8282372,85,20,19,1,1
SBI58YUQ9892658,60,23,18,5,1
SBI19PPG8557138,76,28,16,12,1
SBI02FTP7980685,69,35,18,17,1
SBI65XJL9513884,61,19,18,1,1
SBI45DWV7030151,23,23,16,7,1
SBI43ZWS0322114,72,30,16,14,1
SBI85YTA6774098,22,16,10,6,1
SBI92NPC8682474,76,24,23,1,1
SBI04GII7542880,97,20,14,6,1
SBI20ZFN5715063,66,25,13,12,1
SBI76AXA1832130,99,23,14,9,1
SBI37FUW5785898,25,22,15,7,1
SBI88HSB4922212,20,20,19,1,1
SBI42WHL7694412,86,27,22,5,1
SBI05VIO3817727,72,35,33,2,1
SBI70LTI7522538,99,24,19,5,1
SBI83CLP6654396,97,29,26,3,1
SBI19GIU1523610,24,18,17,1,1
SBI90CZZ9125452,70,21,15,6,1
SBI90ZZY1025920,69,31,27,4,1
SBI46ASO5852411,81,18,13,5,1
SBI37RIY5164747,73,24,17,7,1
SBI84LNP0203259,67,27,21,6,1
SBI87MRL2241494,73,23,18,5,1
SBI64SGY1173105,62,30,21,9,1
SBI94RYK2450319,73,24,14,10,1
SBI00AAB7074421,63,26,19,7,1
SBI38KPX0552834,84,10,9,1,1
SBI71NPU5221189,86,20,11,9,1
SBI80PUL2246416,78,30,25,5,1
SBI32MMQ8943625,72,24,14,10,1
SBI32ABH3244220,98,20,18,2,1
SBI01CEP5236341,69,27,21,6,1
SBI49XMP7235306,94,23,15,8,1
SBI89UYE4798819,25,28,20,8,1
SBI95MFY1301727,76,28,26,2,1
SBI39CXQ6726212,94,19,11,8,1
SBI11UXA3262279,24,28,16,12,1
SBI33KKE2489654,86,22,13,9,1
SBI78JJE6093419,97,28,19,9,1
SBI70KGD2957462,83,22,19,3,1
SBI15CKX3156040,96,19,16,3,1
SBI25KFH5966754,94,23,13,10,1
SBI85LQJ3339445,94,19,14,5,1
SBI88ASN9734860,64,19,18,1,1
SBI42BSZ5885422,60,27,25,2,1
SBI95UMM5273981,99,26,17,9,1
SBI25ACA4324800,18,26,16,10,1
SBI97MTN6578796,92,21,18,3,1
SBI89NZJ3835471,60,26,21,5,1
SBI73QSI5135029,91,26,15,11,1
SBI50SWA7124911,60,22,21,1,1
SBI67ATC3958551,94,28,16,12,1
SBI55NDR2353856,22,21,19,2,1
SBI86DCR9151118,21,31,21,10,1
SBI17PAG0901087,94,27,22,5,1
SBI02GRB4089623,77,23,13,10,1
SBI42ZZH6882473,78,16,13,3,1
SBI48UKO3759019,94,31,28,3,1
SBI82DJW0724744,68,29,16,13,1
SBI13CGD4298604,67,23,22,1,1
SBI75UFY8888409,18,30,24,6,1
SBI85BZW9971975,83,23,13,10,1
SBI28HBO0856741,92,20,14,6,1
SBI61AXL0033312,77,17,10,7,1
SBI45VCE8936721,25,31,27,4,1
SBI08KUZ0025551,85,19,10,9,1
SBI47PNX8395643,92,28,23,5,1
SBI15WGC4389809,19,33,22,11,1
SBI76USQ7950220,87,27,21,6,1
SBI60WEQ6738101,73,14,11,3,1
SBI59QZO0957758,68,20,17,3,1
SBI02VOY7260055,67,23,16,7,1
SBI35MPP5813246,93,23,18,5,1
SBI87BFW8982747,63,19,15,4,1
SBI77GUZ2618171,65,14,13,1,1
SBI75TFY4445761,77,22,20,2,1
SBI05BDO7090602,82,16,14,2,1
SBI08IPP4374149,65,37,22,15,1
SBI17GNH9431096,22,26,24,2,1
SBI16CHV4381136,88,17,11,6,1
SBI71XUO9594719,83,24,18,6,1
SBI58LTX3166123,87,11,9,2,1
SBI29RSL6918328,89,27,26,1,1
SBI25XYX5536957,77,17,14,3,1
SBI35WRI4634060,64,16,14,2,1
SBI24MBR7001158,63,28,17,11,1
SBI12ADS2237042,21,31,30,1,1
SBI83MDA8446829,20,34,30,4,1
SBI00WXI8416684,74,27,19,8,1
SBI34BYF6279904,94,20,16,4,1
SBI85JDT6254483,93,26,22,4,1
SBI05LLX7010165,61,21,16,5,1
SBI04CDW8212664,76,25,20,5,1
SBI93OSA3515285,78,23,21,2,1
SBI71PLO0610045,93,27,16,11,1
SBI60KWK7482379,61,33,19,14,1
SBI85JVV9296330,85,21,11,10,1
SBI75UYX1399037,65,22,14,8,1
SBI45MWV5379444,80,28,16,12,1
SBI20DTC9554488,81,25,23,2,1
SBI68ZLN6277421,95,34,25,9,1
SBI60BQY0623764,79,22,12,10,1
SBI59OPB3120035,73,24,20,4,1
SBI52OAP3851217,72,33,20,13,1
SBI45JRS9786845,73,23,21,2,1
SBI45SXB3593272,61,17,12,5,1
SBI77UOD3867305,23,23,12,11,1
SBI58LXJ8713994,91,18,15,3,1
SBI34EEW8029527,25,23,22,1,1
SBI80EMF9671150,24,23,13,10,1
SBI79ZWK6463598,20,20,18,2,1
SBI99ZZG4052827,83,17,14,3,1
SBI63LIH3709574,96,19,16,3,1
SBI01MQM8765102,69,24,17,7,1
SBI72QEP4438331,21,26,15,11,1
SBI27IYQ2310896,94,29,22,7,1
SBI28WPD7896399,96,19,18,1,1
SBI26CMD8367390,79,23,14,9,1
SBI47YNM7110642,62,19,14,5,1
SBI98GSY8529248,69,21,15,6,1
SBI38HQS3765537,68,15,12,3,1
SBI38DDP9746316,72,19,11,8,1
SBI42SGM3623323,94,17,16,1,1
SBI70PQQ0992874,82,25,24,1,1
SBI16SSF0920817,97,23,21,2,1
SBI50VIZ3099898,97,22,21,1,1
SBI95COP0650294,18,22,15,7,1
SBI14YBW8678315,90,25,13,12,1
SBI68YKL7000798,62,27,25,2,1
SBI63IHK1559781,88,23,17,6,1
SBI14WDW3398344,68,23,17,6,1
SBI60PVO8292249,98,26,19,7,1
SBI53SGO9357993,18,26,25,1,1
SBI31SVK9220332,23,29,23,6,1
SBI35MDJ2801072,87,28,18,10,1
SBI62NTS7237178,96,16,11,5,1
SBI44HLF3816753,62,33,26,7,1
SBI32UBT8132373,91,25,23,2,1
SBI82KAY3466753,24,28,22,6,1
SBI29MSE2606698,96,13,9,4,1
SBI14GRN4881118,20,20,12,8,1
SBI94HEH1747989,97,22,12,10,1
SBI93ORO6657193,72,13,9,4,1
SBI76GGH8125005,70,28,21,7,1
SBI40HXT3240855,20,21,14,7,1
SBI06RVH9060379,24,32,30,2,1
SBI88PKJ6288490,96,33,23,10,1
SBI34TZT1041965,71,16,13,3,1
SBI86LCR5492648,86,19,17,2,1
SBI79BCT2943747,80,27,26,1,1
SBI48ZTZ7881575,78,41,27,14,1
SBI40LJM7309006,25,21,12,9,1
SBI19GVV2863841,67,26,22,4,1
SBI59QBF9406312,20,20,17,3,1
SBI06ZQP0864387,97,20,11,9,1
SBI13VBY0339811,65,28,16,12,1
SBI06LQC4598485,19,26,18,8,1
SBI09IFU9682473,23,30,27,3,1
SBI85OFQ0777158,91,26,14,12,1
SBI03DNC5105343,20,20,14,6,1
SBI44SJT4593993,91,27,25,2,1
SBI75NNY0974358,69,27,16,11,1
SBI82UOC9196067,78,25,21,4,1
SBI96XXF1069927,89,21,16,5,1
SBI72QSN6852613,87,26,18,8,1
SBI69KJB3541417,82,21,14,7,1
SBI26ZWU1832021,81,28,18,10,1
SBI06ACG1241271,82,31,16,15,1
SBI72MNI6538282,89,29,21,8,1
SBI42NMM4379523,74,29,24,5,1
SBI06OWW4531105,80,26,25,1,1
SBI33RAR8222497,85,18,17,1,1
SBI39DJO3910717,22,18,14,4,1
SBI92ZHA9571114,64,29,23,6,1
SBI83RAL6854269,73,18,15,3,1
SBI94SMY1951270,83,32,24,8,1
SBI02LWH0142445,76,24,19,5,1
SBI61DGP5192440,92,13,9,4,1
SBI18NFU7253339,75,23,14,9,1
SBI85SWT8225815,97,20,13,7,1
SBI07RWS8663760,85,39,37,2,1
SBI92AYQ5634773,94,22,14,8,1
SBI08VSX1621692,92,26,16,10,1
SBI64AVC6986238,20,26,23,3,1
SBI47RKQ9040025,69,17,15,2,1
SBI43ZXG7837863,91,19,14,5,1
SBI80FOQ7426599,77,25,17,8,1
SBI81FXJ4036460,89,22,19,3,1
SBI91QOW6279428,85,20,15,5,1
SBI89LCA0937517,88,34,21,13,1
SBI71DFE0537380,83,25,24,1,1
SBI75CXD4238118,67,24,15,9,1
SBI38ZDZ5097358,85,33,24,9,1
SBI95ONT6343728,90,21,18,3,1
SBI62MLS4475546,85,21,20,1,1
SBI90QFR0798293,80,31,30,1,1
SBI35AQI1504242,62,25,16,9,1
SBI23BZJ6893262,68,29,20,9,1
SBI45KIA5453363,22,27,19,8,1
SBI34STT1870359,79,24,15,9,1
SBI69JUG5109101,86,24,17,7,1
SBI36TTL0417404,69,24,14,10,1
SBI02YEG3339168,22,27,16,11,1
SBI85HHY7289743,76,18,11,7,1
SBI54RQJ1666043,85,28,25,3,1
SBI95GSV4933930,79,23,16,7,1
SBI11BPU7173477,73,35,24,11,1
SBI96TUD5589328,76,26,16,10,1
SBI84KBE0925318,67,32,30,2,1
SBI76ARQ5896133,65,27,23,4,1
SBI15MYV9053212,69,28,26,2,1
SBI24RNL4251587,91,33,28,5,1
SBI36JUK2228822,87,30,29,1,1
SBI40XJP5422528,60,26,25,1,1
SBI36UDI4001766,70,21,16,5,1
SBI95AKV2540027,98,35,23,12,1
SBI45GBZ8743349,74,26,15,11,1
SBI38HIC0668377,25,29,21,8,1
SBI16HFL9766791,64,32,26,6,1
SBI23SOS4924581,72,20,15,5,1
SBI97SKC2752678,87,19,12,7,1
SBI14HHO0311387,97,28,25,3,1
SBI76SAN6610142,89,19,10,9,1
SBI20TRK7638204,23,31,25,6,1
SBI10MHG8143078,81,33,32,1,1
SBI74IKJ7103303,65,17,12,5,1
SBI62KMY7853038,78,19,13,6,1
SBI97XFY9608271,75,34,24,10,1
SBI48EUY3594037,24,19,12,7,1
SBI57SVM6465716,76,25,17,8,1
SBI86WKG9377316,23,25,22,3,1
SBI58ZVE6696384,69,23,15,8,1
SBI54SRO7541229,70,14,13,1,1
SBI53IPM9561889,86,22,17,5,1
SBI64VUO6137990,79,28,16,12,1
SBI03PVY8887347,21,24,19,5,1
SBI82ZQJ0772526,79,23,14,9,1
SBI59CUH5540361,71,28,26,2,1
SBI18KNM3697604,20,29,18,11,1
SBI23UYM7464675,81,20,11,9,1
SBI37TVG2429413,24,26,18,8,1
SBI05RZC4210316,25,31,19,12,1
SBI74IGA5510466,73,21,15,6,1
SBI74FWC0585441,75,32,17,15,1
SBI07AOQ2525044,80,18,17,1,1
SBI52RNW4706718,91,23,22,1,1
SBI29SAQ0893806,65,28,23,5,1
SBI72EEB4057006,71,29,16,13,1
SBI20OUJ2780853,92,25,19,6,1
SBI03MWU0790252,88,23,13,10,1
SBI24VRB6514675,91,24,23,1,1
SBI22HYR7023021,90,23,21,2,1
SBI19MLD9608095,65,26,20,6,1
SBI52XCM5176542,73,24,13,11,1
SBI46PIG0467115,62,28,25,3,1
SBI86ZOE0580356,23,21,20,1,1
SBI90WBE4844568,93,24,13,11,1
SBI13LQM0429175,67,33,31,2,1
SBI98INR7975329,71,34,20,14,1
SBI37JJO2060225,19,24,17,7,1
SBI94AWP4333178,22,21,18,3,1
SBI42COP6814350,93,18,10,8,1
SBI32WYX6008543,18,23,17,6,1
SBI53RCG1151958,61,24,22,2,1
SBI91ONP8073534,84,22,21,1,1
SBI36LJY1424310,99,28,25,3,1
SBI18DXV4514662,20,27,21,6,1
SBI68IGL2509531,80,26,21,5,1
SBI93LSK0098894,69,20,13,7,1
SBI83HMA9703738,79,26,18,8,1
SBI28SVI1577645,21,30,21,9,1
SBI49CKW7995367,92,19,17,2,1
SBI49WOY1141060,74,20,12,8,1
SBI05ITL2576354,65,32,31,1,1
SBI44QFK7471339,97,25,22,3,1
SBI98IBO8057536,64,25,20,5,1
SBI17VEL3489488,91,17,14,3,1
SBI69LMZ9898741,87,26,16,10,1
SBI13VSX5265377,70,21,19,2,1
SBI97JCY9535092,81,27,20,7,1
SBI64RJT3948062,69,28,19,9,1
SBI88YIU3454345,23,21,18,3,1
SBI19WDU7415080,69,33,24,9,1
SBI68FWU0548170,96,30,20,10,1
SBI42BLE2894523,94,27,22,5,1
SBI53AQB2438382,62,30,21,9,1
SBI02QSP0781884,94,28,23,5,1
SBI30JKI2571602,23,19,12,7,1
SBI57UYH9338712,80,22,13,9,1
SBI79GFT3435750,86,23,12,11,1
SBI85SVJ5794335,70,32,24,8,1
SBI61QLP4337933,71,31,28,3,1
SBI69SCG7567480,70,27,17,10,1
SBI57TON1337201,76,29,23,6,1
SBI27SJI0247297,18,27,21,6,1
SBI21YAT8809135,77,23,21,2,1
SBI46PZO1499082,86,24,21,3,1
SBI22AOW5383766,87,23,22,1,1
SBI72PXH5572265,97,22,18,4,1
SBI44PPY2599189,18,32,23,9,1
SBI96BSP4903240,94,26,20,6,1
SBI26LBQ7795457,71,24,17,7,1
SBI35HJX2999892,96,26,22,4,1
SBI23WPV2377407,96,13,12,1,1
SBI55WCU1882450,66,23,17,6,1
SBI34CLM1743035,72,25,13,12,1
SBI05ZXP3522617,73,24,19,5,1
SBI21NBK7179895,74,34,32,2,1
SBI86HTK3469805,70,17,16,1,1
SBI63OLV7052665,76,22,20,2,1
SBI47SAA8972865,62,18,12,6,1
SBI82RCE3387073,89,17,13,4,1
SBI59EEK1874118,93,26,18,8,1
SBI02ABQ1435912,78,30,29,1,1
SBI49AJG4512617,98,27,26,1,1
SBI19UTF7164575,18,32,28,4,1
SBI19GOS3967203,85,13,9,4,1
SBI55NWJ9551754,82,19,13,6,1
SBI59ZDF9084116,20,27,26,1,1
SBI80DDZ6248210,68,29,26,3,1
SBI83MFE8103875,96,19,17,2,1
SBI68UXO7097355,91,20,17,3,1
SBI28SYY5761187,77,26,25,1,1
SBI37DRH3168604,67,23,22,1,1
SBI78AJI3640400,73,29,21,8,1
SBI44OHB2433626,86,26,14,12,1
SBI06KOI3448237,74,28,25,3,1
SBI12XNO1722680,99,20,15,5,1
SBI64OMZ2569405,79,28,15,13,1
SBI44OFC7187048,23,19,18,1,1
SBI97AYX6921110,90,24,21,3,1
SBI76WVF4655079,21,27,15,12,1
SBI06PWQ3685441,70,19,14,5,1
SBI64GVB7517615,97,24,19,5,1
SBI08BYM4157311,69,35,26,9,1
SBI37PYT2451383,63,21,20,1,1
SBI23RXB1171143,66,21,19,2,1
SBI51GQU2856711,80,26,15,11,1
SBI31PEG9746611,69,24,18,6,1
SBI39TMW4009255,80,24,14,10,1
SBI46DPN1856351,90,38,36,2,1
SBI76ZDU8290501,74,13,8,5,1
SBI66TUR8828882,69,27,25,2,1
SBI16KWY5013327,60,12,11,1,1
SBI84TSA5950468,21,26,18,8,1
SBI74JSG1264562,86,35,28,7,1
SBI95NVC7799569,92,28,16,12,1
SBI68ZHW1204610,97,28,24,4,1
SBI69HJW1171891,60,29,28,1,1
SBI28HTX2434338,80,19,10,9,1
SBI57GXC6718238,86,28,15,13,1
SBI34TMU5578584,21,20,13,7,1
SBI17MTP1514130,62,37,30,7,1
SBI98GMT7295621,82,30,25,5,1
SBI18XUJ6849709,82,25,17,8,1
SBI18ZVU9877460,70,30,26,4,1
SBI55UDG4148492,70,35,24,11,1
SBI25QVL4739580,95,27,23,4,1
SBI90ELJ2534863,18,28,24,4,1
SBI96QSL6146300,77,24,23,1,1
SBI04QKI5332120,74,27,15,12,1
SBI45QRW9648284,20,23,19,4,1
SBI84OZW7947751,77,25,13,12,1
SBI00DZF3550912,89,15,12,3,1
SBI20YUI5424274,84,25,22,3,1
SBI46HFU6345103,94,33,17,16,1
SBI91IYZ8677839,90,20,16,4,1
SBI88MEN5972876,65,16,14,2,1
SBI01XCY3221236,88,17,15,2,1
SBI71USX0994951,18,32,21,11,1
SBI24YQU6396071,61,17,13,4,1
SBI41CWA0803599,75,21,13,8,1
SBI71MKO7892809,95,32,18,14,1
SBI66YZI4469447,21,23,17,6,1
SBI79QXZ8994848,83,28,20,8,1
SBI11PNQ9419408,23,23,19,4,1
SBI09AEY8512046,70,27,15,12,1
SBI24ONZ2069497,25,28,21,7,1
SBI92MEG4825958,95,15,8,7,1
SBI79EUX5188721,84,24,15,9,1
SBI85IOB4178723,99,25,19,6,1
SBI12PTA7231961,64,23,15,8,1
SBI90XHC9890408,21,34,18,16,1
SBI45ADD4604158,72,36,34,2,1
SBI33KOT3300311,83,33,18,15,1
SBI66ULF3989840,84,19,13,6,1
SBI76JYR3403165,72,23,20,3,1
SBI08LQA8903250,94,29,28,1,1
SBI10PIE2493946,65,21,17,4,1
SBI65XPR2546363,67,20,11,9,1
SBI37MEL2396130,21,32,28,4,1
SBI62DWN2343372,61,21,13,8,1
SBI03HRC1138050,19,21,15,6,1
SBI13ZVA0598430,88,28,22,6,1
SBI47HZA7522451,98,22,19,3,1
SBI64CUD9219301,74,28,15,13,1
SBI33ITJ4916476,81,30,23,7,1
SBI09LLK6314557,96,25,17,8,1
SBI06PED9504745,65,23,17,6,1
SBI20ENH7349630,89,17,13,4,1
SBI41GKU3002840,98,25,24,1,1
SBI58QPF2980211,19,27,25,2,1
SBI08RRA1819243,77,22,14,8,1
SBI10SXI4100477,89,21,15,6,1
SBI40JTK2549275,89,31,27,4,1
SBI52DFT3055755,88,22,20,2,1
SBI55ZXG3011148,19,15,14,1,1
SBI01VWI0238234,19,27,20,7,1
SBI55DGJ1039565,81,24,21,3,1
SBI81AAV9595295,69,29,19,10,1
SBI03CHD7632264,84,24,18,6,1
SBI80OJE5503546,61,27,18,9,1
SBI38EBU0551438,98,30,24,6,1
SBI03DMZ0215803,71,18,13,5,1
SBI31UBP5161365,84,21,11,10,1
SBI26AME0195973,80,27,22,5,1
SBI21YGM8279687,65,21,15,6,1
SBI51ZEG0489972,64,24,13,11,1
SBI66UFD4319471,63,24,20,4,1
SBI36QNY9733502,81,25,20,5,1
SBI17KOW8294163,23,16,10,6,1
SBI62ILJ0778405,70,21,20,1,1
SBI44EHH5924933,22,18,10,8,1
SBI57HFQ9006438,90,32,23,9,1
SBI84SHL7826270,80,17,9,8,1
SBI95BOA0351377,69,33,29,4,1
SBI88PXO0619952,70,28,17,11,1
SBI60AEW6402992,25,21,17,4,1
SBI59GJJ2068099,75,18,10,8,1
SBI85ZPG7115028,75,26,20,6,1
SBI05AEQ7669561,61,35,22,13,1
SBI45IEX3897677,22,18,16,2,1
SBI94INN7086736,97,26,21,5,1
SBI06FYV4759704,88,25,23,2,1
SBI84QHD3750399,97,19,17,2,1
SBI53DQI1975483,88,26,14,12,1
SBI56TLU4927405,95,24,21,3,1
SBI68QSI1579275,87,26,17,9,1
SBI21WJF3085544,91,24,14,10,1
SBI50SJB4063539,92,22,17,5,1
SBI50CAY3145766,78,24,13,11,1
SBI69QHU9937091,87,16,11,5,1
SBI85KWK8542881,70,25,22,3,1
SBI46JZT4481788,68,29,19,10,1
SBI52QMT3959835,79,24,19,5,1
SBI84SBL6148098,81,20,11,9,1
SBI23MBZ5252539,94,26,23,3,1
SBI06CPL5005637,83,25,22,3,1
SBI02KTI4222671,22,31,17,14,1
SBI46SQU6821626,72,24,22,2,1
SBI90SCI3761801,88,24,18,6,1
SBI43VUE5611184,63,32,26,6,1
SBI63ZEA1211227,63,30,16,14,1
SBI69SLY3925493,92,20,17,3,1
SBI94EHM5678636,80,23,18,5,1
SBI58OFO2582460,89,32,25,7,1
SBI23TDF3033719,20,26,17,9,1
SBI72CAQ3333279,93,22,15,7,1
SBI75YRX9762244,64,19,17,2,1
SBI11RLY7435098,22,33,20,13,1
SBI76XNY9542557,92,13,8,5,1
SBI25OGU6291405,76,21,15,6,1
SBI54VEK9689623,64,26,18,8,1
SBI24PTT5726402,79,38,31,7,1
SBI47OTJ5240150,61,17,15,2,1
SBI85ACU9674253,75,23,22,1,1
SBI92KFZ9852678,73,23,20,3,1
SBI33WGM6683107,80,22,15,7,1
SBI33WIG9970336,89,19,13,6,1
SBI82ACQ2078519,95,23,20,3,1
SBI31YLD1766239,74,27,24,3,1
SBI69FOL3096219,67,25,16,9,1
SBI32GDU2419965,65,30,25,5,1
SBI40STS8741086,67,33,29,4,1
SBI56MGV2788580,72,29,17,12,1
SBI49JHX1374459,73,32,29,3,1
SBI88TEP5056114,23,25,21,4,1
SBI97AVC6826367,78,20,15,5,1
SBI64JNK4362100,23,17,9,8,1
SBI91RYY0092997,77,25,20,5,1
SBI91YJS2343335,80,30,21,9,1
SBI05JPD8322068,25,15,12,3,1
SBI10MMV4530342,74,36,35,1,1
SBI94QBV8488265,63,20,13,7,1
SBI98WDE0365808,68,29,18,11,1
SBI81CCJ8873782,22,23,16,7,1
SBI78IAP7422145,97,28,23,5,1
SBI14IEU3565777,79,30,23,7,1
SBI87VXY0247216,24,19,16,3,1
SBI71BAE5988797,22,22,18,4,1
SBI90HNM4838445,66,26,18,8,1
SBI07MRL0691863,82,24,23,1,1
SBI43TAK9122958,94,27,24,3,1
SBI86WHA2988527,25,30,17,13,1
SBI64WZI4799478,62,20,14,6,1
SBI89VBH4766592,90,23,12,11,1
SBI24RXC3419356,91,13,10,3,1
SBI25DCX4482883,68,25,13,12,1
SBI66EWG7562800,21,13,10,3,1
SBI36YHI6837113,93,35,33,2,1
SBI70EEN3601091,93,29,16,13,1
SBI30PKO8380197,78,18,11,7,1
SBI31TAS4303831,87,20,16,4,1
SBI07RZQ5935581,76,29,16,13,1
SBI80AFE3974780,74,37,35,2,1
SBI05CSH0023651,18,26,21,5,1
SBI67RDI0648207,23,30,18,12,1
SBI38MIB0510095,68,28,20,8,1
SBI37RUF3441561,79,25,18,7,1
SBI55ABZ8408186,67,24,18,6,1
SBI59AAV0807895,97,27,19,8,1
SBI14UMR3396281,98,31,21,10,1
SBI61IGS7125061,82,28,15,13,1
SBI14SAH4357870,25,24,13,11,1
SBI83FXE7006791,65,25,24,1,1
SBI23OMJ6623621,61,23,16,7,1
SBI73USO8766325,84,29,28,1,1
SBI47OMW8502165,65,22,15,7,1
SBI42QFD7839533,72,12,7,5,1
SBI33XOR8055149,71,23,13,10,1
SBI90GCG7502307,98,26,17,9,1
SBI41KUX3434292,79,19,12,7,1
SBI87WUU7207512,70,31,23,8,1
SBI44SOS2040447,81,21,11,10,1
SBI91LPV4434874,80,17,14,3,1
SBI21VSC5898877,97,24,13,11,1
SBI28DFM3123955,87,27,20,7,1
SBI17ATX7915101,60,40,25,15,1
SBI76LDR8233072,81,29,26,3,1
SBI60ASU6612973,88,30,27,3,1
SBI04VMU8518463,96,11,9,2,1
SBI38GBD8061149,62,28,26,2,1
SBI26SZH5003133,82,20,14,6,1
SBI63SIK1997841,64,26,22,4,1
SBI39RNA4307945,22,23,21,2,1
SBI40JYF2506305,94,27,16,11,1
SBI30ATU5296460,22,35,30,5,1
SBI05OHT6732875,77,36,29,7,1
SBI68DUT8979307,71,23,15,8,1
SBI23ZGB4351957,74,23,16,7,1
SBI20GTY5400068,85,23,17,6,1
SBI69HSO9608268,87,24,13,11,1
SBI68OIC6621445,19,30,21,9,1
SBI43EMM1100940,82,23,12,11,1
SBI13CZW8618189,87,23,21,2,1
SBI17EZX3405021,77,26,14,12,1
SBI19QXE6199582,67,27,15,12,1
SBI13FFI7515402,64,18,15,3,1
SBI74DBY1604618,79,26,21,5,1
SBI57BVW3014983,61,29,20,9,1
SBI69FDT8785880,25,26,19,7,1
SBI34JEU5012955,64,21,13,8,1
SBI92ITI8300696,19,25,23,2,1
SBI52VXN0998928,76,20,15,5,1
SBI89BTZ9902453,98,28,22,6,1
SBI63YAN0764320,22,24,18,6,1
SBI63RLF6144476,77,16,12,4,1
SBI17VPJ8535398,69,27,21,6,1
SBI03UIN2720575,63,22,12,10,1
SBI37LRY5473616,86,26,18,8,1
SBI83IBE5913551,91,25,16,9,1
SBI60NOM7450804,20,31,16,15,1
SBI91LBU9636054,19,20,12,8,1
SBI53TXR1644568,85,30,23,7,1
SBI40GHM9678791,64,19,18,1,1
SBI14TAS5289731,66,21,16,5,1
SBI73XYF2715073,95,32,24,8,1
SBI47KXI7537959,77,28,17,11,1
SBI08HAR4430085,98,17,12,5,1
SBI79RXQ9143969,82,34,25,9,1
SBI48CIU0060094,24,31,21,10,1
SBI59ODP0615356,20,28,19,9,1
SBI30FTA4193846,68,26,21,5,1
SBI40OLT8981085,65,23,16,7,1
SBI05BAD3672770,20,29,27,2,1
SBI93RBC2208109,90,18,17,1,1
SBI79WKM0743967,98,20,18,2,1
SBI00QHB5915207,73,27,21,6,1
SBI55ZXK1285541,18,22,16,6,1
SBI35NGB3509723,64,28,26,2,1
SBI23GBD1187634,21,20,15,5,1
SBI04JEF0228809,69,29,22,7,1
SBI44EUE8362460,23,35,25,10,1
SBI49AZC1257142,84,26,24,2,1
SBI31NFG1400080,91,27,20,7,1
SBI62YKL2697299,95,22,17,5,1
SBI21LEL9293989,84,29,18,11,1
SBI97MVV6383844,93,27,24,3,1
SBI41UAC2318161,92,25,18,7,1
SBI92AUK1715739,61,26,21,5,1
SBI10BHY4238339,73,26,15,11,1
SBI25YJI4311448,71,24,13,11,1
SBI17ZZE0360631,60,19,18,1,1
SBI96FRX6546318,87,22,14,8,1
SBI28GCJ9825614,65,19,14,5,1
SBI57GQY1487578,84,20,14,6,1
SBI42QEL3036068,23,31,23,8,1
SBI36VIB9742311,64,24,15,9,1
SBI98CYA0566539,76,26,17,9,1
SBI86SQA2773221,65,29,28,1,1
SBI09ZKN8392998,22,35,27,8,1
SBI66RMK4114354,86,27,24,3,1
SBI10EQZ3555694,24,27,17,10,1
SBI23UZO0206781,73,22,16,6,1
SBI15MAY0816650,65,21,13,8,1
SBI63BYP5039721,97,27,18,9,1
SBI45RWT4490564,79,19,13,6,1
SBI15HHN9278676,65,26,21,5,1
SBI60XQN8102987,99,34,29,5,1
SBI00PSW7709940,97,21,12,9,1
SBI61ZRI2451488,74,19,10,9,1
SBI49MCA6961905,89,32,29,3,1
SBI74JNQ1506339,79,14,8,6,1
SBI45GBT2649846,24,26,16,10,1
SBI09ZHJ7395372,85,26,17,9,1
SBI00LYG3504773,73,27,24,3,1
SBI15GTQ8406564,80,19,15,4,1
SBI81LTL8975175,98,25,17,8,1
SBI20GTM9290364,22,33,19,14,1
SBI21GMD9229268,20,25,19,6,1
SBI86MUK9617628,87,23,22,1,1
SBI99BMA5103819,67,22,12,10,1
SBI55WRX2777922,96,27,26,1,1
SBI03KVC5192466,77,23,16,7,1
SBI05OJV5512178,87,21,12,9,1
SBI66DHF3084736,19,22,21,1,1
SBI15WYO3759909,60,16,13,3,1
SBI26LVB6462289,76,22,21,1,1
SBI60TOX5953800,65,26,17,9,1
SBI25FOM1430461,18,21,19,2,1
SBI61XKE5740530,74,24,20,4,1
SBI69BIQ2044950,92,23,14,9,1
SBI29UFS0111210,70,18,12,6,1
SBI29JPD4484517,90,19,18,1,1
SBI40EQQ9584639,76,28,27,1,1
SBI76SCM2169392,25,25,24,1,1
SBI38YOR6827268,66,28,24,4,1
SBI92EGZ7879985,77,15,14,1,1
SBI03CDG9823434,70,17,10,7,1
SBI32PNK1283502,25,21,20,1,1
SBI15JKF0800734,60,37,27,10,1
SBI77PHI7665402,99,21,18,3,1
SBI97GSG5430192,66,18,13,5,1
SBI69HAF6258329,82,25,17,8,1
SBI81SZS0228761,84,24,16,8,1
SBI77KRY7639482,70,15,13,2,1
SBI61ATC1263110,74,23,18,5,1
SBI44STF6562856,65,19,10,9,1
SBI81EMH2109711,20,31,30,1,1
SBI80XTD9958891,20,21,15,6,1
SBI96PVO4796409,80,29,24,5,1
SBI23ESY5056666,98,23,19,4,1
SBI62TIQ4969449,66,30,18,12,1
SBI20NKU4183313,70,28,15,13,1
SBI90PBA0755126,93,27,21,6,1
SBI10DPH6723926,71,30,20,10,1
SBI17APC4789912,24,22,20,2,1
SBI15YZO9096363,62,27,23,4,1
SBI10IGF5762357,22,29,23,6,1
SBI94QXQ7785005,73,20,16,4,1
SBI00IGL8385134,66,28,15,13,1
SBI88OTE6587245,22,24,15,9,1
SBI77WZJ1382392,77,24,21,3,1
SBI18HHS7477474,74,25,17,8,1
SBI30MJD1434718,71,24,19,5,1
SBI74RKZ3229944,62,22,15,7,1
SBI31UDS3903399,71,18,16,2,1
SBI21EDJ0877273,65,18,16,2,1
SBI41BZK3926067,64,29,23,6,1
SBI74JIE8939382,61,18,11,7,1
SBI46VMA0385176,70,24,16,8,1
SBI00YWJ9666416,69,27,24,3,1
SBI67YLK5012732,25,20,19,1,1
SBI06CTZ5722294,77,24,22,2,1
SBI11TOH0122995,77,24,17,7,1
SBI60SRO1859397,98,33,31,2,1
SBI69BFJ7732310,82,31,18,13,1
SBI27DYD2038662,21,23,21,2,1
SBI76ZGN4237393,85,29,28,1,1
SBI15HAB4693338,21,16,10,6,1
SBI65THJ2677931,21,22,12,10,1
SBI01YQK6284268,89,22,13,9,1
SBI29NIM6967678,79,29,26,3,1
SBI43SWB8795287,77,23,21,2,1
SBI43PDE1263402,97,26,19,7,1
SBI56EHT3824025,97,15,9,6,1
SBI22MYY5031141,64,19,15,4,1
SBI72OIQ4872698,90,23,20,3,1
SBI99PGC0496967,65,25,23,2,1
SBI60DWI3803270,71,19,11,8,1
SBI56DYI2674182,88,27,14,13,1
SBI81QSN8252322,86,27,25,2,1
SBI88QII0824900,86,31,25,6,1
SBI99JFE9649569,71,17,16,1,1
SBI31DKI1214074,67,27,22,5,1
SBI65CHY4646285,84,30,21,9,1
SBI45RLV8787418,60,13,7,6,1
SBI63YDZ1460777,94,33,24,9,1
SBI05PEK4387118,65,31,24,7,1
SBI58LZX8722217,98,31,18,13,1
SBI97MNQ3231544,98,19,10,9,1
SBI01URI3372823,78,20,12,8,1
SBI66FFO5285929,92,23,17,6,1
SBI91HMS8434766,65,13,10,3,1
SBI40MUG1943878,79,17,13,4,1
SBI86PXH7401846,61,27,25,2,1
SBI75LMR7913117,81,26,22,4,1
SBI75KWX9121431,93,27,14,13,1
SBI23ZWJ1362597,61,29,16,13,1
SBI72ZMK9325743,90,30,25,5,1
SBI24EEU0621734,88,24,23,1,1
SBI42RLN1660836,99,20,13,7,1
SBI73TPQ8896025,80,28,20,8,1
SBI23ARC3174060,84,31,22,9,1
SBI95QNW9006484,67,28,20,8,1
SBI19XFS8807510,75,26,19,7,1
SBI75JJC4068380,25,29,26,3,1
SBI91OSC8760724,79,22,13,9,1
SBI35XDR3225703,18,27,22,5,1
SBI15TQH7896896,72,31,20,11,1
SBI85OWX1504884,19,24,22,2,1
SBI51GMB6333366,82,29,19,10,1
SBI96TBP8827349,61,24,19,5,1
SBI75PEG9469004,64,21,11,10,1
SBI99CMW1597620,83,30,29,1,1
SBI16QVJ6326098,23,26,23,3,1
SBI49GEL3372816,98,15,9,6,1
SBI59FAU5318816,79,25,22,3,1
SBI83ELF0312589,93,29,17,12,1
SBI90MMS1703419,78,31,19,12,1
SBI14ALM5066133,67,25,22,3,1
SBI93SAU4634490,21,25,13,12,1
SBI42YGC9866073,68,31,23,8,1
SBI91BKK5829828,69,35,20,15,1
SBI10UBC7344411,25,16,10,6,1
SBI74BGA5496380,98,16,9,7,1
SBI99QRF7114559,64,28,15,13,1
SBI83TRF8209717,20,30,28,2,1
SBI29YRA2405815,65,18,11,7,1
SBI73PCW0587074,98,26,17,9,1
SBI05OXP5086485,62,25,18,7,1
SBI88RJO4587518,81,18,14,4,1
SBI56PQT5605050,96,29,28,1,1
SBI35ZXA8768079,83,19,12,7,1
SBI07DTP2091209,62,22,17,5,1
SBI51ULR6249366,20,21,17,4,1
SBI17GOV8373329,94,27,22,5,1
SBI13VWV2797633,91,19,16,3,1
SBI22YMK5492702,83,33,17,16,1
SBI99KOO1039687,61,28,21,7,1
SBI84KMY9796740,23,20,18,2,1
SBI41PZT8518690,83,25,21,4,1
SBI75GGN1971368,24,27,20,7,1
SBI91SYC6832262,25,18,13,5,1
SBI12EKD0933494,93,31,26,5,1
SBI76RIH2606454,65,19,10,9,1
SBI08XKX8667449,96,19,17,2,1
SBI93HHK6927760,64,29,27,2,1
SBI60XIB7272389,70,23,15,8,1
SBI15ZFB0620294,84,23,22,1,1
SBI03PIU8902791,83,29,20,9,1
SBI82FSR0003304,23,30,29,1,1
SBI07EGZ5508604,20,26,15,11,1
SBI36VDZ3463982,95,24,22,2,1
SBI26MPC0652858,61,21,18,3,1
SBI05XYL2182711,87,31,21,10,1
SBI18JLS0327074,19,18,14,4,1
SBI51XOA8971275,98,27,25,2,1
SBI41RQG1862091,21,25,17,8,1
SBI00LLB8214376,95,24,18,6,1
SBI70MAZ3667103,64,23,17,6,1
SBI28ERA5197470,18,19,16,3,1
SBI35PNQ9230040,84,20,14,6,1
SBI24OZC0728630,64,21,11,10,1
SBI36YHJ4760572,67,23,15,8,1
SBI61PXZ2883402,95,18,16,2,1
SBI37EYR6968231,68,29,28,1,1
SBI23PHD9129268,68,17,11,6,1
SBI63IPZ3928422,93,25,15,10,1
SBI30MWJ8222687,78,24,18,6,1
SBI66RWW4004837,67,30,28,2,1
SBI29SSX6061282,23,30,17,13,1
SBI62ADP9143713,91,31,19,12,1
SBI90GKZ7449134,22,28,17,11,1
SBI20APQ4003616,86,29,17,12,1
SBI94KLZ7615438,74,29,19,10,1
SBI15LOZ0286077,23,26,18,8,1
SBI49NVC5891825,77,21,12,9,1
SBI12LSJ6146785,20,18,10,8,1
SBI39ALL8962787,81,21,11,10,1
SBI01QDJ7392312,79,26,14,12,1
SBI03HKM7824629,23,19,12,7,1
SBI21CFJ8000513,60,21,15,6,1
SBI79QAC1538466,90,29,28,1,1
SBI51YYA3792539,20,24,18,6,1
SBI21XWS7375557,89,21,11,10,1
SBI62DSH8499303,85,27,14,13,1
SBI12OPD8997172,95,27,17,10,1
SBI38UBK3007603,94,23,13,10,1
SBI82CYE4714181,88,19,16,3,1
SBI16MCI2583129,93,26,20,6,1
SBI40BWP3919203,84,27,17,10,1
SBI04VTI2377819,91,21,14,7,1
SBI52QVD1277959,18,22,14,8,1
SBI66QLC9043951,90,32,30,2,1
SBI78NKH3294818,76,33,20,13,1
SBI90DOL0111727,83,30,18,12,1
SBI08ATL1301473,25,19,18,1,1
SBI00SHV8070687,23,20,12,8,1
SBI54VMM8071751,89,25,20,5,1
SBI98JGO2739831,88,20,13,7,1
SBI99RYP2587699,98,30,20,10,1
SBI34ZWY5277467,61,28,22,6,1
SBI06UAK8898188,67,23,12,11,1
SBI71ZHU0656259,62,22,21,1,1
SBI42DEZ5537304,62,18,17,1,1
SBI37IVM6311948,18,23,20,3,1
SBI65TMX1786156,80,19,12,7,1
SBI32RFM8252276,82,22,17,5,1
SBI34OZJ5855360,95,20,14,6,1
SBI53VXN8302570,21,25,23,2,1
SBI11XJU2741861,85,29,18,11,1
SBI28ZJV6822223,91,26,23,3,1
SBI34HDF1887838,74,26,14,12,1
SBI91KBD1588362,89,12,10,2,1
SBI19GXK2654602,21,17,15,2,1
SBI48SYV5619762,91,26,14,12,1
SBI71ZUQ8115755,75,24,15,9,1
SBI80JYZ9213965,82,25,18,7,1
SBI10UGT3283680,81,28,20,8,1
SBI84SDQ6791655,68,19,12,7,1
SBI95RGC0849839,96,28,15,13,1
SBI12PDB6888085,75,22,19,3,1
SBI42FWJ1845148,63,21,15,6,1
SBI55LZK2564407,69,27,16,11,1
SBI12AGK1846988,98,25,17,8,1
SBI88GAP3425979,72,32,28,4,1
SBI17TRA7613882,74,21,20,1,1
SBI84DWE7206624,90,23,12,11,1
SBI72LKD4488074,88,28,15,13,1
SBI61BLK8874235,19,26,17,9,1
SBI97PMH2865913,23,23,15,8,1
SBI61UBH7958099,75,23,15,8,1
SBI81YMX9530686,74,30,28,2,1
SBI26IAK0041781,94,22,17,5,1
SBI85UUF1166678,83,19,13,6,1
SBI72WBN3310571,86,22,21,1,1
SBI53NOG0884098,65,21,20,1,1
SBI14VWY7821813,97,26,16,10,1
SBI48OLE7795812,80,15,11,4,1
SBI71UUH8840909,65,23,13,10,1
SBI44NFV7139230,78,19,18,1,1
SBI56SXB4409701,75,31,20,11,1
SBI03ZVX4194118,94,23,20,3,1
SBI62LYF3863306,95,13,12,1,1
SBI68ZZU2147302,93,26,14,12,1
SBI39VUE5532825,74,32,28,4,1
SBI53YCX8100364,79,25,24,1,1
SBI37EEA4710989,89,22,12,10,1
SBI82JLR1031105,75,21,19,2,1
SBI82PQS7957174,95,28,15,13,1
SBI93PWH1034513,65,23,21,2,1
SBI71QFN8707454,94,29,24,5,1
SBI75JAN8616545,77,27,21,6,1
SBI66AUY8647600,95,29,21,8,1
SBI30XQG8883024,73,25,15,10,1
SBI12SKA3347019,70,20,14,6,1
SBI65OJW9414463,85,26,21,5,1
SBI52FBX4281524,71,17,16,1,1
SBI23LNX0830627,67,22,14,8,1
SBI00OWU1464289,68,29,17,12,1
SBI33JMY3623592,64,21,15,6,1
SBI02KCL8263882,78,24,16,8,1
SBI21AVE0302543,69,25,21,4,1
SBI78YXO1245093,99,26,16,10,1
SBI08EHY9993226,66,28,26,2,1
SBI66LSS0488736,83,28,20,8,1
SBI10POC3229801,86,31,20,11,1
SBI75RHH7334737,92,24,19,5,1
SBI01FEW7682588,65,18,15,3,1
SBI92OQN9769807,64,24,17,7,1
SBI19FDN2544551,64,16,13,3,1
SBI76WLM6601221,81,31,22,9,1
SBI21AZJ3543672,87,30,27,3,1
SBI20AXR0082352,98,19,14,5,1
SBI25HLW7404344,74,24,19,5,1
SBI97UZQ9259213,67,23,13,10,1
SBI32NJC0424038,74,31,20,11,1
SBI18LUS4231986,78,29,24,5,1
SBI95HWJ6223372,72,30,18,12,1
SBI53FAY4994254,90,30,28,2,1
SBI05WKG5842224,98,23,16,7,1
SBI65AJG7740444,61,23,21,2,1
SBI13JFZ0991146,65,17,9,8,1
SBI60GQT4683758,74,24,22,2,1
SBI21OEH8970361,21,27,25,2,1
SBI45VWF5637633,76,30,23,7,1
SBI25SPJ3872162,73,25,24,1,1
SBI16JTO1370809,25,26,16,10,1
SBI57QOU8457467,89,23,21,2,1
SBI84KVC9936510,86,27,15,12,1
SBI77VOH1476760,25,22,17,5,1
SBI86CJX8228756,78,23,16,7,1
SBI87ERU3072616,82,29,21,8,1
SBI05BWU2442197,89,28,25,3,1
SBI40MSO4492598,76,24,18,6,1
SBI73HCJ2721354,63,13,12,1,1
SBI82TAY5179865,89,17,15,2,1
SBI39AKM3987836,97,26,22,4,1
SBI17LXW5699867,94,31,16,15,1
SBI41MWJ0377667,68,29,25,4,1
SBI88LJZ2882154,22,27,21,6,1
SBI11VHR8541442,72,20,16,4,1
SBI08LTF4105695,71,14,10,4,1
SBI74ZWV9533576,70,24,14,10,1
SBI44ZBM8456414,67,26,24,2,1
SBI00SWX6149318,89,19,16,3,1
SBI49RWJ0295669,96,22,19,3,1
SBI04EVT0202281,62,29,23,6,1
SBI55HIE4936526,83,33,21,12,1
SBI59SGX8383775,64,25,22,3,1
SBI17EKB4985249,62,21,12,9,1
SBI95KFA3426340,23,27,20,7,1
SBI74KIO2933975,21,30,26,4,1
SBI42VOX7874391,72,27,20,7,1
SBI12ZKJ1989932,24,17,14,3,1
SBI07UKU0482907,20,21,16,5,1
SBI09HOJ4732771,97,21,11,10,1
SBI20DVI3815119,77,31,30,1,1
SBI69OIG7429100,96,10,8,2,1
SBI72ISR4409230,95,29,16,13,1
SBI49IKJ3553104,98,22,12,10,1
SBI18FSE0625532,79,24,17,7,1
SBI79YUR4909769,90,31,20,11,1
SBI06WQP3380707,69,21,19,2,1
SBI54OAQ7231883,80,30,22,8,1
SBI98XHK3013086,80,32,28,4,1
SBI28ONK1603829,99,23,12,11,1
SBI65TZB0007138,89,18,13,5,1
SBI94MXM0210205,74,36,30,6,1
SBI78KQR3953655,71,25,19,6,1
SBI22IRR7094215,84,19,17,2,1
SBI40WLF9358377,63,25,17,8,1
SBI81POI0428032,62,26,18,8,1
SBI08THP4359104,97,26,21,5,1
SBI97EAB3750824,73,20,12,8,1
SBI71EGO7751609,83,30,24,6,1
SBI89YWE9400917,95,20,14,6,1
SBI80SXT9730085,88,19,14,5,1
SBI32BKK0906933,99,25,19,6,1
SBI02YKA8460825,73,17,11,6,1
SBI77MPR8904482,21,34,24,10,1
SBI35GBJ0075081,73,19,18,1,1
SBI39YUK3373389,24,21,17,4,1
SBI98XXL0183505,71,24,16,8,1
SBI84ULB6088836,72,25,18,7,1
SBI26HKW9477406,61,33,30,3,1
SBI51IOZ3744192,95,19,13,6,1
SBI97ZBE8674896,77,33,30,3,1
SBI46PTV5983222,67,26,25,1,1
SBI29JQI9326569,85,22,16,6,1
SBI33CWH5811981,70,17,11,6,1
SBI68EJR1865497,69,21,19,2,1
SBI40KOY8807534,69,28,16,12,1
SBI90BJY0498577,69,28,18,10,1
SBI02DRU9926941,18,23,15,8,1
SBI14AYJ3710965,83,21,14,7,1
SBI21TJR3576266,25,24,18,6,1
SBI96OLM7939877,90,19,15,4,1
SBI65LXX1623879,94,11,7,4,1
SBI55LTR5763158,96,37,36,1,1
SBI99PFX3040410,68,36,24,12,1
SBI12FGH4797956,67,21,11,10,1
SBI86BZW1399748,88,19,13,6,1
SBI05ZED2281492,91,26,24,2,1
SBI58FWQ0506667,85,21,20,1,1
SBI67AIA3075872,64,15,12,3,1
SBI25VFM4470615,81,17,9,8,1
SBI90EEG7095812,82,25,18,7,1
SBI90EHU1602202,25,31,26,5,1
SBI19BHL5158234,65,31,26,5,1
SBI27JNT7738211,70,21,17,4,1
SBI37QIU3573870,67,20,19,1,1
SBI89AIK1287967,68,34,33,1,1
SBI90ZOW1880114,60,29,24,5,1
SBI10JQL5197780,68,29,15,14,1
SBI87SSY1384411,86,11,8,3,1
SBI98MMB6334152,89,25,15,10,1
SBI03HXG7868962,97,23,22,1,1
SBI58UNO3830519,24,21,16,5,1
SBI13EEY4335213,83,18,17,1,1
SBI05HLU9448023,62,23,14,9,1
SBI50NBJ6503040,19,28,23,5,1
SBI61HEE1336128,89,28,19,9,1
SBI13PKR4205650,64,28,22,6,1
SBI31OQB0900250,23,35,20,15,1
SBI32GPW1760244,24,28,20,8,1
SBI01IAY4744957,23,31,19,12,1
SBI56MIY6499254,91,29,26,3,1
SBI06KRP4465737,19,21,14,7,1
SBI96JWU6092147,62,28,26,2,1
SBI52FYI8415286,87,16,15,1,1
SBI74BJG2830017,80,30,21,9,1
SBI84JSH2158802,79,33,23,10,1
SBI30ROF4907014,86,31,19,12,1
SBI25WAS7191194,75,17,10,7,1
SBI53KAA6027618,66,17,16,1,1
SBI58HMY0724872,18,27,17,10,1
SBI28SBD7654130,72,31,20,11,1
SBI78CTP3045315,94,29,23,6,1
SBI91REM7113718,23,23,15,8,1
SBI07VPN4380864,23,14,9,5,1
SBI91WLH5280071,84,23,16,7,1
SBI08SVV9585709,87,21,12,9,1
SBI45RSO7231956,83,24,21,3,1
SBI93FWY2442840,95,19,11,8,1
SBI77RRD2929946,99,16,15,1,1
SBI49BAO4470795,99,28,16,12,1
SBI42HRD6213618,94,34,31,3,1
SBI71QAR2888271,70,21,20,1,1
SBI07MRQ0489843,66,28,24,4,1
SBI06SZX7805968,97,31,23,8,1
SBI49UVN2638213,77,18,16,2,1
SBI31TLR2178644,19,29,20,9,1
SBI14VYQ1071906,67,14,12,2,1
SBI61DSM6146477,23,33,28,5,1
SBI07BFJ6375988,93,25,19,6,1
SBI39ITN7041065,95,26,22,4,1
SBI17SKO7864767,83,27,19,8,1
SBI64XJT4458518,85,19,11,8,1
SBI09GKQ0709210,82,21,20,1,1
SBI31KXB4669785,72,27,20,7,1
SBI78BZA3618048,95,16,13,3,1
SBI56UJS2950048,85,27,18,9,1
SBI80VCN0159056,24,35,25,10,1
SBI88MUX7720506,95,20,12,8,1
SBI68CRT1367320,74,20,11,9,1
SBI70VXB9215917,20,21,12,9,1
SBI37TFS9318446,60,23,21,2,1
SBI00CQV7639026,83,28,24,4,1
SBI87TJY7293459,21,29,24,5,1
SBI19NIJ3586109,60,28,26,2,1
SBI55BAH1217234,22,22,19,3,1
SBI05RSQ0029716,90,16,11,5,1
SBI47QIL0327269,89,22,14,8,1
SBI65BLD5036818,91,24,22,2,1
SBI41RDB6929719,74,21,13,8,1
SBI30AMZ5262306,76,24,15,9,1
SBI19TUT9669133,92,23,14,9,1
SBI93EEA0823852,64,31,25,6,1
SBI50IOG7541444,94,20,12,8,1
SBI12MMS3405213,82,22,12,10,1
SBI22CKY3676695,85,24,14,10,1
SBI38VGP7777944,91,31,20,11,1
SBI69UKC7223604,76,33,18,15,1
SBI31PJR1950888,21,30,26,4,1
SBI44CBO2811624,22,20,14,6,1
SBI73LKT9538855,62,28,24,4,1
SBI08UEU5089085,76,30,28,2,1
SBI50GYV0158221,78,26,25,1,1
SBI02ZJS9650501,73,22,12,10,1
SBI99ESO2900232,96,30,27,3,1
SBI30OLI5116538,68,23,15,8,1
SBI87ZSW9147979,94,24,16,8,1
SBI78JWF5770429,20,29,17,12,1
SBI21QOR2292825,72,33,17,16,1
SBI53IJN9919299,88,32,27,5,1
SBI19MWE7595513,95,28,23,5,1
SBI47OPE8383659,71,28,16,12,1
SBI19KLQ7131443,98,21,16,5,1
SBI03HQG9504702,60,16,15,1,1
SBI88APK1004511,86,21,11,10,1
SBI74RMM6873272,25,29,19,10,1
SBI71TQL8667465,20,23,14,9,1
SBI89GVB2452281,96,21,17,4,1
SBI05QGL6016822,76,21,12,9,1
SBI74QKL4934868,71,24,13,11,1
SBI37TMC6920577,72,22,13,9,1
SBI06EPH0827656,80,24,15,9,1
SBI22LBQ4525922,73,19,11,8,1
SBI24XSH2863860,72,22,18,4,1
SBI07QGA1568546,80,33,17,16,1
SBI99KSY4959575,62,23,18,5,1
SBI05ADK2547877,82,22,18,4,1
SBI56VXP6871200,86,22,18,4,1
SBI93YFQ9239603,73,12,10,2,1
SBI87MYL5138776,62,18,17,1,1
SBI16HRR4786615,23,26,16,10,1
SBI76VOH5332386,81,24,22,2,1
SBI21YKW6848901,20,26,15,11,1
SBI43IRN2681073,79,22,20,2,1
SBI68WNG5954483,77,25,24,1,1
SBI08QCF8710158,77,24,22,2,1
SBI63OMJ8008470,18,21,13,8,1
SBI34GNG7613465,20,25,15,10,1
SBI65GGT6627759,80,25,14,11,1
SBI14GVC4750787,93,27,22,5,1
SBI63VKR2958662,63,24,23,1,1
SBI66ETO6890014,75,23,15,8,1
SBI50MXT7497353,80,26,23,3,1
SBI02XDO4540418,73,21,13,8,1
SBI02NVP5252733,63,26,16,10,1
SBI21NFC9944980,25,20,17,3,1
SBI06IGU0561360,69,27,25,2,1
SBI08KTG0680741,61,27,17,10,1
SBI63KMA5223881,23,25,17,8,1
SBI13STM3623932,85,19,12,7,1
SBI97VZX4327815,68,16,12,4,1
SBI18VWL8068976,90,21,13,8,1
SBI91MNY8546982,76,22,18,4,1
SBI63YVN0621304,19,22,18,4,1
SBI38KUH0008509,89,36,22,14,1
SBI17ELM1105987,82,41,38,3,1
SBI37XSX6018105,94,28,15,13,1
SBI23AVZ1692225,67,29,26,3,1
SBI24GUL8361610,60,26,14,12,1
SBI46BNC3553143,64,16,13,3,1
SBI62ZCH9721608,64,30,18,12,1
SBI75EKK7489003,85,26,18,8,1
SBI54HAO6975298,97,27,23,4,1
SBI58IUZ7708703,24,32,28,4,1
SBI55SVZ0785316,64,24,22,2,1
SBI08HMR7609471,96,26,24,2,1
SBI82LFY6597786,19,24,20,4,1
SBI03LQJ2314673,60,30,25,5,1
SBI81JGZ6178835,67,29,16,13,1
SBI85LWS4691910,18,27,19,8,1
SBI03DET6363291,89,39,26,13,1
SBI81JRG6880835,93,20,17,3,1
SBI09IKO5905391,67,22,16,6,1
SBI60QLD6059400,86,16,14,2,1
SBI18GGM3866929,69,26,16,10,1
SBI81FXW2235626,69,20,13,7,1
SBI42RAM7661228,19,25,17,8,1
SBI28ISE0628598,94,28,19,9,1
SBI97ACK2969070,90,29,21,8,1
SBI80GHJ4728745,88,28,21,7,1
SBI49MTL8134064,60,20,12,8,1
SBI09FAT1709607,24,26,24,2,1
SBI43DDD1264018,80,30,21,9,1
SBI06KDN3891682,98,27,14,13,1
SBI92ZKS3524967,79,26,17,9,1
SBI16WFH3062537,62,21,15,6,1
SBI36XAY1522331,77,29,22,7,1
SBI49RQC2868101,83,24,18,6,1
SBI95MWY9699065,72,22,14,8,1
SBI16GME9553056,20,30,17,13,1
SBI28QMN4701405,18,25,21,4,1
SBI32BVG7502212,79,29,22,7,1
SBI60ZSE6747063,97,30,24,6,1
SBI13XJK3734816,95,23,22,1,1
SBI85JPV5150647,95,20,11,9,1
SBI70EDP1151368,96,24,13,11,1
SBI63VQC0322227,95,21,15,6,1
SBI38JXW6838610,82,13,9,4,1
SBI51LTG6560622,69,27,16,11,1
SBI59BXA6923126,87,25,17,8,1
SBI35DOP1785081,61,19,11,8,1
SBI56PRB5146655,91,17,16,1,1
SBI74KYM9698091,70,24,16,8,1
SBI51NXX4168523,70,31,16,15,1
SBI17VGR5778878,63,38,28,10,1
SBI93SQN4601486,70,21,13,8,1
SBI32QYL5242454,62,30,20,10,1
SBI85ESU4982847,98,25,19,6,1
SBI23GMG9972750,82,15,8,7,1
SBI19LRL4432497,76,25,18,7,1
SBI63NCH3062508,22,27,16,11,1
SBI60ELS3794938,93,24,15,9,1
SBI43UAL4170365,78,27,23,4,1
SBI48HLT8019661,94,24,21,3,1
SBI12DDW4651840,61,32,30,2,1
SBI13EZY8882520,63,27,18,9,1
SBI53FWU0472570,81,22,17,5,1
SBI45TVY4335518,20,25,14,11,1
SBI32NUV7085070,92,29,27,2,1
SBI83UNA3681840,90,30,28,2,1
SBI17ALF3378004,76,23,13,10,1
SBI69UVC7021177,91,26,22,4,1
SBI06FCF6233314,90,28,16,12,1
SBI04KUX0628477,81,25,23,2,1
SBI38SUJ8175336,86,21,13,8,1
SBI15JBV1769483,92,29,27,2,1
SBI93VNY6431947,18,33,26,7,1
SBI90FQZ1476031,77,29,25,4,1
SBI82RXS9747709,22,25,15,10,1
SBI01LRE5521052,70,24,22,2,1
SBI94TNU3243895,97,27,19,8,1
SBI54RGO4487640,84,18,12,6,1
SBI06YTL7941858,69,29,27,2,1
SBI48YOS9927294,89,17,16,1,1
SBI47PNB7828388,81,19,11,8,1
SBI35XXT2999540,68,23,14,9,1
SBI65UUF4867580,76,29,26,3,1
SBI86YEC4153188,69,37,26,11,1
SBI04ILP0152161,89,26,24,2,1
SBI23SVK8956725,97,33,30,3,1
SBI95JYL9465708,24,24,14,10,1
SBI44DZS5948254,67,34,31,3,1
SBI23OOF1471480,19,24,15,9,1
SBI13WXZ2699905,67,35,24,11,1
SBI51CXU9437909,78,30,23,7,1
SBI68MFF3751653,22,13,7,6,1
SBI35WMD8573178,92,21,15,6,1
SBI07JEU8191286,22,14,9,5,1
SBI85PNC5027413,81,19,18,1,1
SBI64KCT9814217,73,25,14,11,1
SBI35ZBI8987355,93,34,28,6,1
SBI88FHA0894220,91,19,11,8,1
SBI94NVM3732020,62,22,21,1,1
SBI61YRT4912247,95,25,15,10,1
SBI76GAD1527374,75,19,10,9,1
SBI98YKQ1962201,98,27,25,2,1
SBI50XVF8050768,24,32,18,14,1
SBI47CYX4281910,86,22,18,4,1
SBI76XRZ6847229,20,25,15,10,1
SBI44DIE9225612,87,21,13,8,1
SBI34QRO0419294,69,26,20,6,1
SBI95VJV1897372,97,19,18,1,1
SBI81HLB7214228,85,20,19,1,1
SBI94WAS2384219,83,15,9,6,1
SBI44XGG6161864,78,21,20,1,1
SBI27VSM2894597,68,20,18,2,1
SBI71JCJ1710781,65,26,15,11,1
SBI03XRU2365929,91,16,14,2,1
SBI31YQL3868552,99,28,24,4,1
SBI82OKC0517950,88,35,20,15,1
SBI17AAD6754219,96,34,24,10,1
SBI90QZL8459493,69,19,17,2,1
SBI60DTL3579957,21,31,16,15,1
SBI78PVG8529996,78,27,21,6,1
SBI25QWC0866050,92,32,23,9,1
SBI41VCE9844003,89,30,28,2,1
SBI10TEM4135928,99,33,26,7,1
SBI70VQM9366293,99,30,16,14,1
SBI35VZG7378844,19,30,20,10,1
SBI65GMD5110902,99,21,19,2,1
SBI41TER1467820,78,27,15,12,1
SBI24WJH8488496,76,26,20,6,1
SBI67AQG0945104,70,23,12,11,1
SBI55KRM2116487,92,27,24,3,1
SBI76KPE7019501,66,26,22,4,1
SBI01SVA0364374,92,32,30,2,1
SBI18RVK4244600,91,22,19,3,1
SBI18LLX6565692,94,16,12,4,1
SBI07PZX2677334,92,30,25,5,1
SBI04MLC9803730,79,24,16,8,1
SBI32BUN5115814,72,26,19,7,1
SBI36VMF9148603,91,21,12,9,1
SBI26XBZ2501082,98,29,19,10,1
SBI05YXF4369610,60,26,16,10,1
SBI55FZX9838825,98,20,15,5,1
SBI74KCT3728324,95,32,25,7,1
SBI93UJL0897169,75,15,10,5,1
SBI95YBV0954948,87,32,21,11,1
SBI53IHR1242857,78,21,16,5,1
SBI62FRJ7505106,86,28,27,1,1
SBI25EGL5268709,87,23,13,10,1
SBI49RRC2238753,25,20,11,9,1
SBI28HXL4072949,24,27,19,8,1
SBI21BZO6108182,89,13,12,1,1
SBI35CNY8962752,74,27,25,2,1
SBI40VIW3003466,98,28,21,7,1
SBI80GBN4812818,80,15,12,3,1
SBI71BQB8165701,92,23,17,6,1
SBI26YOP3087629,75,27,26,1,1
SBI82VFJ2843386,67,24,22,2,1
SBI71QTC8652343,64,22,19,3,1
SBI60ZAX6607202,67,30,22,8,1
SBI64AYN3713344,21,25,22,3,1
SBI83BWL9941746,84,23,12,11,1
SBI46LXV1671958,19,20,12,8,1
SBI27CHR7964840,82,20,15,5,1
SBI06ALH3931165,74,25,18,7,1
SBI65ZLH0476629,87,27,23,4,1
SBI21FTV1543053,82,18,17,1,1
SBI35KTO7437665,61,19,10,9,1
SBI09AEI2884559,94,25,19,6,1
SBI69QSO5108806,61,24,18,6,1
SBI08CCL5945007,76,21,20,1,1
SBI72TYT4070852,80,22,16,6,1
SBI35EML5980614,78,31,19,12,1
SBI14FXG3873932,96,32,23,9,1
SBI09HXA8694914,70,28,21,7,1
SBI84AQZ3020877,83,27,20,7,1
SBI56IXG1574860,88,21,16,5,1
SBI39KHM6749981,96,25,18,7,1
SBI90FMM4081245,73,21,18,3,1
SBI62EEM9497771,93,27,22,5,1
SBI60XKL3336146,63,21,16,5,1
SBI79VTD2602004,84,26,18,8,1
SBI36YKQ7688645,79,29,24,5,1
SBI40MWZ3282741,68,31,26,5,1
SBI36MXA5945631,95,25,18,7,1
SBI76OSK3337552,74,23,20,3,1
SBI14ICR8477933,23,16,11,5,1
SBI62PTE9921856,92,31,30,1,1
SBI16RLW5120251,20,29,24,5,1
SBI14AIT4675839,91,33,24,9,1
SBI60CCD0966143,97,18,11,7,1
SBI34XNF6130461,86,21,14,7,1
SBI65LPS9626024,93,19,17,2,1
SBI41VQQ6337300,93,26,22,4,1
SBI60KCI5647875,82,24,15,9,1
SBI04CJF0090226,79,29,25,4,1
SBI57UIJ8681220,23,23,13,10,1
SBI58MZG6313548,80,21,14,7,1
SBI32IGZ6596267,73,35,23,12,1
SBI14BYC5321881,24,29,19,10,1
SBI27IUX4952640,60,22,19,3,1
SBI49LZA6041151,61,25,16,9,1
SBI34HXT3129842,64,22,15,7,1
SBI28EPG1029709,65,28,18,10,1
SBI64EAV9333131,86,17,10,7,1
SBI51FWO6082335,62,25,18,7,1
SBI58YJO6450209,65,31,27,4,1
SBI03DPS1380735,84,27,14,13,1
SBI00PED9662526,80,25,24,1,1
SBI95NDW3275556,98,24,21,3,1
SBI19GXJ1395533,75,18,16,2,1
SBI01BRL6381528,93,25,16,9,1
SBI89TDA1211366,95,27,25,2,1
SBI05OVX4150346,25,24,20,4,1
SBI56HCF3438217,25,22,19,3,1
SBI72NWM6635144,65,20,11,9,1
SBI35WSX1983135,75,21,12,9,1
SBI41YKC2120067,90,22,12,10,1
SBI27PAI8750780,79,17,10,7,1
SBI16GKQ1258821,25,23,19,4,1
SBI63YEL2411970,87,24,19,5,1
SBI41MSA9620153,64,28,26,2,1
SBI78ZJD7035703,67,28,17,11,1
SBI16GLK3549493,94,25,15,10,1
SBI27PTC6767674,22,22,12,10,1
SBI01TSJ9412686,18,17,15,2,1
SBI83VGU4993514,99,15,13,2,1
SBI51FPN6993484,87,22,14,8,1
SBI82PWH9015646,73,26,19,7,1
SBI50DBC5687175,70,30,28,2,1
SBI91XHP7226638,99,29,21,8,1
SBI43HPQ6860339,65,23,17,6,1
SBI78KDW6071376,20,16,15,1,1
SBI48VHB9494659,78,29,20,9,1
SBI79FTD7841633,23,19,15,4,1
SBI91LFW4307180,72,22,14,8,1
SBI71IIH6244648,75,26,23,3,1
SBI02UAU6388840,62,22,16,6,1
SBI55TNX6649352,84,30,27,3,1
SBI76MJN3009101,68,33,27,6,1
SBI78SKK2024970,99,36,30,6,1
SBI34TKL7938450,22,13,8,5,1
SBI88SJY4363201,94,34,20,14,1
SBI97NKJ1245077,79,10,8,2,1
SBI87PJF3265259,87,20,15,5,1
SBI73QWR6819862,66,23,13,10,1
SBI72BHV0554098,98,23,21,2,1
SBI62UKS2082752,86,19,16,3,1
SBI22UFJ2167388,61,27,15,12,1
SBI56ULX4018522,94,27,25,2,1
SBI08XON2527349,65,19,17,2,1
SBI53QLR8131681,61,32,28,4,1
SBI93EOU4737192,62,29,15,14,1
SBI85DUS5844012,96,21,16,5,1
SBI02OGZ9070274,79,22,21,1,1
SBI32VJA6479173,63,18,15,3,1
SBI36CJN3503261,78,37,26,11,1
SBI81BOV4064759,75,22,12,10,1
SBI25LJT9332229,67,29,18,11,1
SBI37ORF1816082,96,28,17,11,1
SBI06ZMH2799959,70,19,11,8,1
SBI82RUO4550689,83,29,24,5,1
SBI80SFS4701675,99,25,16,9,1
SBI75KDM9519194,81,25,20,5,1
SBI27QRQ6848486,24,21,15,6,1
SBI11SHW0214517,71,17,12,5,1
SBI63URP6524710,81,24,19,5,1
SBI11SZM1334988,66,22,20,2,1
SBI91TAS8307034,25,25,18,7,1
SBI50PVR6780644,80,31,30,1,1
SBI79KWB1912004,25,30,24,6,1
SBI69CCF4014348,80,17,11,6,1
SBI96GVO9255856,81,29,18,11,1
SBI95DRP9003753,72,26,20,6,1
SBI03OZH4457864,20,29,26,3,1
SBI51YDS2157454,95,20,13,7,1
SBI65AJV6411364,18,24,17,7,1
SBI47TEQ1029318,67,14,13,1,1
SBI03CAH5087513,25,19,12,7,1
SBI63UWE0753883,76,28,22,6,1
SBI09KYX1505911,92,37,22,15,1
SBI19PVD2915806,18,28,18,10,1
SBI99DBX4311964,84,30,25,5,1
SBI69VBR1337212,70,26,21,5,1
SBI46UPJ6062338,82,16,15,1,1
SBI98WRU4756562,96,20,16,4,1
SBI47BYV0893180,89,25,18,7,1
SBI92PYN4213465,77,27,15,12,1
SBI34PKM5210219,96,27,15,12,1
SBI41MLV2335462,75,28,20,8,1
SBI48JMS6775992,99,26,15,11,1
SBI47NQX1722210,96,27,17,10,1
SBI95IDY4084601,64,19,10,9,1
SBI17OQC9919545,82,28,17,11,1
SBI23SPF0766091,66,28,18,10,1
SBI14HKA7446439,63,17,10,7,1
SBI58FVU3228913,61,29,15,14,1
SBI94SFC5795021,83,15,8,7,1
SBI51PXD6451436,70,22,14,8,1
SBI31NYX5194073,91,19,12,7,1
SBI78UMK0470285,20,18,16,2,1
SBI25NKC4862556,89,25,15,10,1
SBI41UZJ1564306,75,27,25,2,1
SBI16IKX4859275,22,27,22,5,1
SBI88OBP8298398,90,24,21,3,1
SBI02RIZ1621522,85,24,20,4,1
SBI65AKB2429913,95,25,14,11,1
SBI45AFH8328896,24,21,20,1,1
SBI62QUT7902772,20,24,16,8,1
SBI26MMW5627563,69,18,11,7,1
SBI41ZUS8040280,23,28,25,3,1
SBI20XOG2195576,78,29,16,13,1
SBI45NJE2112810,85,22,16,6,1
SBI37IUR4686524,81,23,22,1,1
SBI40SYF2508727,96,12,8,4,1
SBI61SID2890790,80,23,17,6,1
SBI89YIP5578039,65,25,15,10,1
SBI28OBB6696724,22,24,19,5,1
SBI72EUU7181194,84,22,13,9,1
SBI01SFH5627802,98,37,32,5,1
SBI15RET0427313,79,30,26,4,1
SBI17QDA2953852,20,24,16,8,1
SBI89WOZ5891656,84,26,17,9,1
SBI94HHP0175324,85,18,17,1,1
SBI18DEW2402867,81,22,14,8,1
SBI88LYD0829050,72,24,13,11,1
SBI38DZQ3296136,65,23,15,8,1
SBI76YIO2894595,96,27,26,1,1
SBI91GAI2709547,98,24,16,8,1
SBI68YTC8633760,88,20,12,8,1
SBI36LMD9541629,92,18,11,7,1
SBI60UFL8358683,73,25,13,12,1
SBI04JID2269039,62,15,8,7,1
SBI20DJT9962801,70,31,21,10,1
SBI50XGK7397758,67,39,25,14,1
SBI36JNV4954480,60,31,18,13,1
SBI80RXA3466218,93,29,17,12,1
SBI01JIJ3252499,95,28,17,11,1
SBI98QGJ4412098,81,28,22,6,1
SBI81DNO4382180,18,20,15,5,1
SBI52OOS4546925,75,32,20,12,1
SBI94NRR0884897,63,23,19,4,1
SBI04FRF0795235,60,30,26,4,1
SBI09OMC1553815,19,15,8,7,1
SBI63LBL7494053,83,27,16,11,1
SBI52JMD0276246,62,18,11,7,1
SBI63VXK5339205,82,21,11,10,1
SBI77FMM1464963,65,30,18,12,1
SBI55GKI0376286,66,12,7,5,1
SBI99XHG9026622,87,24,13,11,1
SBI97ATF6878173,62,29,28,1,1
SBI82ZMN3218034,91,24,18,6,1
SBI48WEA4786886,18,19,14,5,1
SBI52FSZ7835188,67,27,15,12,1
SBI98KES9208584,97,35,27,8,1
SBI48QWP4141250,62,26,21,5,1
SBI49GOS0083883,89,33,24,9,1
SBI38AOT4322388,23,32,22,10,1
SBI41TKN2964910,20,21,14,7,1
SBI68VQD5375108,64,34,18,16,1
SBI93XYF1530700,63,32,30,2,1
SBI91YMQ8188701,75,28,20,8,1
SBI40DGZ4656109,98,17,16,1,1
SBI11QNZ2072305,74,25,14,11,1
SBI90FGH3884056,67,27,14,13,1
SBI75OFD1318239,79,26,21,5,1
SBI49HVY6794389,69,17,13,4,1
SBI99UAL4993709,75,32,20,12,1
SBI47OVB9528396,69,28,19,9,1
SBI28SBT3823123,70,19,15,4,1
SBI26UXS1073846,89,18,12,6,1
SBI52QGC7712945,86,25,24,1,1
SBI85UFM1255987,81,24,14,10,1
SBI73PZU5463186,92,19,17,2,1
SBI53YGX4128995,87,20,16,4,1
SBI17AFG8459532,90,30,28,2,1
SBI36LQO6438721,81,26,18,8,1
SBI27TSU3620307,80,12,7,5,1
SBI84IGJ8097765,80,26,21,5,1
SBI50XLC6385925,63,28,17,11,1
SBI81QLW7959046,99,24,13,11,1
SBI99VIQ2282582,87,31,18,13,1
SBI71QZJ4072554,93,17,14,3,1
SBI90VHX0550104,75,16,13,3,1
SBI25BOY9791686,98,36,23,13,1
SBI58YXM3242541,18,27,19,8,1
SBI13PFS0852081,73,27,16,11,1
SBI13LLS3751542,80,29,28,1,1
SBI14QTN2933062,91,25,17,8,1
SBI22NVZ1198818,91,28,23,5,1
SBI99UMV9371864,19,24,13,11,1
SBI03LTV6185470,67,13,9,4,1
SBI08RKT8253247,98,32,18,14,1
SBI90ORP3710770,77,26,22,4,1
SBI01DHP4156603,77,26,21,5,1
SBI51GPL2243915,75,32,17,15,1
SBI52APR8417384,63,8,7,1,1
SBI08AWO5672977,62,17,11,6,1
SBI82UBY5112681,98,28,17,11,1
SBI40YRZ6169193,68,30,16,14,1
SBI19JDJ6489594,94,17,15,2,1
SBI23QWM3010162,18,27,15,12,1
SBI22SVE4798826,67,27,26,1,1
SBI65CPE8769753,20,23,22,1,1
SBI08WTG2738480,61,22,12,10,1
SBI93QWL0964514,74,21,13,8,1
SBI68XOJ9268735,61,17,15,2,1
SBI01XHS4254700,21,19,12,7,1
SBI11RIW9298559,92,27,14,13,1
SBI10NGO1780934,74,24,23,1,1
SBI02EUK1489263,93,24,23,1,1
SBI88RPF8834666,78,25,23,2,1
SBI65QSR8886755,91,19,10,9,1
SBI90LBT4308995,69,28,19,9,1
SBI55FWH7983045,80,22,13,9,1
SBI78WOL5542455,70,30,24,6,1
SBI87GVO6537520,99,31,23,8,1
SBI00AQT4050433,73,20,15,5,1
SBI52VPQ6348326,94,19,10,9,1
SBI70YWF0898562,77,28,16,12,1
SBI40PXR6548273,66,33,32,1,1
SBI04VBQ3060884,69,19,18,1,1
SBI55JBS9590537,67,21,19,2,1
SBI96BTA0785302,65,26,17,9,1
SBI17ITP1919562,85,28,15,13,1
SBI06QMY6726027,82,19,12,7,1
SBI52LEC8219034,97,22,13,9,1
SBI43DCX0726656,71,29,23,6,1
SBI82HZM7584226,60,29,24,5,1
SBI67KSX8756834,89,23,20,3,1
SBI15VVB3216193,97,21,20,1,1
SBI47UPB6794128,65,22,13,9,1
SBI41RGY4733539,25,15,12,3,1
SBI12FVW5553232,22,26,19,7,1
SBI89EHG1485121,79,25,19,6,1
SBI71FYI0659139,74,30,22,8,1
SBI73DQQ9366301,65,29,28,1,1
SBI07ZGR8465148,81,22,17,5,1
SBI44WCY7742667,88,30,23,7,1
SBI64HXI2946738,61,26,16,10,1
SBI33PEM3352250,19,23,22,1,1
SBI21OJF4998715,85,15,11,4,1
SBI48NZA4221501,98,19,17,2,1
SBI69QTA6829145,87,26,18,8,1
SBI83QEN1480022,83,21,11,10,1
SBI09LZK2441903,94,28,25,3,1
SBI48QLR4357653,65,29,24,5,1
SBI36ZWX9248652,69,25,13,12,1
SBI91ASQ7919884,88,25,17,8,1
SBI21QRQ8150048,86,23,17,6,1
SBI81CTP2970327,25,19,15,4,1
SBI67VYM6196945,96,28,21,7,1
SBI49EPY4778735,96,24,20,4,1
SBI31ZKH2125439,62,26,24,2,1
SBI82IYE8619445,87,32,20,12,1
SBI01BVX6702933,79,24,13,11,1
SBI04NUE7452502,83,21,20,1,1
SBI33GFR7111527,66,28,25,3,1
SBI75EHA8215391,61,22,18,4,1
SBI83VVG6569716,76,25,13,12,1
SBI25IYG8592534,98,25,19,6,1
SBI21ZHM4669046,94,32,23,9,1
SBI11ZNJ4397709,85,22,12,10,1
SBI29TOP4529337,24,28,22,6,1
SBI41JZU5210042,63,30,23,7,1
SBI81ZZV3031797,82,21,13,8,1
SBI98GWB1627496,81,21,20,1,1
SBI84AGE2475085,72,27,14,13,1
SBI57HBY1722123,20,26,25,1,1
SBI98TCL4740915,21,26,19,7,1
SBI73KOV0868604,24,20,19,1,1
SBI12EQL8234351,92,27,25,2,1
SBI34UXY9854516,93,19,12,7,1
SBI33JJC0615449,69,27,14,13,1
SBI80DDE0760318,63,27,14,13,1
SBI61VFE2939084,92,26,21,5,1
SBI42XIV0756297,79,30,17,13,1
SBI38FPN8644538,75,31,21,10,1
SBI48DXB9662461,76,21,13,8,1
SBI82LIS7828341,65,20,15,5,1
SBI15SET9947239,80,16,10,6,1
SBI65QSB6197473,66,24,15,9,1
SBI97RUR4902975,64,25,23,2,1
SBI92XNR1596707,24,34,21,13,1
SBI95PVQ7951169,86,12,11,1,1
SBI27GUP0642584,94,33,17,16,1
SBI13LWM0875007,85,25,17,8,1
SBI98GTA2301802,22,27,18,9,1
SBI17SSL3897956,69,31,26,5,1
SBI69IFB9238663,76,27,18,9,1
SBI78LWI2701423,61,30,24,6,1
SBI94ZMB0985040,66,19,13,6,1
SBI80YCY6567870,83,29,28,1,1
SBI74FZK9614074,80,34,30,4,1
SBI44CPS5584959,21,19,17,2,1
SBI62UWW2881475,68,28,19,9,1
SBI69KMN1781725,89,33,26,7,1
SBI53ALH5307584,78,27,21,6,1
SBI23PAR5805749,20,29,17,12,1
SBI06GSM1519919,86,24,17,7,1
SBI24QWV9268043,24,33,20,13,1
SBI79AUD8434538,81,20,17,3,1
SBI39VIP9774345,73,18,15,3,1
SBI64CVE3150510,94,25,23,2,1
SBI14PDI7227377,60,23,22,1,1
SBI72IZE9876435,18,26,16,10,1
SBI45NEI6865780,79,27,19,8,1
SBI24UXG5306527,96,17,9,8,1
SBI77YZQ0656728,18,32,20,12,1
SBI80BFV8917738,19,23,14,9,1
SBI27MPA0781432,99,29,18,11,1
SBI15KWK2347817,20,23,18,5,1
SBI75DZZ9349741,83,31,21,10,1
SBI66XOI9033489,84,31,21,10,1
SBI24ZAA9995765,83,30,26,4,1
SBI06WEO7730670,60,23,21,2,1
SBI23XOZ6922281,60,35,31,4,1
SBI78CWA8950834,95,19,17,2,1
SBI30MCO7982101,98,24,14,10,1
SBI34HYG0209897,20,36,24,12,1
SBI65OZN1029110,80,18,14,4,1
SBI40EBC2806976,84,33,30,3,1
SBI89IRU6322233,90,27,16,11,1
SBI97MQK5026503,63,19,13,6,1
SBI38NLO3680239,63,27,19,8,1
SBI98SWB6739074,86,23,15,8,1
SBI69ZWX3005057,83,25,14,11,1
SBI12UVM1098172,90,31,24,7,1
SBI45PJR2057203,68,22,13,9,1
SBI04QCG0023568,60,24,22,2,1
SBI98HNV7264652,20,16,10,6,1
SBI87PRL0519071,99,25,23,2,1
SBI11UAT8492728,99,18,10,8,1
SBI43ONR0944763,68,32,21,11,1
SBI41VLD2391075,90,25,14,11,1
SBI76JQC8457705,71,32,29,3,1
SBI92TLF7261207,98,31,20,11,1
SBI03LJY2307433,24,25,13,12,1
SBI56EHZ5076498,91,27,25,2,1
SBI75YCO2004170,62,23,18,5,1
SBI77NKN2938222,70,17,10,7,1
SBI20ABW3914385,77,25,13,12,1
SBI95JEW3695473,18,22,14,8,1
SBI15DOP2289385,18,21,17,4,1
SBI83KAT3815948,18,18,10,8,1
SBI78AMN2653311,24,25,17,8,1
SBI65NRY3301229,67,15,8,7,1
SBI78GCL6838329,91,25,15,10,1
SBI30AFR5212711,92,32,31,1,1
SBI50AFO9185895,23,28,26,2,1
SBI71TBU3590446,79,22,20,2,1
SBI49RYB7884556,99,22,13,9,1
SBI06PGD1621660,70,31,17,14,1
SBI66SPG8931906,79,24,22,2,1
SBI04UIN9681582,82,24,18,6,1
SBI38ZBA7806042,75,28,21,7,1
SBI20ZKW3565296,82,28,20,8,1
SBI52SAE3072234,20,25,23,2,1
SBI50LFA1478999,66,29,25,4,1
SBI67MUH8490417,89,22,17,5,1
SBI94NHN5687151,87,16,14,2,1
SBI16OAS5989639,24,19,16,3,1
SBI83OGT4005106,90,23,19,4,1
SBI26HYV0514426,24,26,17,9,1
SBI56LJW3783382,61,24,19,5,1
SBI95XEZ3009048,63,29,22,7,1
SBI14ENJ2753435,97,17,15,2,1
SBI02GUQ3256102,22,27,24,3,1
SBI86XWA8038835,76,31,20,11,1
SBI38IUE8360786,61,26,18,8,1
SBI05JTN0478016,72,32,28,4,1
SBI67MQM1477742,25,23,12,11,1
SBI33EQO6128876,21,33,31,2,1
SBI85MBX3968862,84,21,15,6,1
SBI45RGR9885541,22,29,21,8,1
SBI32FVD9225987,66,19,10,9,1
SBI93XNA5677803,93,16,13,3,1
SBI34MOK7230029,21,15,8,7,1
SBI89HIF6001073,81,26,17,9,1
SBI02HAV8048148,62,29,28,1,1
SBI31TWE7417975,98,22,19,3,1
SBI34EAJ9903421,19,29,24,5,1
SBI74HEC5045545,24,24,16,8,1
SBI01DTL3837203,20,24,19,5,1
SBI26PNC8662240,68,21,17,4,1
SBI30LIF2568779,90,32,19,13,1
SBI82QFN8384843,64,35,20,15,1
SBI24YFX5937347,18,25,17,8,1
SBI00RAO6620633,74,42,22,20,1
SBI57TXO8960243,87,22,14,8,1
SBI51MHY4823964,79,22,18,4,1
SBI05ADT5723063,25,28,18,10,1
SBI94COE7790513,79,18,10,8,1
SBI34OSA0392626,77,25,22,3,1
SBI89LEL5376902,85,25,13,12,1
SBI84EIO3801873,95,24,16,8,1
SBI90JFT0676525,63,31,20,11,1
SBI51WNJ6904318,83,22,13,9,1
SBI19GEM2189278,91,17,9,8,1
SBI73ORR9568493,24,24,16,8,1
SBI78NRM0968139,23,22,21,1,1
SBI47ZFS5527860,18,33,31,2,1
SBI62UWB5868630,18,23,17,6,1
SBI33KJS1980720,80,18,11,7,1
SBI90PGF7632293,84,31,17,14,1
SBI74ZFO0893593,82,23,19,4,1
SBI68IUY4829620,82,27,20,7,1
SBI59YAT6383635,65,24,18,6,1
SBI43BXG1887526,71,23,18,5,1
SBI41EXF1704983,21,20,12,8,1
SBI64IQS4749937,61,29,26,3,1
SBI01BMN8128405,96,25,18,7,1
SBI38ZKB5609018,91,25,14,11,1
SBI80BWL8021469,93,21,17,4,1
SBI29XOP7310697,82,19,18,1,1
SBI82FRO6660053,83,23,14,9,1
SBI47SPC4179448,89,23,19,4,1
SBI71ZRU5368828,80,24,20,4,1
SBI92UTU5290637,92,15,9,6,1
SBI70AKJ2496725,81,23,12,11,1
SBI43CFK2048922,81,17,9,8,1
SBI43OHF0558060,85,18,12,6,1
SBI96TQE8738474,25,27,20,7,1
SBI05HGK3688750,22,23,20,3,1
SBI42LUL4162627,78,22,15,7,1
SBI27FRQ4284575,96,20,16,4,1
SBI16WVB8188030,19,24,21,3,1
SBI12IUW6413715,89,27,22,5,1
SBI09FYC8993776,70,22,16,6,1
SBI85ZSB4812685,69,26,18,8,1
SBI82KBB5267281,64,27,21,6,1
SBI56PJY4976738,71,22,14,8,1
SBI17ILT1907957,24,19,16,3,1
SBI55FPU7770617,94,19,17,2,1
SBI84JGA5342261,90,27,19,8,1
SBI99AAS5920941,71,19,16,3,1
SBI93MMW5903554,88,30,26,4,1
SBI58WNT6774212,69,20,19,1,1
SBI96QSY1339279,19,23,22,1,1
SBI10NEI8615175,89,34,22,12,1
SBI42CNK5967491,22,22,16,6,1
SBI32GIX6226265,85,29,16,13,1
SBI30BOV3983209,87,17,16,1,1
SBI54YXX5688277,97,23,13,10,1
SBI99HXO0749479,83,26,17,9,1
SBI85YOX2077104,73,28,21,7,1
SBI29REN6737854,66,20,17,3,1
SBI85CAW8167462,18,21,16,5,1
SBI43ILK6154135,66,20,13,7,1
SBI56IYI0802870,93,29,20,9,1
SBI72STD9651700,81,27,24,3,1
SBI87MZT3879039,78,22,16,6,1
SBI44JOD6577948,98,29,28,1,1
SBI97WMC6244401,65,18,13,5,1
SBI01YYI7074606,76,17,10,7,1
SBI99VIC6806315,86,26,14,12,1
SBI17FTD0401000,93,31,22,9,1
SBI77TNC5859177,80,29,25,4,1
SBI63OCK3558194,93,35,22,13,1
SBI28QCE4208305,99,23,13,10,1
SBI80RVX0437941,68,26,22,4,1
SBI24XRY2389334,66,29,24,5,1
SBI79WWO0504085,74,23,15,8,1
SBI44BYR3639678,22,31,28,3,1
SBI27RCZ4724552,81,26,21,5,1
SBI26GQP1241982,76,24,13,11,1
SBI10DIR1045812,88,25,24,1,1
SBI85EXE4532261,79,13,8,5,1
SBI07ERC8010430,83,25,13,12,1
SBI64XKR5769295,93,29,25,4,1
SBI06KIJ1190572,21,24,23,1,1
SBI95CPV1563152,73,27,14,13,1
SBI78RBQ9566025,78,21,13,8,1
SBI80XMK2184874,67,21,13,8,1
SBI87FMJ3902598,20,25,14,11,1
SBI77HXV3332798,22,30,19,11,1
SBI35YUV5914012,73,30,25,5,1
SBI94YUH4615588,18,22,13,9,1
SBI75DFF0187629,93,30,22,8,1
SBI20TUQ4092260,21,24,23,1,1
SBI42AHD2515327,82,27,15,12,1
SBI25AMJ4518301,71,35,32,3,1
SBI29JGE4548463,81,25,18,7,1
SBI79IUZ2723858,89,20,17,3,1
SBI17YJT6872727,97,32,30,2,1
SBI25HUS2985946,83,19,11,8,1
SBI50DEH4678816,73,32,18,14,1
SBI55HHK4622337,79,34,28,6,1
SBI98VJL0875727,73,34,27,7,1
SBI76KCK2469411,67,20,15,5,1
SBI91DZN4265743,70,35,19,16,1
SBI02KYL8920150,77,32,23,9,1
SBI32CZN7062081,60,25,14,11,1
SBI40NER1202273,79,22,15,7,1
SBI59ZWQ7307666,93,20,11,9,1
SBI85BQS6751255,19,22,16,6,1
SBI82JAS7836622,72,25,21,4,1
SBI03GUD0561151,78,27,15,12,1
SBI45XXK5382752,62,16,14,2,1
SBI58LXS3285773,68,14,13,1,1
SBI96VUM1085080,95,22,12,10,1
SBI07JOM3084060,72,22,18,4,1
SBI01SVZ8906212,21,19,18,1,1
SBI04XGN7424962,78,25,20,5,1
SBI14QPM3624645,61,31,26,5,1
SBI27BHS9237917,64,21,14,7,1
SBI09CHS8855341,72,30,23,7,1
SBI69CKH1527795,91,30,20,10,1
SBI52CBM7492537,62,19,17,2,1
SBI21RPA2567774,96,30,17,13,1
SBI93DVQ1820879,62,25,13,12,1
SBI63TIR2814630,76,17,16,1,1
SBI41LIV5765757,86,27,23,4,1
SBI64GXP9439673,90,21,16,5,1
SBI58HWF2078784,96,31,27,4,1
SBI98CTM5455376,71,15,14,1,1
SBI05YZI8115819,78,20,11,9,1
SBI81AFP2462981,70,31,27,4,1
SBI22EKJ9349977,82,25,21,4,1
SBI91HTU0168600,71,22,21,1,1
SBI62NWU0136127,86,20,16,4,1
SBI73XUW3485157,25,25,16,9,1
SBI44CMQ2070135,92,23,19,4,1
SBI23XTK7589681,62,18,12,6,1
SBI19HKW9086891,70,23,19,4,1
SBI33DSS9231090,68,25,22,3,1
SBI48JKQ6929144,71,28,22,6,1
SBI56UAE3361046,20,27,22,5,1
SBI47AMS6538921,25,26,14,12,1
SBI48VQQ4479386,20,37,25,12,1
SBI83UAI4263582,60,25,24,1,1
SBI95XNO7993529,89,19,15,4,1
SBI22NLZ6745616,74,32,28,4,1
SBI70OYO7872478,24,33,26,7,1
SBI20UUG4150818,65,20,12,8,1
SBI31YFP1566363,97,23,21,2,1
SBI39OHR8144803,77,28,24,4,1
SBI22OLB6397119,21,28,21,7,1
SBI32GPU9583283,68,17,13,4,1
SBI36MIH9913901,69,30,20,10,1
SBI40KUS3821546,60,30,19,11,1
SBI49KIN9423480,20,16,9,7,1
SBI53WKW5668792,25,23,19,4,1
SBI89ZKM0340787,82,21,20,1,1
SBI52PPE1359800,90,23,16,7,1
SBI32STF6890632,18,28,19,9,1
SBI98FSL4781025,89,17,12,5,1
SBI16XKM8891591,60,23,15,8,1
SBI00SVT8567914,90,32,17,15,1
SBI71KKC7078613,25,29,20,9,1
SBI35PKY5438731,78,25,21,4,1
SBI10ZBO4822286,67,24,20,4,1
SBI15DAT8851692,62,21,14,7,1
SBI90ZXA8899647,68,23,22,1,1
SBI90AAD5827409,84,25,20,5,1
SBI73AAF8604838,25,20,14,6,1
SBI13DDA8925376,60,28,22,6,1
SBI52BBE1154249,66,27,19,8,1
SBI84QNN9865772,98,23,22,1,1
SBI35VYT6429018,70,24,20,4,1
SBI34EAZ1089610,87,16,9,7,1
SBI35TBY0658534,89,26,18,8,1
SBI66GSW7214291,88,32,28,4,1
SBI55OIJ0611472,85,26,20,6,1
SBI19QAD1911571,61,25,24,1,1
SBI33RPN8189763,90,17,10,7,1
SBI94TIB7988711,79,22,18,4,1
SBI75OKW1035821,62,31,27,4,1
SBI79DUG6332608,75,14,13,1,1
SBI61ETT3268423,25,27,23,4,1
SBI93YBF1563510,67,27,20,7,1
SBI50ETB9212810,63,19,13,6,1
SBI59QBJ2343134,24,21,14,7,1
SBI52NRH5025325,91,25,16,9,1
SBI52NIT6016756,96,21,12,9,1
SBI71AHG0813450,78,27,20,7,1
SBI95ULA7054666,86,25,22,3,1
SBI67CIN9494011,91,25,20,5,1
SBI48XIE9772849,83,17,12,5,1
SBI33GQS7488291,92,18,12,6,1
SBI37ERV1554945,83,17,9,8,1
SBI48TAU9007847,86,29,22,7,1
SBI57QDM2118267,66,29,28,1,1
SBI27ADU4644021,88,22,17,5,1
SBI50BSH9174110,69,22,17,5,1
SBI21XET6161925,70,24,13,11,1
SBI87RLY9482632,68,26,22,4,1
SBI14ZOC1358671,70,34,21,13,1
SBI59QYN6255463,69,30,20,10,1
SBI14XJH5279026,24,21,14,7,1
SBI59BLD2742668,60,20,15,5,1
SBI72ORH6005598,88,21,17,4,1
SBI20VPL1522859,20,27,14,13,1
SBI13SHT9409335,71,23,20,3,1
SBI37XEC2426505,67,33,19,14,1
SBI61QDI4606271,86,36,25,11,1
SBI67PKD1753083,85,22,17,5,1
SBI71WXB9445126,18,21,18,3,1
SBI22PWK0402886,80,26,25,1,1
SBI14ZPF1287699,23,36,35,1,1
SBI45WZE6062187,86,29,22,7,1
SBI94EHY8099976,24,9,6,3,1
SBI64FYC1994844,68,23,16,7,1
SBI83QRJ7629197,60,30,24,6,1
SBI04BJR5497203,88,20,16,4,1
SBI45QZK0263872,20,19,16,3,1
SBI17XUV9024521,73,25,19,6,1
SBI58FFR0923842,62,22,13,9,1
SBI82FTJ0420297,98,26,19,7,1
SBI09DWQ0581556,84,28,19,9,1
SBI92KIJ7287189,63,26,20,6,1
SBI32DZM8702065,96,27,15,12,1
SBI82TIQ1241160,69,13,7,6,1
SBI38XRY1324737,66,19,10,9,1
SBI12POR4621210,23,29,19,10,1
SBI59XGT6135672,69,25,14,11,1
SBI17DFY9004688,75,25,17,8,1
SBI39FVD6178929,61,35,29,6,1
SBI62EMV5763846,84,20,15,5,1
SBI38HIQ3301078,95,28,26,2,1
SBI11VYG7800245,77,15,9,6,1
SBI83EFY0712510,90,23,22,1,1
SBI73BCD3238200,68,14,12,2,1
SBI38LWD9016788,89,25,20,5,1
SBI23NPS2900123,20,25,19,6,1
SBI25LMY2267998,23,31,26,5,1
SBI12FHK5260846,98,19,16,3,1
SBI46PFA5952526,70,18,10,8,1
SBI44MOQ9221906,25,23,16,7,1
SBI96IXY8264652,60,18,12,6,1
SBI46KJG0769538,90,32,22,10,1
SBI00PCU1014527,61,24,14,10,1
SBI96DRF9267710,60,23,20,3,1
SBI46ENK9869794,89,28,19,9,1
SBI97FJI3351710,19,23,17,6,1
SBI22YUF1839242,91,34,19,15,1
SBI63FHF1210553,98,30,18,12,1
SBI19QFM1652133,72,30,25,5,1
SBI13JBT3838808,67,25,16,9,1
SBI50NBY3362439,82,20,17,3,1
SBI11ZGT5908493,69,22,16,6,1
SBI55BBD5370165,95,31,22,9,1
SBI60UUO2961363,61,19,15,4,1
SBI24BJV7691355,22,19,12,7,1
SBI97BKI4698242,89,23,15,8,1
SBI04WOH3688713,77,20,19,1,1
SBI54SZU5190073,64,25,18,7,1
SBI14NXZ4949574,62,24,20,4,1
SBI15ALE3859212,95,28,27,1,1
SBI24DCT7410807,70,32,20,12,1
SBI23AJC0449125,63,25,19,6,1
SBI20GLL5694080,64,28,22,6,1
SBI36QLL1733058,81,33,27,6,1
SBI40YVC4318208,81,14,8,6,1
SBI20JPP4621030,73,19,13,6,1
SBI07XME5528832,61,32,22,10,1
SBI05VWO8403240,89,29,16,13,1
SBI14ROX7367712,64,23,21,2,1
SBI58QHL0912703,68,32,31,1,1
SBI45DCP8904462,94,29,16,13,1
SBI10LMM8155628,24,20,11,9,1
SBI70PDZ9575347,96,30,25,5,1
SBI05AFS6446486,66,32,17,15,1
SBI41GGQ6408935,70,25,22,3,1
SBI23WDA6066944,63,32,28,4,1
SBI77LWS8438692,66,29,20,9,1
SBI22EDX6769857,18,25,15,10,1
SBI85LRQ1326377,23,32,19,13,1
SBI58RTH6851136,71,29,20,9,1
SBI70FJD4583255,83,19,18,1,1
SBI20YIC5991259,96,24,13,11,1
SBI76BZN6609483,69,25,21,4,1
SBI86AOC5816011,91,24,18,6,1
SBI77EKK2953361,69,25,23,2,1
SBI97VPY3528380,18,23,17,6,1
SBI69ZIV4981200,84,26,20,6,1
SBI49ZKQ2233063,91,24,14,10,1
SBI26EXE7670797,84,22,18,4,1
SBI93XPR0747544,65,22,12,10,1
SBI31YMF9651566,25,24,14,10,1
SBI07CJA9719684,90,26,23,3,1
SBI99VRJ7443814,70,19,18,1,1
SBI52RPS2879256,21,20,11,9,1
SBI05KUL2580053,81,22,16,6,1
SBI54TCN9223406,91,23,21,2,1
SBI45JLT2945808,61,26,23,3,1
SBI97OQU3790395,99,23,20,3,1
SBI12ZYD4818084,81,23,16,7,1
SBI63SKO5029778,82,29,27,2,1
SBI85QPN3257654,91,17,16,1,1
SBI87YZO2577418,69,13,8,5,1
SBI62ZBS2614187,21,21,11,10,1
SBI70ZML8177689,69,23,18,5,1
SBI27YNR4167625,22,17,15,2,1
SBI77GSL6497266,93,17,13,4,1
SBI62AMJ5768606,99,30,28,2,1
SBI91HMW5968410,70,28,25,3,1
SBI56WPS8470127,84,31,25,6,1
SBI20QIO4464960,71,17,13,4,1
SBI64EXA1943204,65,32,21,11,1
SBI80OME4006086,80,28,17,11,1
SBI58CAC7744071,94,29,18,11,1
SBI78QAQ6653528,23,26,20,6,1
SBI43JWF0750654,98,24,20,4,1
SBI01WSA4620163,75,23,19,4,1
SBI54FZT9655390,67,26,18,8,1
SBI81BES8993366,19,31,20,11,1
SBI48DVS1970070,84,24,21,3,1
SBI45ANQ9280844,89,25,21,4,1
SBI89VUY4473696,69,21,13,8,1
SBI76HUM6686889,65,19,14,5,1
SBI76AMC3285902,67,20,16,4,1
SBI63OHO7740292,95,32,19,13,1
SBI71KOZ2465007,94,25,24,1,1
SBI79AII6948264,62,32,22,10,1
SBI98UTF7049110,78,22,16,6,1
SBI99DWR9612482,19,27,15,12,1
SBI62PLT9985814,62,17,10,7,1
SBI40XJN5960982,71,16,12,4,1
SBI51LTS5282853,66,19,14,5,1
SBI99AVE9196360,18,25,24,1,1
SBI30LEC2181203,68,32,25,7,1
SBI81DTO4814837,62,24,15,9,1
SBI31SKI8067947,94,17,10,7,1
SBI27XNM5315736,82,21,20,1,1
SBI65HXQ6167224,20,15,10,5,1
SBI33YAO9971208,65,32,25,7,1
SBI54RWR8014642,90,29,27,2,1
SBI87HDG2921354,80,24,21,3,1
SBI38TQI0218656,88,15,10,5,1
SBI45MQF0042430,86,33,20,13,1
SBI50OLM2887915,87,24,23,1,1
SBI33IHZ6604726,89,30,17,13,1
SBI20EJE2997512,88,30,29,1,1
SBI37WVC8230091,96,24,15,9,1
SBI59BCW0594570,85,20,17,3,1
SBI70HZF4158840,71,26,18,8,1
SBI98JJI6061333,23,24,23,1,1
SBI89IPM0780778,74,27,23,4,1
SBI86ZVF7544767,81,26,18,8,1
SBI19VWB0516926,92,20,16,4,1
SBI51XKD6600424,74,27,19,8,1
SBI00SLH3834633,71,38,23,15,1
SBI13QPI5362188,22,19,16,3,1
SBI88HYP3578777,95,24,19,5,1
SBI18MJL4648350,66,20,17,3,1
SBI28PPT7157720,20,22,16,6,1
SBI05LFZ6522992,61,25,15,10,1
SBI96PSP4097874,87,26,20,6,1
SBI65XXI0196506,20,23,17,6,1
SBI21OTN8530955,84,21,17,4,1
SBI50MKO5967324,98,31,20,11,1
SBI74AEE5287192,80,22,18,4,1
SBI05QCG3609549,88,31,18,13,1
SBI21ZGV4020995,69,23,21,2,1
SBI56UEJ0867488,72,31,20,11,1
SBI38LGX5914103,69,32,31,1,1
SBI80QNY3865079,23,25,15,10,1
SBI98DGA6304765,19,21,14,7,1
SBI50YIS3959120,90,16,9,7,1
SBI88SAK8915001,85,20,13,7,1
SBI32RNX9603812,73,21,13,8,1
SBI24FQP4517399,23,22,13,9,1
SBI42RCC7641020,67,21,15,6,1
SBI03BFJ3801119,93,32,31,1,1
SBI27WHH4302179,66,19,16,3,1
SBI72QVF1594651,90,23,21,2,1
SBI82UUB9744776,63,31,28,3,1
SBI15OHJ4765372,83,37,28,9,1
SBI69PBD7696945,71,20,11,9,1
SBI97DJF5914385,25,19,13,6,1
SBI55XFL5453850,71,27,25,2,1
SBI78DTN0974862,93,18,10,8,1
SBI41PGE8177236,67,28,24,4,1
SBI58PLZ1655072,25,27,21,6,1
SBI98HEA6576767,68,27,19,8,1
SBI33KTN6616171,74,24,23,1,1
SBI89XZX3320009,60,30,16,14,1
SBI56YZH8708690,63,25,22,3,1
SBI51JJS0037165,99,23,20,3,1
SBI02QVH5006140,64,23,16,7,1
SBI59UGA6087167,92,20,15,5,1
SBI04EBG2244965,91,22,19,3,1
SBI63OZT9592114,94,26,19,7,1
SBI93XYE8251276,22,18,16,2,1
SBI04SSB0372404,96,30,19,11,1
SBI22BEW7877710,68,34,23,11,1
SBI25IJO1032034,20,25,18,7,1
SBI61PBO8109017,95,32,29,3,1
SBI44BZL5665401,75,19,12,7,1
SBI75ROG6390209,97,27,14,13,1
SBI48OKJ9730812,74,31,20,11,1
SBI57ITB0915111,78,23,20,3,1
SBI50MNW2858647,63,28,21,7,1
SBI32OKD2099802,85,21,19,2,1
SBI60JQU9664030,83,31,25,6,1
SBI14CEA2234609,60,28,16,12,1
SBI96JTE1180810,82,28,16,12,1
SBI30JEO8287717,79,25,22,3,1
SBI31TKD3182206,62,21,16,5,1
SBI42TIM7938614,92,20,15,5,1
SBI54KWL1051305,75,30,23,7,1
SBI48MOD0207553,67,29,17,12,1
SBI17MDM9274601,89,28,21,7,1
SBI57KTG4685716,96,17,10,7,1
SBI08KPZ5846064,62,14,10,4,1
SBI20BWA3641570,82,22,13,9,1
SBI74VTC1749718,90,23,15,8,1
SBI63LSN1841707,61,26,14,12,1
SBI19QHS2886350,84,26,20,6,1
SBI16OSH3719891,97,21,19,2,1
SBI98YGO2418557,99,19,12,7,1
SBI71QDW6391902,76,24,15,9,1
SBI52IJI5976005,70,28,23,5,1
SBI73KWU5249971,98,19,11,8,1
SBI09YUQ9839899,22,16,9,7,1
SBI68KEF0713164,24,24,22,2,1
SBI04XQG9702152,73,19,10,9,1
SBI20ZSY9211116,62,28,20,8,1
SBI40YTY7732641,94,31,19,12,1
SBI05XOI1143179,62,31,16,15,1
SBI69TAL5954408,75,19,18,1,1
SBI03BRJ1242753,66,23,22,1,1
SBI80JNK2090434,75,25,18,7,1
SBI39VKL8170236,81,29,28,1,1
SBI16YMT2270430,88,28,21,7,1
SBI41SHX6785197,81,26,18,8,1
SBI05WAA4292874,91,34,30,4,1
SBI23NWX6555788,67,27,14,13,1
SBI18SUC2272145,82,31,18,13,1
SBI55XHN7979322,98,29,20,9,1
SBI65LWI5260183,86,27,24,3,1
SBI63HPV9829596,18,24,18,6,1
SBI52XGR6686230,70,20,19,1,1
SBI91VFA6236018,19,22,19,3,1
SBI96HOW9887570,86,26,18,8,1
SBI83UKF5483066,68,21,13,8,1
SBI05RPW4538133,64,22,16,6,1
SBI96SMI7205771,85,24,14,10,1
SBI80DRU5704158,76,31,29,2,1
SBI61LAZ1267637,63,22,21,1,1
SBI65ALQ6405129,96,21,17,4,1
SBI54OMH5648118,94,35,28,7,1
SBI83QFO1742929,25,19,16,3,1
SBI72LRN8225371,62,25,16,9,1
SBI65YCH4765073,79,35,20,15,1
SBI42IJS4823608,90,17,10,7,1
SBI88SFV7534051,62,21,19,2,1
SBI33LYO7760488,79,26,15,11,1
SBI82BMM9798615,95,25,14,11,1
SBI47OKW8254065,61,28,18,10,1
SBI30NHZ7910629,94,21,13,8,1
SBI13NTX2233682,87,30,27,3,1
SBI97XLE7231693,86,24,20,4,1
SBI54RKP1856710,21,19,16,3,1
SBI84OKY6800101,92,38,37,1,1
SBI84THX8277677,94,27,23,4,1
SBI45ZBA7544542,82,28,18,10,1
SBI80ZVI5818232,99,25,21,4,1
SBI06NEA8035095,23,20,15,5,1
SBI09VRA2847765,83,24,13,11,1
SBI80FGV5284068,89,28,21,7,1
SBI09LCM6976725,95,26,25,1,1
SBI92XHE1806344,84,27,26,1,1
SBI29RNH7804519,65,21,16,5,1
SBI78YZV1649354,82,31,18,13,1
SBI61JSF6946297,61,31,24,7,1
SBI64ITS5918504,81,20,13,7,1
SBI98CKY7319517,88,12,8,4,1
SBI64PHB7881879,80,18,14,4,1
SBI94OCJ8488770,93,25,24,1,1
SBI60WSE3553286,23,22,21,1,1
SBI08EQI4265721,99,29,24,5,1
SBI72QUD7797069,73,32,19,13,1
SBI55DOX4411216,83,23,12,11,1
SBI05BBT4689427,83,27,19,8,1
SBI50SEP4356709,61,28,22,6,1
SBI71GYU4572974,62,24,14,10,1
SBI84UHF4577646,89,26,17,9,1
SBI66UUK0638734,97,27,23,4,1
SBI58LEP7968155,91,24,18,6,1
SBI72DIS7422158,90,31,26,5,1
SBI43JJL0884550,81,25,24,1,1
SBI74ACD2495161,79,25,18,7,1
SBI71KGN4548032,98,32,18,14,1
SBI97REF4277727,67,25,16,9,1
SBI09SAK8795209,67,21,19,2,1
SBI99JQH9478628,83,27,18,9,1
SBI57CON6288378,69,14,12,2,1
SBI34FAW9337877,18,24,21,3,1
SBI61XZJ6628124,84,26,16,10,1
SBI51GDI3033617,73,25,14,11,1
SBI01ZZZ6696035,95,24,15,9,1
SBI08FAS2405456,88,27,23,4,1
SBI07BIV8110104,99,23,12,11,1
SBI83YRG2634256,68,23,20,3,1
SBI92JLX3942983,68,23,17,6,1
SBI31BCZ0848416,93,16,15,1,1
SBI56FTC3523876,19,17,15,2,1
SBI72EKV0808649,65,21,20,1,1
SBI31DTT4760480,69,22,18,4,1
SBI83PJZ1516528,99,28,22,6,1
SBI82UOE4857685,99,26,17,9,1
SBI33RPV6469643,19,27,21,6,1
SBI21NIJ4851971,82,28,21,7,1
SBI25WOV1073754,92,22,14,8,1
SBI48MVB3382753,84,28,23,5,1
SBI91QBO1423455,82,28,25,3,1
SBI91WSP3760423,92,23,15,8,1
SBI55REB6517816,68,28,15,13,1
SBI43IYB8843986,25,34,23,11,1
SBI18DJR4363865,83,30,27,3,1
SBI69MZI6365611,76,27,18,9,1
SBI10DJH3946562,73,15,10,5,1
SBI93UGC0139037,67,33,21,12,1
SBI28PBT8179372,69,30,27,3,1
SBI61INI6010339,66,24,21,3,1
SBI57HGD4170958,24,15,8,7,1
SBI23SLS5526891,79,29,27,2,1
SBI25ACW6277101,93,21,13,8,1
SBI05SRH3371964,64,17,12,5,1
SBI69ODM3121082,71,23,17,6,1
SBI89KYY4466920,71,26,19,7,1
SBI91JYD0486603,64,21,18,3,1
SBI82NKU5483047,85,18,13,5,1
SBI85OWC5408601,91,31,22,9,1
SBI19IDZ2520307,22,25,16,9,1
SBI34TOC4479602,79,27,24,3,1
SBI14KBK1093479,66,23,13,10,1
SBI11TWC4471270,77,28,27,1,1
SBI65ENA7422135,75,15,9,6,1
SBI34SYU8928390,65,30,16,14,1
SBI35SWE5220836,66,28,17,11,1
SBI10UYL2527179,95,18,11,7,1
SBI04PHI2275990,90,31,24,7,1
SBI97HYP5699632,95,18,16,2,1
SBI90UNF3597468,63,25,13,12,1
SBI09VBU7236157,75,25,17,8,1
SBI04VFE5807384,19,23,21,2,1
SBI00BMM5442390,92,29,26,3,1
SBI14ZDL8052572,96,24,23,1,1
SBI10CNE8259113,74,30,28,2,1
SBI36EQJ0335019,18,24,19,5,1
SBI72GOF6011894,64,26,17,9,1
SBI16AOS3005801,22,21,17,4,1
SBI96IVD1101628,96,17,9,8,1
SBI80DZA1452621,69,17,13,4,1
SBI39DLY0641055,60,27,22,5,1
SBI23MCE6905788,80,23,18,5,1
SBI55JHK0279572,96,14,9,5,1
SBI22RPO1693079,76,27,17,10,1
SBI85ONX8646650,64,22,18,4,1
SBI73DKX7158875,82,15,11,4,1
SBI28GTN0203828,76,27,21,6,1
SBI12UCJ9562235,81,25,24,1,1
SBI72YMI7885154,25,22,15,7,1
SBI47LSI5361661,99,29,23,6,1
SBI85TDR5145927,75,31,24,7,1
SBI28TOT5950644,65,22,14,8,1
SBI42IHF8553686,95,27,16,11,1
SBI43BLQ8910421,78,24,14,10,1
SBI04BLJ6230210,79,30,29,1,1
SBI85TFW6326954,98,18,15,3,1
SBI10ANG1223935,64,24,16,8,1
SBI75GRQ7337943,96,28,18,10,1
SBI15EFA7608959,83,30,26,4,1
SBI70ECA7567339,60,30,23,7,1
SBI70YWS0149971,88,24,22,2,1
SBI33TKV9101936,69,22,21,1,1
SBI76PNA8930712,99,17,12,5,1
SBI58UQX2929733,18,24,19,5,1
SBI09AMD6818950,67,23,22,1,1
SBI74HHZ3045697,18,26,15,11,1
SBI85TNN3251287,23,24,14,10,1
SBI83ZSA8021671,86,30,19,11,1
SBI30DHE4977804,24,27,17,10,1
SBI81OCI2534429,67,27,23,4,1
SBI83KHQ2302085,20,31,16,15,1
SBI96HOI4156721,82,23,13,10,1
SBI20PGA0576878,89,27,22,5,1
SBI47KIN2197602,68,23,13,10,1
SBI08AXC1032956,63,19,18,1,1
SBI13ANS0503124,65,27,24,3,1
SBI46ANC9882053,18,22,21,1,1
SBI15VJU4695614,76,24,16,8,1
SBI75GNO8947144,83,15,11,4,1
SBI49QGG9858061,71,23,15,8,1
SBI99BQO5361254,96,23,19,4,1
SBI23ARR4979846,70,25,20,5,1
SBI19UHX0606671,60,25,16,9,1
SBI96TZC4678916,65,20,17,3,1
SBI44KLQ6073096,83,27,23,4,1
SBI48MGM0828333,75,24,18,6,1
SBI43ICZ6978232,68,23,22,1,1
SBI49SNA3132871,64,16,14,2,1
SBI38YRW5615938,83,27,23,4,1
SBI97HSW6291491,76,27,26,1,1
SBI80NJJ9962949,98,25,13,12,1
SBI79RAV9177829,63,15,10,5,1
SBI95PNM4910104,77,18,14,4,1
SBI68QRW1285351,93,22,12,10,1
SBI17XJJ1841486,24,25,14,11,1
SBI22ESA8632979,88,30,23,7,1
SBI36KNZ9395771,68,29,18,11,1
SBI27QXF8711095,88,22,12,10,1
SBI31JRY2389287,79,18,15,3,1
SBI71AUA6014929,86,17,9,8,1
SBI72GCP9300740,76,29,20,9,1
SBI47BRY5662151,76,24,20,4,1
SBI72NMS6871139,94,27,21,6,1
SBI81NNB7108935,94,27,23,4,1
SBI49ETP5979494,18,21,19,2,1
SBI21PPW0473061,75,28,22,6,1
SBI62ICX7058107,77,29,26,3,1
SBI12RLF3206866,23,24,14,10,1
SBI22DDF2199394,97,16,14,2,1
SBI47YMB6922501,97,30,22,8,1
SBI50QKH5999034,81,20,13,7,1
SBI74WRB6243786,67,22,13,9,1
SBI28FXU7817674,86,24,20,4,1
SBI66UTA1130663,84,25,16,9,1
SBI06ETU4523553,19,28,26,2,1
SBI87KKR4435717,82,21,11,10,1
SBI33DMB2046705,79,27,22,5,1
SBI95NDL2032415,21,24,15,9,1
SBI94KDB8545787,70,26,24,2,1
SBI63IHZ0978229,65,31,29,2,1
SBI83PMF8009425,18,25,21,4,1
SBI40EEF9968434,95,28,26,2,1
SBI37DTG0120445,92,29,16,13,1
SBI49PEI6426097,69,24,21,3,1
SBI24FUO2818531,91,22,20,2,1
SBI57LTQ4233287,86,22,12,10,1
SBI61SZO7738661,86,17,11,6,1
SBI23RVS0557607,99,18,16,2,1
SBI56YCY9051211,85,21,17,4,1
SBI98HLM4071696,95,23,13,10,1
SBI24WBI6547981,89,24,18,6,1
SBI15IFS4013572,24,18,17,1,1
SBI72ROH9073727,24,17,10,7,1
SBI08REI7363591,64,22,12,10,1
SBI72XUT7243610,25,14,10,4,1
SBI75AJE6624753,18,23,12,11,1
SBI00ZYN1205253,20,24,18,6,1
SBI11EWU1147770,81,27,26,1,1
SBI01MEY1341498,81,29,27,2,1
SBI44TSV9963969,76,25,22,3,1
SBI96FOQ7208918,95,29,26,3,1
SBI12FNF2996031,18,14,9,5,1
SBI63GSK4642076,78,26,20,6,1
SBI88JEO6681624,84,19,13,6,1
SBI63TXD5234893,86,28,16,12,1
SBI42KEK0532250,79,25,16,9,1
SBI14RWR0626914,18,19,17,2,1
SBI00IGI5046918,86,26,17,9,1
SBI53KBF5650691,71,20,15,5,1
SBI11TYG7541338,90,16,12,4,1
SBI24CPE3737399,21,21,12,9,1
SBI29KJJ7737349,25,23,15,8,1
SBI38JKW8083452,24,19,17,2,1
SBI03ZYL4529347,22,27,23,4,1
SBI78YVY0134667,73,16,11,5,1
SBI39PCH8126474,67,29,21,8,1
SBI04SOH9989486,24,21,16,5,1
SBI34BYT4812857,72,22,19,3,1
SBI73IWX8714540,81,24,22,2,1
SBI46GXP0916299,70,27,24,3,1
SBI36XFH9839775,80,30,26,4,1
SBI05MTJ5816177,96,28,27,1,1
SBI65HZZ2577334,67,22,19,3,1
SBI08OAJ0999170,98,17,11,6,1
SBI79RMB0874138,82,26,24,2,1
SBI29SEB0451944,61,22,15,7,1
SBI57UYH2051596,94,23,17,6,1
SBI30AIH2277540,67,24,22,2,1
SBI89XRL9088455,68,22,12,10,1
SBI59YKA7817968,81,28,15,13,1
SBI43TFV7848493,82,24,13,11,1
SBI08QTL1578151,95,32,19,13,1
SBI04HOL9614076,85,28,18,10,1
SBI36PZH7996940,91,28,15,13,1
SBI66HMC3428225,20,26,16,10,1
SBI26KLN7074049,60,27,22,5,1
SBI38YWS7180276,78,24,21,3,1
SBI54LHE4133525,83,21,12,9,1
SBI08TKU8334730,60,30,18,12,1
SBI62KAD6463964,64,23,13,10,1
SBI95LJE8877369,21,29,18,11,1
SBI25RCF6564042,95,30,24,6,1
SBI05CQV5339754,95,26,17,9,1
SBI59FPS1269871,97,19,15,4,1
SBI54VSH5516415,97,26,24,2,1
SBI37CZU6171525,23,32,30,2,1
SBI21LQS4181006,23,22,19,3,1
SBI56MRP7054906,92,28,16,12,1
SBI53DKI4919599,97,26,17,9,1
SBI63VBO8362469,75,23,19,4,1
SBI18XUG8232242,90,17,9,8,1
SBI08SJJ9537787,21,28,27,1,1
SBI27PVM6085181,80,30,24,6,1
SBI30RUG5602414,80,30,19,11,1
SBI69OXP3671803,80,18,10,8,1
SBI32QYY2939822,73,18,17,1,1
SBI08DVG2080495,98,24,20,4,1
SBI10FIY5191168,68,30,26,4,1
SBI92CVB0254143,60,22,14,8,1
SBI12DRB3988856,86,17,16,1,1
SBI70QPA0191485,73,22,21,1,1
SBI43MFE4387358,93,15,8,7,1
SBI54CWV7469633,90,23,18,5,1
SBI19RBO6989919,94,26,22,4,1
SBI63ZZW4509158,24,24,21,3,1
SBI70TIY3335670,74,23,17,6,1
SBI33TKR9103902,69,22,12,10,1
SBI46GZT4024354,66,28,16,12,1
SBI03PXI6247077,66,21,12,9,1
SBI75ANC1851661,93,28,17,11,1
SBI38RCW6004694,95,31,16,15,1
SBI59UIS2835752,62,29,21,8,1
SBI95YJS5588929,95,32,17,15,1
SBI54GEX5094468,85,17,9,8,1
SBI18YTZ9295251,68,21,12,9,1
SBI22MKZ4524516,74,21,11,10,1
SBI22MIO4750892,20,34,30,4,1
SBI59ZVO1018766,92,26,23,3,1
SBI15EXN5723325,98,33,29,4,1
SBI76CUL8724977,72,31,29,2,1
SBI04PZF0863651,95,28,22,6,1
SBI41WWH5689220,76,23,16,7,1
SBI99NBT7698075,74,19,17,2,1
SBI97DPN3282950,83,22,13,9,1
SBI49FFH6539367,71,28,15,13,1
SBI36SWS3997442,93,31,23,8,1
SBI11IYQ5521313,89,18,14,4,1
SBI95EVT3341996,93,19,17,2,1
SBI50YGL8405338,83,26,24,2,1
SBI33JDH9750654,66,30,22,8,1
SBI97TYZ2444164,24,28,22,6,1
SBI64PWB3120693,94,25,24,1,1
SBI90PSP2046516,68,29,19,10,1
SBI86ABK0477386,18,18,15,3,1
SBI15MRY5134124,88,23,19,4,1
SBI33MEF2269179,80,29,19,10,1
SBI03FQZ9624029,71,23,12,11,1
SBI97XOV7883914,18,26,17,9,1
SBI50BKU6642028,91,20,17,3,1
SBI04FUO7986942,82,20,16,4,1
SBI26QZV9058818,86,27,17,10,1
SBI87LJC9586861,84,29,23,6,1
SBI67PVC3582719,67,18,10,8,1
SBI74TEC7347019,75,39,22,17,1
SBI99CTW0568173,19,31,17,14,1
SBI26NMJ1074835,62,28,27,1,1
SBI83KBR3052934,65,23,14,9,1
SBI60WIG5765134,88,37,34,3,1
SBI11ZSZ3163446,65,23,22,1,1
SBI96GBD2851881,94,23,22,1,1
SBI01XNX5337891,18,19,14,5,1
SBI89BRX8394282,23,31,30,1,1
SBI02MDV7121660,72,23,14,9,1
SBI84YNA7424781,72,27,23,4,1
SBI24UPT5437978,65,21,20,1,1
SBI67SHV9819405,69,26,22,4,1
SBI92AKC4636801,64,22,14,8,1
SBI59POK2131866,82,19,17,2,1
SBI89ICL5481257,67,30,18,12,1
SBI75GXH6654582,71,25,13,12,1
SBI57LTJ3349488,64,25,22,3,1
SBI47DMB6292906,79,33,22,11,1
SBI96VUD1977244,75,22,15,7,1
SBI66SCG1054405,83,28,20,8,1
SBI36VSZ9953918,76,25,13,12,1
SBI51BAT6652052,72,24,22,2,1
SBI69MXE3167484,66,28,25,3,1
SBI02CCK0926034,20,27,22,5,1
SBI12IPJ5400066,68,19,18,1,1
SBI70QAA8639966,88,22,17,5,1
SBI41JGM1845616,69,21,18,3,1
SBI36TLG7598730,85,27,17,10,1
SBI81HPA5188885,78,21,12,9,1
SBI18FLB8339359,19,29,20,9,1
SBI07OLE8954166,60,38,22,16,1
SBI15HYP7157845,99,21,14,7,1
SBI66ANG7413916,97,23,14,9,1
SBI15ASC4578857,80,26,25,1,1
SBI28AQU3864929,68,26,14,12,1
SBI64ZBC5794210,24,21,12,9,1
SBI25VGJ7147232,90,27,25,2,1
SBI04YRY6389070,68,26,17,9,1
SBI17QJE3780794,94,24,17,7,1
SBI97JEA1016562,95,19,17,2,1
SBI38TDA6849172,65,17,9,8,1
SBI55ILE7559264,80,15,8,7,1
SBI59MUB9380491,73,24,18,6,1
SBI23GZE2267887,64,21,11,10,1
SBI71CCN9508298,83,30,26,4,1
SBI77GUV8464011,80,27,21,6,1
SBI01JUM1479355,89,31,18,13,1
SBI86EPL8381167,22,26,14,12,1
SBI82OIQ0225979,87,24,22,2,1
SBI33VQI0731009,75,21,16,5,1
SBI20NXF6347853,62,31,20,11,1
SBI40LZZ2550589,77,36,28,8,1
SBI41TYI8419222,81,19,16,3,1
SBI19KJW6598311,98,33,21,12,1
SBI46PWJ2661137,86,20,11,9,1
SBI54RFK2382317,65,27,16,11,1
SBI80WGA9649178,18,19,18,1,1
SBI21TYT9200331,20,10,8,2,1
SBI03BRM8845694,25,32,17,15,1
SBI34QHK1861638,82,30,20,10,1
SBI99QHS0456653,24,26,16,10,1
SBI68UYL5021360,24,28,20,8,1
SBI29YDP2325894,25,22,12,10,1
SBI03KLK4545402,66,26,24,2,1
SBI10POG7376147,79,22,14,8,1
SBI50FNV9493449,69,21,17,4,1
SBI73YXY7649713,83,25,18,7,1
SBI82XCE7402948,85,27,19,8,1
SBI74OLN2628666,78,14,9,5,1
SBI33YAN9322686,84,17,10,7,1
SBI37VNX0378417,24,33,32,1,1
SBI94BRP2830632,92,23,18,5,1
SBI53JSV6565856,82,20,16,4,1
SBI85DMX5426908,63,26,22,4,1
SBI43MPQ5047066,87,24,16,8,1
SBI66IUU2875574,25,29,25,4,1
SBI04MSQ4370238,84,26,19,7,1
SBI48JXR1855021,93,30,27,3,1
SBI41GZC2617825,67,20,14,6,1
SBI44FKQ7190015,61,29,16,13,1
SBI69XFK3082005,65,21,18,3,1
SBI77ADD1583136,75,24,16,8,1
SBI68GUP7419464,81,23,17,6,1
SBI42XKP3094608,88,29,19,10,1
SBI59MCV5571737,23,30,23,7,1
SBI11QGO9832169,82,26,14,12,1
SBI38BUE5779579,77,27,23,4,1
SBI59IMF4377327,79,26,19,7,1
SBI65KAU8359446,23,24,15,9,1
SBI95LYR8839550,74,30,25,5,1
SBI10OKP1648522,91,23,20,3,1
SBI72ALS6415924,96,16,9,7,1
SBI34PEK7438087,74,24,20,4,1
SBI53TCE5210922,81,21,13,8,1
SBI84DDO5576044,65,29,26,3,1
SBI41LIH9506177,89,32,28,4,1
SBI78UDO1936815,97,24,21,3,1
SBI63FQX0820915,94,24,14,10,1
SBI34TRK4332367,93,22,20,2,1
SBI81UAX4888287,78,16,13,3,1
SBI05UMP5968764,76,15,9,6,1
SBI60QGT4033249,96,23,14,9,1
SBI37VUJ8287329,71,25,16,9,1
SBI76OBJ7926151,80,33,30,3,1
SBI00OBS0139659,24,20,17,3,1
SBI55NTO3020791,97,23,19,4,1
SBI86LCB1250901,22,19,13,6,1
SBI08DCH7809640,90,18,17,1,1
SBI72BXR6362607,81,27,17,10,1
SBI94IWK5389863,95,27,18,9,1
SBI94SEH5122261,61,28,22,6,1
SBI33RZI9347447,82,21,17,4,1
SBI01CRQ1937454,61,24,19,5,1
SBI22GXD3643375,83,27,21,6,1
SBI00FUP5965662,85,27,24,3,1
SBI12IJO8248013,82,25,18,7,1
SBI64UUH8470032,62,22,19,3,1
SBI54QVJ8091270,75,29,17,12,1
SBI45SVX0503349,64,18,11,7,1
SBI55CAP6778274,69,24,18,6,1
SBI36XAB2843272,92,25,15,10,1
SBI14IRV6574993,95,29,18,11,1
SBI81RBO5257951,60,30,21,9,1
SBI44KIC9384575,73,23,13,10,1
SBI81FYP6962204,68,23,17,6,1
SBI16HAL4069638,79,30,23,7,1
SBI39GMJ9982634,88,21,19,2,1
SBI41ESW2959371,93,33,32,1,1
SBI49YYD5974026,80,31,27,4,1
SBI55CSM5736196,22,28,19,9,1
SBI85EFU7665778,95,21,20,1,1
SBI17YCR1092179,78,21,19,2,1
SBI86LKM2527910,67,29,16,13,1
SBI59MSQ5362549,89,29,25,4,1
SBI25NLF8105090,93,27,18,9,1
SBI10KFJ2753220,90,26,17,9,1
SBI91KLF4140127,82,22,20,2,1
SBI72WEK5014399,74,29,28,1,1
SBI99LOF6601096,79,31,30,1,1
SBI13SQO7790635,89,22,13,9,1
SBI33UTE3838122,91,25,15,10,1
SBI92FUS5960667,63,15,9,6,1
SBI91QUU1016034,92,30,17,13,1
SBI29EPC1052828,65,28,25,3,1
SBI97SMS6679948,89,24,14,10,1
SBI15PGG2393651,69,15,13,2,1
SBI55WDU5162206,84,15,9,6,1
SBI03TAD7438240,21,21,18,3,1
SBI66AHH3965452,73,24,13,11,1
SBI46CXZ9783910,98,34,18,16,1
SBI50MHB4098105,61,28,18,10,1
SBI19YIT1086372,76,29,19,10,1
SBI82VTS5952619,85,26,25,1,1
SBI66HRA1933762,87,22,20,2,1
SBI79YOU9358805,97,28,15,13,1
SBI37JWQ9131167,71,27,16,11,1
SBI75XYZ3933275,69,35,20,15,1
SBI90SJJ3846844,95,18,14,4,1
SBI70CPS9088760,83,22,16,6,1
SBI50QCT0168306,69,34,22,12,1
SBI75BSN6496597,80,27,18,9,1
SBI32MUU8751506,94,27,25,2,1
SBI04GKA3894535,99,13,11,2,1
SBI14ZRX3685241,19,17,10,7,1
SBI80ZOY0793957,93,23,14,9,1
SBI28ZNY3549611,94,17,15,2,1
SBI07MOZ5038035,98,23,19,4,1
SBI36YCQ5670913,77,23,18,5,1
SBI70ODJ4900170,90,17,14,3,1
SBI84ULB5776180,24,24,20,4,1
SBI80XEJ4281022,75,29,24,5,1
SBI96OWM3636839,82,28,16,12,1
SBI71MBJ6697184,94,27,25,2,1
SBI65YXA0976041,61,30,20,10,1
SBI65LWR6070062,77,26,24,2,1
SBI16YED4725585,90,22,12,10,1
SBI06RQS6951702,86,14,11,3,1
SBI79WOZ0617856,66,23,22,1,1
SBI62PPJ5410998,94,21,19,2,1
SBI42QSC3605446,84,24,18,6,1
SBI35AXG6531248,76,17,12,5,1
SBI24ACI1666670,73,31,16,15,1
SBI01CFU8752772,69,30,25,5,1
SBI19GMY3378515,24,19,17,2,1
SBI11AZZ1233909,22,25,24,1,1
SBI51FHI8088718,71,23,16,7,1
SBI42YHD9628025,78,6,4,2,1
SBI44VMG9574135,76,20,17,3,1
SBI05QFD4973060,64,28,16,12,1
SBI80NMI1876947,89,20,14,6,1
SBI74BTP0387368,71,19,10,9,1
SBI09KUE7965006,95,32,23,9,1
SBI91FTP8502597,65,31,23,8,1
SBI28HXV9665533,97,22,21,1,1
SBI87CPO0320156,66,18,14,4,1
SBI03BPV6917486,88,22,16,6,1
SBI69LVV8460032,72,21,16,5,1
SBI17WDY5056816,98,28,25,3,1
SBI40CPV9848201,21,22,20,2,1
SBI02KSR7563704,21,26,23,3,1
SBI06PIZ7633999,88,32,25,7,1
SBI22UCJ2458609,93,21,13,8,1
SBI80RQT1432679,69,23,16,7,1
SBI75CTH4936661,77,25,20,5,1
SBI28LXF3007516,18,25,20,5,1
SBI32YNX8007038,88,20,16,4,1
SBI24LLJ5319552,88,27,24,3,1
SBI27KEG3908564,81,15,11,4,1
SBI41GJQ7632567,25,35,33,2,1
SBI20YRZ1139833,85,28,16,12,1
SBI95CRW9619449,78,21,19,2,1
SBI94HGR5846251,94,22,19,3,1
SBI81JPG1545796,84,24,16,8,1
SBI86HYN7476901,70,19,10,9,1
SBI99LBY9145483,21,16,10,6,1
SBI21ZDF9339402,81,27,16,11,1
SBI08UGM4594040,98,20,18,2,1
SBI44ECX1823942,75,29,20,9,1
SBI97NBW6941504,94,19,15,4,1
SBI40XHD8740128,23,27,16,11,1
SBI69KIP8983631,70,29,15,14,1
SBI35HRE7336108,67,30,26,4,1
SBI83CHK9289714,73,31,22,9,1
SBI44VCF0371577,86,38,32,6,1
SBI81OTL8156317,23,24,22,2,1
SBI48EGV0434818,81,27,15,12,1
SBI85UIT7782891,79,34,18,16,1
SBI40IRP8153689,80,33,18,15,1
SBI75WQQ3205613,93,29,22,7,1
SBI32XMD4393584,24,19,13,6,1
SBI40YVY8029897,89,27,18,9,1
SBI97WEZ0971401,20,21,19,2,1
SBI00LLH5498821,71,13,7,6,1
SBI62QUA6797447,79,28,23,5,1
SBI82WTW6182446,60,19,14,5,1
SBI62YJV7937077,95,35,26,9,1
SBI12QZO9355962,82,28,20,8,1
SBI75IFV5037272,87,31,24,7,1
SBI48KHB9787445,69,27,16,11,1
SBI17OGY6672323,82,18,15,3,1
SBI51TXZ5399001,85,32,27,5,1
SBI73IRT2515983,86,28,17,11,1
SBI94UXP1448645,78,32,28,4,1
SBI87DGY0169843,66,20,16,4,1
SBI20DYK6521834,78,30,22,8,1
SBI17FYN0480252,20,25,16,9,1
SBI21MGN6626729,60,30,16,14,1
SBI61HXO7240705,23,17,11,6,1
SBI93RSP9998720,25,26,24,2,1
SBI22TME2945953,81,34,30,4,1
SBI16UHN0618680,19,23,21,2,1
SBI95GWL3982870,18,30,23,7,1
SBI17URE9379134,75,36,32,4,1
SBI12GWI3958520,86,26,15,11,1
SBI72SAF8716035,88,29,15,14,1
SBI19XNF7287592,85,23,22,1,1
SBI29HAZ7742958,70,26,18,8,1
SBI25DVR8620126,61,24,17,7,1
SBI44TVT4249880,65,25,23,2,1
SBI63YGB7286295,73,33,30,3,1
SBI65LYT2659299,23,31,18,13,1
SBI24IJU2080260,78,30,27,3,1
SBI16KTN9265617,83,23,17,6,1
SBI11QPQ5395549,23,31,19,12,1
SBI13JEY2906267,98,32,31,1,1
SBI26PBD7155632,84,29,23,6,1
SBI69JCT9322882,63,22,18,4,1
SBI88BWC1675772,86,30,29,1,1
SBI77HMT4399285,91,28,25,3,1
SBI98DTI4249901,69,31,20,11,1
SBI23GPO5461192,63,20,12,8,1
SBI87NFQ4242086,25,35,24,11,1
SBI70IRV0124843,92,20,15,5,1
SBI10WNC9814200,92,27,24,3,1
SBI94WBA2500549,95,22,18,4,1
SBI78ZJN8709338,65,32,25,7,1
SBI03LYW0841949,25,26,18,8,1
SBI06TLO1597199,86,32,26,6,1
SBI83TGT8447230,93,29,26,3,1
SBI94TKB5854078,18,33,24,9,1
SBI89QVD0395286,79,16,9,7,1
SBI87DGU2653240,25,18,13,5,1
SBI23CXK4004785,97,24,16,8,1
SBI58GVH2951178,62,30,22,8,1
SBI14KBI2714621,62,36,22,14,1
SBI04FJT9422345,94,22,19,3,1
SBI49EFY4439318,85,25,14,11,1
SBI42JKI1140438,24,24,14,10,1
SBI50MXE6305995,65,19,11,8,1
SBI88MIL5608268,22,23,13,10,1
SBI12WLK1554184,24,23,14,9,1
SBI68KUQ5554248,75,20,18,2,1
SBI60EAU6679544,83,17,9,8,1
SBI85OCE7454701,97,25,16,9,1
SBI96QTU9424403,18,22,15,7,1
SBI50NSK7441277,20,18,13,5,1
SBI24DLA4739142,89,27,15,12,1
SBI26ZTL3732866,71,23,13,10,1
SBI20LIJ4544232,85,33,25,8,1
SBI11CPH5291608,67,25,20,5,1
SBI89KMD8764245,76,25,13,12,1
SBI82ZVP6343660,90,29,27,2,1
SBI09QXK1405161,70,23,15,8,1
SBI90CJA3315635,61,23,12,11,1
SBI20OOM8065344,88,25,17,8,1
SBI75MGN2859892,95,30,23,7,1
SBI38ROR4443003,70,17,13,4,1
SBI06GOT6775512,25,19,18,1,1
SBI20VBS3545246,87,20,13,7,1
SBI51ZRM0302994,96,13,12,1,1
SBI00HEE2400492,80,38,20,18,1
SBI81KAY8456900,98,25,22,3,1
SBI91JJE4296371,70,20,12,8,1
SBI60QIL9492269,94,21,12,9,1
SBI41VQK8086268,70,33,30,3,1
SBI46ZZW3868465,76,18,10,8,1
SBI99PSC5362291,67,23,21,2,1
SBI40GCK8766379,64,25,23,2,1
SBI20HVC1134969,22,20,13,7,1
SBI77JQU4468783,79,25,19,6,1
SBI30TCB9661934,80,16,15,1,1
SBI75CIT7184347,60,16,15,1,1
SBI31YBF2341034,87,31,17,14,1
SBI19BFA3766053,90,26,14,12,1
SBI17SMJ7450508,75,21,17,4,1
SBI86JVJ7675062,60,26,21,5,1
SBI94BHU6871125,63,22,15,7,1
SBI03YEG7176451,78,26,22,4,1
SBI76LKP5309591,79,18,12,6,1
SBI93PTG9092626,18,23,15,8,1
SBI06UQX6735829,71,21,11,10,1
SBI17XZF1950686,80,26,16,10,1
SBI78SAT8196512,63,31,27,4,1
SBI97GUC3144112,64,27,22,5,1
SBI88PUL0278112,97,30,22,8,1
SBI91IDF1791305,79,25,23,2,1
SBI40KXO9179170,98,19,18,1,1
SBI32BVY5089312,95,26,17,9,1
SBI04UIH5012855,92,28,16,12,1
SBI13XEF1545177,24,13,8,5,1
SBI44SKP5872712,23,25,13,12,1
SBI21ADH4908276,24,19,15,4,1
SBI44TIX4493355,98,25,16,9,1
SBI19TIP4135698,79,28,15,13,1
SBI83IYP6457960,68,25,18,7,1
SBI10FYA0420464,83,30,18,12,1
SBI25VML1605175,64,22,18,4,1
SBI31OTU6806346,61,29,19,10,1
SBI33JMA0933274,74,23,16,7,1
SBI26GOT9302862,96,25,14,11,1
SBI48QQN2251211,74,17,10,7,1
SBI69GBD2519684,89,21,11,10,1
SBI24VOV1669587,20,22,16,6,1
SBI09IBN9607975,98,17,10,7,1
SBI63KGB6368185,99,23,16,7,1
SBI59QQD1827271,65,19,12,7,1
SBI77NEF5377702,96,27,17,10,1
SBI64PQZ9122021,84,22,17,5,1
SBI44RLJ5631467,92,25,18,7,1
SBI07LCV7061957,97,20,16,4,1
SBI34JWL5830542,66,22,20,2,1
SBI44TQV9364835,70,18,16,2,1
SBI81NRI4796257,64,25,20,5,1
SBI54NJN5706925,91,23,15,8,1
SBI51PJZ5818796,62,22,16,6,1
SBI23OFE9873782,20,24,21,3,1
SBI20WFN3848136,72,31,18,13,1
SBI31DWX0796506,84,27,14,13,1
SBI13NRJ4912171,24,15,11,4,1
SBI42FKU9919477,24,20,15,5,1
SBI95ZDU9789902,18,18,17,1,1
SBI39SXB2310982,96,21,17,4,1
SBI04JXY3892100,25,22,14,8,1
SBI07JYA8942251,23,19,14,5,1
SBI68SQU9531780,67,31,26,5,1
SBI53GJS4388057,76,28,26,2,1
SBI61UOA2666204,21,15,10,5,1
SBI54IXL7462843,65,23,19,4,1
SBI64NAF0652186,98,26,24,2,1
SBI14INA0384074,66,29,21,8,1
SBI81JLZ7779652,94,27,16,11,1
SBI62HPF2832963,74,18,10,8,1
SBI01VJF0768520,63,23,19,4,1
SBI14LLX9595302,65,28,18,10,1
SBI82ZOM9741358,76,29,19,10,1
SBI79JCC7827450,84,20,15,5,1
SBI30SWC1255005,73,30,23,7,1
SBI02YYD6585967,75,28,24,4,1
SBI56MOB1101293,89,20,15,5,1
SBI72ABA5369481,82,25,17,8,1
SBI81SSJ6983513,61,31,18,13,1
SBI40KYP4869475,74,22,14,8,1
SBI30VZZ1788765,98,20,18,2,1
SBI17JAY5642250,69,23,13,10,1
SBI53TPD1271804,91,26,24,2,1
SBI50HKJ7284255,71,27,15,12,1
SBI18PUW0512821,68,24,19,5,1
SBI67AVG5864265,87,30,19,11,1
SBI37KHK5027617,76,19,10,9,1
SBI18LTW1734413,74,22,16,6,1
SBI09TRB2432338,74,22,13,9,1
SBI86JAC0526093,25,30,23,7,1
SBI49SCK1879219,77,26,18,8,1
SBI54XNX6562740,80,23,14,9,1
SBI03DKD1640776,89,33,18,15,1
SBI43BXR1982693,79,20,13,7,1
SBI09PHC5706045,25,27,15,12,1
SBI33UIX8249310,62,24,17,7,1
SBI17NDT5681955,70,27,17,10,1
SBI89NGV6194891,80,21,17,4,1
SBI37ACI3457999,71,25,23,2,1
SBI04IRK5485844,84,25,24,1,1
SBI57ART7837053,63,23,18,5,1
SBI49OWQ1347782,66,15,11,4,1
SBI69UVK8370719,73,33,29,4,1
SBI30FYM8513379,72,26,22,4,1
SBI57KXT9836042,25,25,22,3,1
SBI32FQD3675981,67,27,21,6,1
SBI94CQW3641281,70,25,19,6,1
SBI33SBG6787052,87,26,18,8,1
SBI98PGF0168053,65,21,18,3,1
SBI77BYT6071535,92,30,20,10,1
SBI51MAO5611892,19,26,24,2,1
SBI80FJC8306183,22,27,14,13,1
SBI41GDM9748365,81,18,14,4,1
SBI17IEM3332308,24,28,27,1,1
SBI02LIT3672505,87,31,26,5,1
SBI82QPW1900894,18,28,20,8,1
SBI02XBX7296894,80,24,13,11,1
SBI07EIV5946813,97,30,23,7,1
SBI20OPF0957779,75,23,21,2,1
SBI22LZT9637107,87,16,10,6,1
SBI72CAW3382113,72,24,16,8,1
SBI43SJB4822141,91,20,12,8,1
SBI99RFK0931150,72,24,17,7,1
SBI23ECU9868857,24,23,14,9,1
SBI30RXC4067479,61,24,16,8,1
SBI33LFN6434896,22,29,21,8,1
SBI05RGS1987277,74,21,12,9,1
SBI36BNY5473031,21,30,23,7,1
SBI37AIK6890217,95,21,11,10,1
SBI76EZV3640928,78,19,13,6,1
SBI00ARZ0937484,25,22,18,4,1
SBI21XAS3082489,19,24,13,11,1
SBI18FUE8148651,97,22,16,6,1
SBI63FDI4633597,19,23,22,1,1
SBI91QHM0352993,68,23,22,1,1
SBI58BYZ4373833,97,31,25,6,1
SBI40EGY9011642,65,30,27,3,1
SBI76VWY5181051,73,24,23,1,1
SBI28RIK7365304,67,29,22,7,1
SBI15HSY3375337,62,22,19,3,1
SBI52RMN6022087,72,16,9,7,1
SBI24EYK8906459,87,25,20,5,1
SBI69MSC8046274,99,32,28,4,1
SBI39TXP5275375,22,29,21,8,1
SBI44ASR8804966,91,31,26,5,1
SBI93LNN0414821,68,19,16,3,1
SBI09DBF5605650,74,18,15,3,1
SBI50MVI5387719,92,27,24,3,1
SBI47GJT2608006,18,22,16,6,1
SBI68LIQ0980127,81,35,20,15,1
SBI78PFK2377811,21,13,7,6,1
SBI10JXF1751876,70,24,20,4,1
SBI10AIH7411166,93,21,14,7,1
SBI92AFH7905954,82,30,25,5,1
SBI36SGT6581398,99,28,27,1,1
SBI30BHV6901530,90,21,15,6,1
SBI49BNW6918894,62,32,28,4,1
SBI32YEF8374765,20,27,21,6,1
SBI25NFK3806895,65,25,15,10,1
SBI16QSB7676419,97,18,15,3,1
SBI58GZG5289711,83,30,23,7,1
SBI33EYP3086237,98,22,12,10,1
SBI30TGT7449466,88,28,17,11,1
SBI47UYP7121797,68,21,16,5,1
SBI90TFK6107050,79,19,13,6,1
SBI34HGX5369221,98,24,17,7,1
SBI14LIH3916427,25,29,23,6,1
SBI18NQQ8119711,83,27,15,12,1
SBI58TGM5714597,65,28,22,6,1
SBI12QIS4875546,76,22,16,6,1
SBI05MHC3590222,84,28,26,2,1
SBI59BNF5100946,73,25,16,9,1
SBI61VCA5472470,73,31,25,6,1
SBI58OTB5470677,65,34,21,13,1
SBI58HYY8256144,71,23,22,1,1
SBI86ZVW2775937,20,22,20,2,1
SBI99RPX5643768,18,26,14,12,1
SBI66DJB9881348,86,20,14,6,1
SBI01VRK0327684,90,24,15,9,1
SBI10LSF9903100,63,27,16,11,1
SBI03DMN7184026,78,20,11,9,1
SBI58WBO3392086,60,26,15,11,1
SBI56JVA5356423,74,22,15,7,1
SBI88OEB8088215,80,24,16,8,1
SBI17RGV8136122,64,21,20,1,1
SBI29TVF7485800,98,19,16,3,1
SBI18FCQ8302315,95,19,11,8,1
SBI45XIP6359490,25,29,18,11,1
SBI03JJJ2550067,72,17,10,7,1
SBI14JXF1149299,96,27,24,3,1
SBI56QBL4692133,67,16,12,4,1
SBI20EPJ5089627,81,29,15,14,1
SBI30ZOZ8356150,19,31,26,5,1
SBI29QZP6476925,79,29,24,5,1
SBI40CQI5664106,91,22,13,9,1
SBI40VGL4230736,96,19,12,7,1
SBI58TKJ3026296,25,27,23,4,1
SBI88DMB6880068,84,21,17,4,1
SBI06LQV4302513,24,26,19,7,1
SBI50GHQ5564384,22,24,17,7,1
SBI63QFX6086037,22,35,22,13,1
SBI09EET3069601,71,20,17,3,1
SBI79ABH9323908,90,17,9,8,1
SBI23RQX8857879,65,27,24,3,1
SBI40RBL4908033,65,38,22,16,1
SBI63BAL6070158,67,27,24,3,1
SBI67KBF7754861,88,27,19,8,1
SBI74ZTK1324773,96,23,15,8,1
SBI90ENS8615571,88,26,21,5,1
SBI71MGQ4901641,98,29,26,3,1
SBI72VNP2472131,74,22,12,10,1
SBI04IOV8604849,20,25,17,8,1
SBI77CBD9529512,76,23,16,7,1
SBI85TKT4908783,79,21,19,2,1
SBI70RFF3617683,66,24,20,4,1
SBI30UEF9941605,91,33,19,14,1
SBI36FSW2455083,23,32,25,7,1
SBI43UMY2879035,79,23,15,8,1
SBI85RFT0553896,79,18,15,3,1
SBI89MXQ4166038,62,25,21,4,1
SBI58LMU6883567,97,31,23,8,1
SBI08JRA7965069,85,34,18,16,1
SBI81HNH0287948,80,14,9,5,1
SBI22IGI7178025,71,28,24,4,1
SBI65EFT5095591,71,20,18,2,1
SBI60ZPK5969675,22,25,19,6,1
SBI89CUV7125286,86,26,18,8,1
SBI80HGH6655803,21,15,9,6,1
SBI32GAA9465991,91,29,18,11,1
SBI56EPT9703315,84,22,12,10,1
SBI35IZW9696465,94,22,12,10,1
SBI63JOZ0298694,80,27,24,3,1
SBI48EPY8534003,61,30,20,10,1
SBI94YQB1246805,82,23,12,11,1
SBI65TML1854575,66,22,18,4,1
SBI65KQC0554197,75,30,19,11,1
SBI58AZO6117339,19,21,19,2,1
SBI18XEK5394902,90,26,16,10,1
SBI37WHK6610722,94,14,10,4,1
SBI48ZZF8050757,68,22,20,2,1
SBI72OET2081908,95,30,19,11,1
SBI75AEC9355822,65,28,24,4,1
SBI38LJP1038144,21,27,14,13,1
SBI55QOM9229664,22,20,13,7,1
SBI41OGG1278223,71,13,7,6,1
SBI89ZCI8641892,25,24,15,9,1
SBI85KTR0844472,62,19,18,1,1
SBI36CXA3920644,98,18,12,6,1
SBI04CTN0808586,22,16,12,4,1
SBI66JHS5794970,70,32,28,4,1
SBI67UDX8401402,90,25,20,5,1
SBI41WRX0445828,88,25,15,10,1
SBI23SIE6125574,21,22,17,5,1
SBI37SYI2146619,23,25,22,3,1
SBI80BTP6678687,62,24,13,11,1
SBI61EJU9543723,24,22,16,6,1
SBI52LJQ2566396,23,18,12,6,1
SBI68XIX4177877,62,29,27,2,1
SBI44XWN8464226,68,33,17,16,1
SBI88WIA5757466,62,21,14,7,1
SBI45SPI8525779,21,20,16,4,1
SBI24FOR3391589,84,37,32,5,1
SBI56ORA9703781,90,19,12,7,1
SBI27MFZ7987529,82,24,21,3,1
SBI76LMP7818410,70,19,15,4,1
SBI18IUN1230502,74,31,18,13,1
SBI58UQI9178093,87,22,15,7,1
SBI78GIL2133037,71,21,16,5,1
SBI51LVK2945080,94,20,11,9,1
SBI14NZL7270263,64,32,22,10,1
SBI16NWA0343145,99,23,14,9,1
SBI65SXH9883620,64,24,15,9,1
SBI07GMD3326036,61,31,29,2,1
SBI48ZLD5440217,23,27,20,7,1
SBI21RES2815936,80,32,25,7,1
SBI08TOH4118948,24,18,14,4,1
SBI94WFQ8166157,20,20,18,2,1
SBI34SMR8871053,64,27,22,5,1
SBI27ULC0083139,84,29,24,5,1
SBI97OZW4495444,66,22,15,7,1
SBI80UNQ9145200,84,36,33,3,1
SBI50ULI3161334,21,20,12,8,1
SBI50LQY0585255,95,24,13,11,1
SBI22IUM4663817,81,31,27,4,1
SBI91VWA1311896,64,18,14,4,1
SBI86YXD1617646,75,21,17,4,1
SBI02JZJ4020044,78,33,29,4,1
SBI88UDQ5430934,83,23,13,10,1
SBI61HIK3999804,20,32,17,15,1
SBI08JOB5502023,22,28,27,1,1
SBI08MTM7005157,71,18,11,7,1
SBI48YWV4653036,97,25,21,4,1
SBI45BYJ8373273,24,24,18,6,1
SBI93FFP7164743,68,20,19,1,1
SBI86EGW6370410,85,19,10,9,1
SBI94TWR8653371,25,19,11,8,1
SBI90JZG0522891,72,33,21,12,1
SBI99DLB6028983,97,20,13,7,1
SBI81GOX5996043,99,19,16,3,1
SBI91UYB7712405,82,28,17,11,1
SBI45PDT1425277,18,31,23,8,1
SBI36PJJ4554933,77,25,22,3,1
SBI58ZMO7194475,67,19,13,6,1
SBI49XBF2306804,67,27,25,2,1
SBI42EOT2793719,19,23,18,5,1
SBI86MBW5339543,71,30,25,5,1
SBI95MXY5526611,76,12,7,5,1
SBI89GGU7069879,76,28,19,9,1
SBI71ZMJ0728349,23,31,29,2,1
SBI73CFK2173378,99,25,19,6,1
SBI77QZG0778564,76,20,13,7,1
SBI66SWI2555010,61,28,21,7,1
SBI01BCQ1343439,82,23,21,2,1
SBI70NXC1935030,68,26,14,12,1
SBI36LEK2390681,73,20,13,7,1
SBI34JOS7617854,79,27,14,13,1
SBI66PXP3879054,98,23,16,7,1
SBI70ABW8483882,81,22,20,2,1
SBI26ZPI1039807,77,26,15,11,1
SBI07CFD1597239,74,23,12,11,1
SBI41ZZX3058640,73,24,23,1,1
SBI56SYZ7056698,80,27,21,6,1
SBI85YPY2034419,75,24,21,3,1
SBI78JVQ6396609,60,21,12,9,1
SBI09ZOL5423996,75,27,20,7,1
SBI27SZI6865072,96,27,20,7,1
SBI18XBW1968079,25,27,17,10,1
SBI16CPT4731364,71,27,17,10,1
SBI69ESI2088891,21,27,20,7,1
SBI62JZX2902801,60,24,15,9,1
SBI66HBI7144589,23,22,15,7,1
SBI12ALD1783186,94,21,19,2,1
SBI50FUM8734422,83,22,20,2,1
SBI42BXB1324927,75,20,17,3,1
SBI09UYF4269377,89,28,17,11,1
SBI94UNF0795654,18,24,14,10,1
SBI16HLT8427770,75,30,19,11,1
SBI60OTT7384504,90,22,12,10,1
SBI25NEU5167168,90,29,20,9,1
SBI36RCY2525996,87,35,25,10,1
SBI01TWT7383743,90,21,19,2,1
SBI68STW8503745,64,18,10,8,1
SBI90UYR9458113,21,22,17,5,1
SBI77QIA7800240,19,18,13,5,1
SBI95DMR5396379,92,25,24,1,1
SBI85VGL7254993,82,37,35,2,1
SBI96HST8653904,76,31,16,15,1
SBI87RYS0933585,92,22,19,3,1
SBI32IKQ0336952,64,24,20,4,1
SBI08OCF5963821,74,25,17,8,1
SBI53XTZ1138797,91,35,30,5,1
SBI49FAL8624982,21,15,13,2,1
SBI19XWQ2037432,65,28,21,7,1
SBI03YET6820047,69,24,18,6,1
SBI47MLM5693387,94,29,23,6,1
SBI00CDO3759848,88,24,21,3,1
SBI32HZT9045641,87,26,23,3,1
SBI14XAG7965594,22,26,19,7,1
SBI59CJS3467679,91,23,14,9,1
SBI55TBJ4310223,74,19,12,7,1
SBI14YJG6248344,69,23,22,1,1
SBI59CQY5528467,68,18,13,5,1
SBI65SNG4588783,62,24,20,4,1
SBI14ELV3974212,80,23,16,7,1
SBI67FGK8043168,76,17,12,5,1
SBI66IXZ1589724,98,25,15,10,1
SBI45SDA0405298,86,26,22,4,1
SBI33TIX8880840,85,22,15,7,1
SBI22XJO4824383,60,22,12,10,1
SBI45GQB0282211,90,21,11,10,1
SBI93HMY1517281,81,24,21,3,1
SBI03CSG9613237,70,31,27,4,1
SBI75QII1379533,68,25,20,5,1
SBI54NXV1048586,23,25,16,9,1
SBI89ULT4724782,73,26,24,2,1
SBI73XHY5405734,80,18,17,1,1
SBI76EJF7777576,22,23,20,3,1
SBI57TVK3749899,61,29,15,14,1
SBI82YOL8629910,98,23,18,5,1
SBI29FWZ5514696,21,31,25,6,1
SBI65NAL5908666,60,29,21,8,1
SBI11KTP0437663,68,31,16,15,1
SBI56MUN3030413,61,20,16,4,1
SBI16XNU8748296,75,21,18,3,1
SBI32LKS5168264,75,20,18,2,1
SBI22HEK0941647,74,29,28,1,1
SBI99OVY6778587,79,20,14,6,1
SBI91BGB7584529,79,27,20,7,1
SBI75AHK5667737,68,30,28,2,1
SBI24XQY9747645,67,25,22,3,1
SBI20UKE7671846,90,23,18,5,1
SBI69LLN0258804,25,24,13,11,1
SBI13YHJ1285395,83,24,19,5,1
SBI46YYR9316554,87,31,20,11,1
SBI45EJW8932011,18,17,15,2,1
SBI84JXQ5053434,22,20,13,7,1
SBI44MKZ0239207,80,21,11,10,1
SBI71QMV2331481,65,24,16,8,1
SBI31RTV8132651,70,20,18,2,1
SBI19USO8740922,96,29,23,6,1
SBI48XCB5263957,85,14,11,3,1
SBI45QJN2492971,80,32,22,10,1
SBI91GRB3029473,91,34,22,12,1
SBI83YEN0769843,82,25,20,5,1
SBI94HKF6273254,93,27,24,3,1
SBI44NHI8461774,77,26,15,11,1
SBI24YSQ2244849,63,17,9,8,1
SBI99FLI7458277,60,29,25,4,1
SBI01PNT4080558,71,33,25,8,1
SBI36OZH2409746,69,14,13,1,1
SBI29BLB0715246,89,21,14,7,1
SBI59MIB0383090,78,22,14,8,1
SBI77WPS9361935,70,21,20,1,1
SBI15ONY5063548,22,24,22,2,1
SBI19MZX0526451,83,27,15,12,1
SBI62HVW1393356,80,27,21,6,1
SBI22CWN3961563,61,28,20,8,1
SBI29YVE2895154,83,24,19,5,1
SBI21OUV1479356,85,26,18,8,1
SBI28WEA5520581,92,13,7,6,1
SBI71YTD1601611,60,22,17,5,1
SBI31JCW3993328,91,23,18,5,1
SBI03TWD9382364,23,25,23,2,1
SBI86CYO8711507,73,29,28,1,1
SBI30NGA2588048,73,32,23,9,1
SBI98RMV8933214,67,28,27,1,1
SBI36LIU7833444,69,24,21,3,1
SBI59NPB6217538,99,25,17,8,1
SBI24MKH1866562,90,25,21,4,1
SBI55NSJ7889905,63,27,24,3,1
SBI29BWO8723304,84,28,25,3,1
SBI30UGD0554551,61,24,14,10,1
SBI61FMO1501538,91,26,19,7,1
SBI71LIC6341403,77,24,13,11,1
SBI70WZJ1613981,91,31,20,11,1
SBI20AYS3984428,91,15,8,7,1
SBI60OUX8728708,23,27,20,7,1
SBI67VLB5756109,69,28,27,1,1
SBI46XSS7353606,19,20,13,7,1
SBI93EUH7554610,72,35,23,12,1
SBI93SCT4988518,86,38,37,1,1
SBI64GJJ2175284,91,24,20,4,1
SBI31LFA2303368,91,28,19,9,1
SBI91HEN4944402,68,13,8,5,1
SBI14XCE2857564,24,29,25,4,1
SBI38AUB4623202,88,19,16,3,1
SBI80FUK1752546,23,21,17,4,1
SBI31BEX5874007,68,16,9,7,1
SBI68XTR0338251,68,14,12,2,1
SBI25OJL0356033,65,28,22,6,1
SBI09ZTI0303695,77,22,14,8,1
SBI57JLR4088664,84,20,13,7,1
SBI05MCP1866785,62,21,14,7,1
SBI55XJH1710769,21,26,15,11,1
SBI90QHG9419147,82,30,20,10,1
SBI56SYG6907906,64,21,16,5,1
SBI31FSN5289535,88,19,15,4,1
SBI10HCR4107000,71,28,24,4,1
SBI21ONN2256680,23,29,18,11,1
SBI21JWY2681466,98,31,20,11,1
SBI04DPN1148806,61,34,28,6,1
SBI48GYU3237681,72,28,25,3,1
SBI34FVF8117839,71,22,21,1,1
SBI28EIR7643414,22,25,23,2,1
SBI13CQU0135305,74,20,18,2,1
SBI51ZOM1237672,74,18,15,3,1
SBI58HSJ7644408,25,32,27,5,1
SBI52SSV7656529,94,18,17,1,1
SBI28FOJ7414427,18,22,15,7,1
SBI99EZE6105595,63,30,27,3,1
SBI54SRV5597842,20,27,20,7,1
SBI15ACC4088278,19,31,20,11,1
SBI89QZC5331251,63,19,16,3,1
SBI45CWG1840145,80,27,18,9,1
SBI28RLB9841610,87,16,13,3,1
SBI58WSF0743564,76,26,18,8,1
SBI51JJL9489810,95,25,20,5,1
SBI63CBV4434305,90,26,24,2,1
SBI68AUR2284702,77,21,12,9,1
SBI86BUX3147001,87,24,22,2,1
SBI46NTI9194620,84,25,17,8,1
SBI84EYI8797191,92,23,16,7,1
SBI76OQT3637132,91,21,14,7,1
SBI61VGL5038756,98,26,18,8,1
SBI42JAX6850677,74,28,23,5,1
SBI60PJR0851931,62,20,16,4,1
SBI66RKX0018928,62,21,11,10,1
SBI98APE5229958,93,26,15,11,1
SBI92ZDG6967968,71,26,20,6,1
SBI76NZR2711099,98,29,17,12,1
SBI60JLR5014448,61,23,18,5,1
SBI60NCO7104358,98,23,21,2,1
SBI91DGO9307164,80,29,21,8,1
SBI43SPX8118299,99,22,21,1,1
SBI25BAD3774636,98,33,18,15,1
SBI85KXQ1921217,71,24,20,4,1
SBI79CLD5937517,72,23,17,6,1
SBI54EBP0018913,25,21,19,2,1
SBI47ZNX5759160,88,25,17,8,1
SBI79FIY0943318,74,21,19,2,1
SBI65OHU9362078,60,28,23,5,1
SBI88ZBX4433911,80,21,20,1,1
SBI72DGO8612497,60,25,19,6,1
SBI53LDV8930669,84,24,20,4,1
SBI24TYI6586747,68,30,23,7,1
SBI57STF9869396,76,31,21,10,1
SBI19DAG7779995,19,25,17,8,1
SBI28RCG0375405,99,25,18,7,1
SBI46VLP0610216,96,26,19,7,1
SBI95BZI3200689,88,25,20,5,1
SBI77WKG2287683,92,26,21,5,1
SBI92HIN4484441,96,21,14,7,1
SBI25DKH2750117,63,32,24,8,1
SBI05ZGS8705039,81,18,11,7,1
SBI21JSE5696224,98,26,14,12,1
SBI89VQP6105397,83,31,18,13,1
SBI23WTP7968230,81,31,21,10,1
SBI83SOD1573062,22,15,10,5,1
SBI92EAG8332469,82,22,16,6,1
SBI81BAZ9104278,71,22,17,5,1
SBI93VVI4762800,71,25,13,12,1
SBI52NDC1822861,90,25,20,5,1
SBI14OWL2680795,99,23,12,11,1
SBI46JND5859047,92,18,14,4,1
SBI22BNZ4935672,77,24,22,2,1
SBI79XLB7127240,22,25,16,9,1
SBI87YIS3838278,71,15,10,5,1
SBI64GIK5571896,79,23,17,6,1
SBI52KPE5301078,67,18,17,1,1
SBI14BOA0680801,76,18,15,3,1
SBI32YXE7789088,87,23,16,7,1
SBI49BKD9075188,60,21,16,5,1
SBI89ZHF4541581,96,25,19,6,1
SBI46MTG2960164,73,19,11,8,1
SBI16ESV1224544,86,20,19,1,1
SBI45AXK3721713,99,22,12,10,1
SBI80TGH2935222,94,25,14,11,1
SBI02EAP5887643,67,30,27,3,1
SBI04JIM7978035,18,21,15,6,1
SBI50LAI7157905,73,25,17,8,1
SBI10QEL6516060,63,21,15,6,1
SBI48ZQQ4664443,87,21,11,10,1
SBI27ZYT6218894,77,23,15,8,1
SBI78IWJ7815825,80,21,14,7,1
SBI36AKH6551440,69,24,18,6,1
SBI53KIV8550258,91,21,17,4,1
SBI96NQJ1551855,98,26,16,10,1
SBI20GCK4492625,92,17,10,7,1
SBI97PLV5889541,98,25,13,12,1
SBI57TCL8236589,87,29,22,7,1
SBI47ZQX7366328,87,28,18,10,1
SBI87UYA2354938,66,22,17,5,1
SBI34OSL3329130,61,21,15,6,1
SBI86YHE9682521,95,21,16,5,1
SBI92SQB8635873,25,30,20,10,1
SBI79UED6941899,69,23,13,10,1
SBI14ISY6074143,21,17,15,2,1
SBI98BES2097026,19,28,21,7,1
SBI90TYI7042762,84,25,23,2,1
SBI54VBD1978939,91,23,15,8,1
SBI94YDZ7091792,63,27,25,2,1
SBI20JAT0674371,89,30,16,14,1
SBI82YNI9419285,98,29,28,1,1
SBI70KDK1659729,75,27,16,11,1
SBI72ERM0263363,66,28,26,2,1
SBI89HXW6246436,80,30,17,13,1
SBI38GCP2029327,73,24,19,5,1
SBI93RBB4232344,72,22,19,3,1
SBI88PYO7089017,96,11,8,3,1
SBI54JUB4987562,83,29,25,4,1
SBI36SBY2237976,77,20,19,1,1
SBI02NFN0127591,88,25,13,12,1
SBI79ORI9001133,91,23,15,8,1
SBI07KGA1069163,64,22,20,2,1
SBI15LDC7059584,25,21,16,5,1
SBI20LXI5658383,66,31,29,2,1
SBI12JVZ0447812,62,24,22,2,1
SBI48UYD1765665,78,28,23,5,1
SBI68QCZ1967391,88,24,21,3,1
SBI34HGU4262351,93,20,16,4,1
SBI09BXX5350276,76,30,19,11,1
SBI34SBX7198318,92,33,28,5,1
SBI43ZCF6687430,99,23,19,4,1
SBI05YLE3548681,92,38,21,17,1
SBI17VTW3517363,25,29,24,5,1
SBI44OUF8474598,20,36,23,13,1
SBI29QCT4092338,19,31,30,1,1
SBI40SIF6744185,90,17,11,6,1
SBI02HXP1733701,61,17,16,1,1
SBI32AOR9445009,82,31,21,10,1
SBI20IMU8695085,96,23,20,3,1
SBI00JBF8198797,88,26,24,2,1
SBI21HQM6178523,67,26,19,7,1
SBI82BJM7082187,96,23,14,9,1
SBI68FTR2371620,72,22,19,3,1
SBI40SJZ6301029,83,16,14,2,1
SBI58HMS6540940,77,18,12,6,1
SBI85OTM6927127,61,25,14,11,1
SBI22EUK7373667,68,17,15,2,1
SBI56PEE7007182,20,26,25,1,1
SBI41FAT8312363,87,28,26,2,1
SBI82KYY5032188,90,16,11,5,1
SBI33LPF8458637,68,19,13,6,1
SBI04EZW3837883,70,17,11,6,1
SBI38VUH1417266,24,33,28,5,1
SBI35UOY4318260,88,34,33,1,1
SBI96ZHY2600382,61,22,15,7,1
SBI62YXR2038799,72,21,14,7,1
SBI53YBS8752303,60,22,16,6,1
SBI04CQX0502940,67,18,16,2,1
SBI26FSV3346397,23,18,12,6,1
SBI70PHR9589789,72,32,24,8,1
SBI73PPY5455706,69,27,22,5,1
SBI63EKO7812963,92,15,12,3,1
SBI80XWZ0997438,74,18,15,3,1
SBI07CYT7088722,95,24,14,10,1
SBI22OAP8142566,74,25,21,4,1
SBI12KQG5396639,65,24,22,2,1
SBI28SIF2996251,21,24,21,3,1
SBI22RXJ9875039,87,26,17,9,1
SBI78TAI5913862,71,25,24,1,1
SBI83FQN0708827,25,28,21,7,1
SBI72ZTJ6121180,70,23,16,7,1
SBI41FFH6453226,22,27,19,8,1
SBI39KVA0738563,64,27,22,5,1
SBI44IYU7755142,91,21,15,6,1
SBI02RVQ8139902,60,23,22,1,1
SBI28IWT1880230,89,25,16,9,1
SBI52CAK2108984,23,26,16,10,1
SBI14TSZ2848934,86,20,17,3,1
SBI66ZNH0617193,88,19,11,8,1
SBI59QMB0379381,85,14,11,3,1
SBI48UNQ2300651,63,19,12,7,1
SBI18BAP3981944,78,20,19,1,1
SBI26LGW8933792,78,21,19,2,1
SBI60DHJ8334188,61,26,25,1,1
SBI86RAO1548826,65,14,13,1,1
SBI02TQA1867210,91,25,19,6,1
SBI33UFI0966530,76,25,16,9,1
SBI95UOX3621105,24,26,24,2,1
SBI00TOQ5075483,79,16,11,5,1
SBI46WMH9917632,77,23,22,1,1
SBI64BBQ9910618,91,14,10,4,1
SBI52WAJ1903781,65,20,17,3,1
SBI63SHM7518759,74,17,10,7,1
SBI31VLY0548574,85,30,26,4,1
SBI14BSR8094399,63,25,18,7,1
SBI74LBD9583031,20,21,16,5,1
SBI34UUW4486673,65,23,21,2,1
SBI09OOO4101882,67,26,25,1,1
SBI44JKU3279780,83,23,13,10,1
SBI69PSB7906349,69,19,17,2,1
SBI50DWL2074966,90,32,18,14,1
SBI41IHV0081383,80,18,11,7,1
SBI32OYJ5362262,84,19,14,5,1
SBI38LKD3830812,73,25,13,12,1
SBI20XOO6199571,69,22,14,8,1
SBI57BPJ9734848,18,32,20,12,1
SBI02UAU3034363,69,32,26,6,1
SBI00MNE3121629,80,14,11,3,1
SBI96EDT4773584,87,28,22,6,1
SBI23JOU7124649,97,28,15,13,1
SBI61AXN1061752,66,26,18,8,1
SBI88YJT4968686,19,28,16,12,1
SBI36WIX2882464,89,29,27,2,1
SBI96PMB5527547,96,22,16,6,1
SBI68HYX3776510,88,20,13,7,1
SBI58ZST1507898,99,32,23,9,1
SBI05BQL3569829,83,31,24,7,1
SBI84APO6846228,60,24,18,6,1
SBI21YGI2867353,88,30,25,5,1
SBI90BTV9549984,23,29,16,13,1
SBI13XEH5162532,94,15,9,6,1
SBI79FTD0705876,65,24,20,4,1
SBI76GUR5414254,94,24,13,11,1
SBI14XNV3837147,71,29,28,1,1
SBI50PXJ1798740,25,23,18,5,1
SBI82OSJ3041655,67,25,23,2,1
SBI91FEF3622701,75,32,23,9,1
SBI28DDR3693981,80,21,19,2,1
SBI05HZK0237721,23,26,23,3,1
SBI19FQQ1334781,69,33,27,6,1
SBI16YXB8021248,93,20,18,2,1
SBI08ZQD6948982,18,24,18,6,1
SBI05FRA3138332,18,27,25,2,1
SBI11REX7914149,21,27,23,4,1
SBI52FSK1918131,98,26,21,5,1
SBI30YUX4382414,93,31,26,5,1
SBI78OSN3662356,79,22,13,9,1
SBI38CSG5660583,72,28,23,5,1
SBI58GYF6495253,61,20,17,3,1
SBI75NMM7675735,80,26,17,9,1
SBI11NYT0958477,67,33,29,4,1
SBI55YQC7083316,91,28,27,1,1
SBI13GPU6728184,74,19,12,7,1
SBI59DOB4722314,19,20,14,6,1
SBI04OZH3169176,60,25,16,9,1
SBI42OJA8574618,20,22,18,4,1
SBI03YRW7098204,25,20,16,4,1
SBI34OOS0725587,80,23,19,4,1
SBI24BUM5363640,96,19,15,4,1
SBI17WMA1608853,20,24,18,6,1
SBI61DQF6192317,20,18,15,3,1
SBI28UMP0202624,69,14,8,6,1
SBI10ZCY8254668,19,27,24,3,1
SBI49YMB0009827,24,23,17,6,1
SBI70SSM4134126,74,32,18,14,1
SBI09WQK6497338,23,22,13,9,1
SBI39QUL1653293,74,20,16,4,1
SBI20XED4100379,93,19,12,7,1
SBI57BTF7561970,24,20,11,9,1
SBI20UQD6284453,89,15,10,5,1
SBI06NIK5488782,19,25,24,1,1
SBI97IHW8059120,67,20,11,9,1
SBI95BNL4492488,69,21,17,4,1
SBI04RQG3041031,69,30,19,11,1
SBI61QMW9546274,94,27,26,1,1
SBI31WJV9401218,24,28,23,5,1
SBI02SKB7012893,61,27,18,9,1
SBI09LVJ5883560,93,22,20,2,1
SBI46YES5152375,24,29,28,1,1
SBI65UJS5961872,84,30,17,13,1
SBI49ZAZ7110891,78,25,14,11,1
SBI24CUH4407836,76,23,15,8,1
SBI75GWG5152066,76,22,21,1,1
SBI48ZVZ3798320,86,21,11,10,1
SBI72SUW1052298,25,30,16,14,1
SBI91SKI0836332,72,26,23,3,1
SBI49GUX1376123,18,23,12,11,1
SBI16URA5853539,80,25,15,10,1
SBI52LYA8709628,18,27,17,10,1
SBI19WJR1919022,68,29,18,11,1
SBI18NHA7599478,63,29,24,5,1
SBI29RLT6863493,80,17,9,8,1
SBI33PUT9981978,67,21,18,3,1
SBI98GIK9965101,86,22,19,3,1
SBI25MEN7389184,90,15,9,6,1
SBI44HSE1546156,82,24,20,4,1
SBI90RWY9959173,63,24,19,5,1
SBI33POI0156081,69,29,25,4,1
SBI35ELM5571389,75,21,20,1,1
SBI02LCF6888549,98,27,26,1,1
SBI34LIX6711184,23,22,19,3,1
SBI95WQK9683058,91,19,11,8,1
SBI28LWG3303078,98,19,15,4,1
SBI35PHC6366367,20,25,21,4,1
SBI56FZQ7800680,83,29,15,14,1
SBI10MJL9925438,66,24,17,7,1
SBI61ZES8320931,18,38,31,7,1
SBI07UGQ5131660,76,34,29,5,1
SBI62FZB3467778,70,27,18,9,1
SBI73IZP7100665,97,17,14,3,1
SBI26HSD4942905,87,21,19,2,1
SBI69GWB5225294,88,22,19,3,1
SBI15SSI2583366,24,24,17,7,1
SBI48NUE0186702,85,23,16,7,1
SBI95JSU2759970,66,23,21,2,1
SBI78GTE9603353,78,31,22,9,1
SBI28PQW3924311,79,24,23,1,1
SBI42OPX8742838,70,27,20,7,1
SBI99YIP5849256,91,25,18,7,1
SBI96EIM1997724,72,23,22,1,1
SBI88VQK3750024,95,28,25,3,1
SBI47VCH0190062,87,14,11,3,1
SBI60PWC5426820,25,26,24,2,1
SBI42SVK6449885,98,22,17,5,1
SBI49NXC6473072,81,22,13,9,1
SBI91ZJJ6776528,97,28,20,8,1
SBI68UKG6479951,78,18,14,4,1
SBI32GKR5973596,78,36,24,12,1
SBI37VCK8946953,89,19,16,3,1
SBI92XBQ7901655,91,20,15,5,1
SBI11EZT3624469,18,34,29,5,1
SBI77GLW7035850,70,24,21,3,1
SBI86UBV3499989,90,21,14,7,1
SBI64IKO4632187,78,25,16,9,1
SBI78DKC7938567,73,31,24,7,1
SBI12RHC3829875,63,26,23,3,1
SBI48PQM5899159,92,23,18,5,1
SBI57SYM8838892,20,22,12,10,1
SBI77SOY1019955,83,22,18,4,1
SBI38GYJ5201314,69,19,13,6,1
SBI41AJM1620912,64,22,19,3,1
SBI58UTW2440176,82,18,12,6,1
SBI48UGU8881978,20,37,28,9,1
SBI36EZN3989718,74,28,15,13,1
SBI18KSV4319053,99,33,19,14,1
SBI19HUD2666924,25,21,11,10,1
SBI99JFO8152122,77,25,23,2,1
SBI63EVW3935393,20,29,16,13,1
SBI13DZF9751963,62,24,23,1,1
SBI35SVE6890232,75,31,26,5,1
SBI59WVY8571520,75,35,32,3,1
SBI03QRE1984174,75,26,18,8,1
SBI22DUZ9557320,61,25,18,7,1
SBI91JAQ1153804,25,24,20,4,1
SBI51VVT8413127,22,26,25,1,1
SBI14GLS0388645,22,30,16,14,1
SBI47ZHF3262429,67,31,18,13,1
SBI78NRN4608313,22,27,15,12,1
SBI12XEI9514584,67,22,18,4,1
SBI44NCJ6191679,96,26,21,5,1
SBI74GVL2305462,67,31,18,13,1
SBI71CXO4559704,21,30,19,11,1
SBI06QHF0167996,77,30,26,4,1
SBI91TEH9316034,98,33,31,2,1
SBI23EGY7621513,79,14,12,2,1
SBI53MYT2684251,96,21,20,1,1
SBI12NER0571281,74,24,16,8,1
SBI62BUB9984789,86,27,21,6,1
SBI21NVN8449541,77,30,21,9,1
SBI66HPH3972812,98,24,15,9,1
SBI26ZGF4763920,22,24,14,10,1
SBI85IOJ9365162,88,25,14,11,1
SBI24AOA0374478,65,36,31,5,1
SBI48WJM3463981,69,22,20,2,1
SBI31YZC1722638,68,25,14,11,1
SBI05AHE1052272,98,31,26,5,1
SBI92SSM3556011,97,18,17,1,1
SBI75SSX2738794,74,21,14,7,1
SBI44EEH6111379,22,35,25,10,1
SBI16DIZ2666485,77,23,17,6,1
SBI56HOP9988714,95,28,27,1,1
SBI46ZIJ7630687,18,18,12,6,1
SBI65TEQ9834449,99,26,16,10,1
SBI29KNH0045546,22,23,13,10,1
SBI96LYP4512591,62,25,13,12,1
SBI89WKH2577675,61,21,20,1,1
SBI39MVI8860800,90,20,17,3,1
SBI68YKV3801840,21,27,24,3,1
SBI60UPY2264273,89,22,20,2,1
SBI67GDE0149347,98,23,12,11,1
SBI14DXB0612415,75,25,20,5,1
SBI95AUJ7245112,74,32,31,1,1
SBI38SIA4504448,84,31,26,5,1
SBI23BOP7968882,91,30,16,14,1
SBI90QWI8762047,84,24,17,7,1
SBI70LHX2144876,95,22,19,3,1
SBI82JVT0945700,94,19,16,3,1
SBI92UTG8873856,87,15,8,7,1
SBI23ZXR6420765,72,18,11,7,1
SBI30INB9846599,87,23,18,5,1
SBI93OJJ1877881,90,17,12,5,1
SBI24CKN9240388,70,28,27,1,1
SBI41SPC9992971,75,22,12,10,1
SBI49CRX1509053,63,27,23,4,1
SBI74LMX1955087,99,23,12,11,1
SBI36BAJ2506258,19,23,20,3,1
SBI07HUP2745210,61,25,17,8,1
SBI83DWY4532913,79,16,11,5,1
SBI16AFP3335864,82,19,15,4,1
SBI39RXK9761894,99,20,17,3,1
SBI40GDO9647515,96,28,20,8,1
SBI22LSI0529350,92,25,24,1,1
SBI00VBY3877903,82,30,20,10,1
SBI92EGQ6450609,69,25,24,1,1
SBI86TNJ0557539,20,22,18,4,1
SBI43TWR4064935,60,26,17,9,1
SBI13DRL6354057,20,20,19,1,1
SBI91PTC6597690,75,15,13,2,1
SBI02XBW7414184,92,26,24,2,1
SBI45TWT8065684,62,18,13,5,1
SBI04EON6924050,99,29,28,1,1
SBI47XYK0275712,69,14,11,3,1
SBI43BQY7111370,76,20,19,1,1
SBI38WPX2807919,75,22,16,6,1
SBI16NNN8701247,64,24,14,10,1
SBI21UPC5348193,71,27,15,12,1
SBI72CUQ6336035,67,28,17,11,1
SBI83LUA8192429,95,23,19,4,1
SBI39CGV5320352,22,31,28,3,1
SBI13NIW7021617,89,26,16,10,1
SBI54HAP7364854,83,19,18,1,1
SBI09NMX5540236,80,27,17,10,1
SBI33MUH4714555,78,20,15,5,1
SBI00XOY3093687,61,22,15,7,1
SBI66XKM1327079,70,21,16,5,1
SBI96ECO1026452,71,21,19,2,1
SBI67JXQ5044455,71,19,18,1,1
SBI37BCF6644088,65,20,19,1,1
SBI23ZGP2810229,77,28,21,7,1
SBI20IQI9637489,77,27,24,3,1
SBI32OKE0672437,86,22,19,3,1
SBI96GIQ7622830,95,25,18,7,1
SBI02WKD3576517,70,20,16,4,1
SBI98JFK3258753,62,28,16,12,1
SBI12BSE1746189,21,23,18,5,1
SBI33MGP0943167,62,27,18,9,1
SBI60BZL6628219,72,18,11,7,1
SBI91RND8239091,23,19,14,5,1
SBI88BKH3982171,67,24,22,2,1
SBI70YKM2271222,18,29,15,14,1
SBI23HBC8645596,69,23,14,9,1
SBI62LRJ3227029,93,36,30,6,1
SBI60KMW7244252,64,27,16,11,1
SBI47UHU3404437,95,20,19,1,1
SBI19SHA8191177,87,26,21,5,1
SBI76BQW6703195,71,24,20,4,1
SBI69PFV3580578,84,17,13,4,1
SBI48HQR4994853,70,29,23,6,1
SBI41UIZ6127862,64,8,6,2,1
SBI77SNP4467841,19,31,29,2,1
SBI87CFW8510101,83,29,18,11,1
SBI00DRU8595739,98,35,33,2,1
SBI16NQR7733733,91,32,17,15,1
SBI20UOY7635622,66,27,23,4,1
SBI39BBF9055229,22,18,11,7,1
SBI58HBR9614462,63,25,13,12,1
SBI64MSI9686826,98,35,24,11,1
SBI75XBR4435489,22,19,18,1,1
SBI12GNU6217255,97,23,20,3,1
SBI44SMY0148132,94,23,21,2,1
SBI62USH5988531,93,27,20,7,1
SBI02YQI0249581,99,28,17,11,1
SBI94VHN5405988,19,32,21,11,1
SBI11HWR0998842,19,20,19,1,1
SBI08ZZB6092583,93,23,19,4,1
SBI14MTP7631422,98,21,11,10,1
SBI46EKJ0930710,81,27,18,9,1
SBI52TLR8949290,95,18,16,2,1
SBI11HWZ8967127,95,33,26,7,1
SBI14ZOC4111957,69,27,16,11,1
SBI57RER6392448,64,26,21,5,1
SBI18SNL3884301,78,33,23,10,1
SBI98HJN6195112,24,31,23,8,1
SBI95HOC8767420,91,23,14,9,1
SBI44SHU8662499,96,29,27,2,1
SBI92MAT0431953,64,39,20,19,1
SBI31PKP6010723,91,24,21,3,1
SBI06OMK6397947,71,29,23,6,1
SBI00YYQ4645310,69,20,11,9,1
SBI51ZMT9310267,23,30,28,2,1
SBI50UTP3486998,67,29,24,5,1
SBI72SHU4130650,73,27,19,8,1
SBI40MRY5829850,96,18,16,2,1
SBI56ETQ7990762,98,25,20,5,1
SBI72SFS8888635,98,24,19,5,1
SBI28BZX2059857,67,23,19,4,1
SBI45XAB9131680,18,23,16,7,1
SBI69RVZ5099738,75,21,16,5,1
SBI32ZEI9096098,25,35,25,10,1
SBI05ARE1525316,95,23,19,4,1
SBI33DPZ3392787,89,26,17,9,1
SBI78ZPM9734084,18,17,13,4,1
SBI88TLG8585361,64,22,20,2,1
SBI95UCZ7954740,86,26,25,1,1
SBI14AQS6948984,85,25,16,9,1
SBI28CID2468836,18,25,17,8,1
SBI83JBR7262229,19,20,11,9,1
SBI85JNP6711493,99,19,11,8,1
SBI17MNN5745262,83,21,12,9,1
SBI82SHO4173237,85,21,12,9,1
SBI01LUE3208736,90,30,29,1,1
SBI37URB9772617,24,46,27,19,1
SBI09VSM2992460,61,29,21,8,1
SBI40IYK1124695,91,26,14,12,1
SBI07DIC4713489,96,23,18,5,1
SBI95SQM7600342,92,28,21,7,1
SBI81KPW7017261,91,23,20,3,1
SBI05JCL5364429,72,28,24,4,1
SBI65CMW6171960,68,21,14,7,1
SBI01TNS9256845,86,29,23,6,1
SBI94NKR3281077,69,33,21,12,1
SBI74OJW4624467,24,21,14,7,1
SBI45FVA5952320,76,18,15,3,1
SBI58YUQ7820050,83,23,13,10,1
SBI94CZN5692614,87,17,15,2,1
SBI21SNR6713237,77,27,23,4,1
SBI39XBP9233330,93,30,23,7,1
SBI71PKP8975975,79,29,20,9,1
SBI22ISO3973482,61,27,20,7,1
SBI62MOZ6130851,72,20,16,4,1
SBI98FGB0807236,86,21,18,3,1
SBI97HKY7578913,92,26,23,3,1
SBI52IKE2857734,85,28,19,9,1
SBI25WTX1410228,66,18,10,8,1
SBI19UQL9509403,90,20,19,1,1
SBI22CRE6341760,21,24,21,3,1
SBI40GJX3069462,83,24,13,11,1
SBI31FSH3107615,62,22,20,2,1
SBI30ZKF1381819,98,17,16,1,1
SBI37YFA7605269,76,36,21,15,1
SBI66KOS4496425,97,33,30,3,1
SBI44GTO2161130,65,22,17,5,1
SBI85GRT8632027,61,32,25,7,1
SBI41LGJ8747718,70,32,18,14,1
SBI00FOU3271615,68,25,15,10,1
SBI87TLN6276245,76,29,23,6,1
SBI85DMZ9700455,96,27,19,8,1
SBI47VMZ7016411,77,24,15,9,1
SBI02AMM2062758,18,23,19,4,1
SBI05QQE2906318,79,22,20,2,1
SBI85LZX3566684,79,21,19,2,1
SBI97STN9152581,23,16,12,4,1
SBI86YRZ4661030,23,16,12,4,1
SBI68NAG6552542,80,29,17,12,1
SBI56OBA6503212,89,30,24,6,1
SBI75MDF7249870,88,13,7,6,1
SBI12LQQ4146810,67,20,13,7,1
SBI03LIH4329851,83,28,20,8,1
SBI83OTJ5566487,63,18,10,8,1
SBI94DHA2736045,25,23,22,1,1
SBI63YLV7293483,85,19,13,6,1
SBI54NXM6149389,90,29,17,12,1
SBI94TML7032455,73,20,13,7,1
SBI13XKN2366836,83,27,14,13,1
SBI18NOA0767593,79,20,17,3,1
SBI85CWV1212198,70,28,16,12,1
SBI78ZSU8923323,66,23,14,9,1
SBI60MPY7443802,66,27,21,6,1
SBI43ZVY9862458,63,18,14,4,1
SBI70FVN5499850,99,23,13,10,1
SBI39MRH5775114,85,17,15,2,1
SBI94IEZ3310928,25,26,19,7,1
SBI47YEV4065605,87,27,20,7,1
SBI13LPC0625141,90,25,22,3,1
SBI01ILR1897679,63,26,14,12,1
SBI36OFZ8143000,71,30,21,9,1
SBI43HZR5752521,97,32,24,8,1
SBI95OGJ0264556,84,20,12,8,1
SBI18MGG1457339,77,24,15,9,1
SBI37HTZ6713019,68,17,15,2,1
SBI27XUV3241399,93,31,30,1,1
SBI67BJD3481105,99,23,17,6,1
SBI15ZAH5663756,94,20,12,8,1
SBI22LDV5156174,88,23,14,9,1
SBI53DHI3997845,68,23,22,1,1
SBI76WQP4426410,81,26,14,12,1
SBI45OOY2215029,21,20,13,7,1
SBI69PTT4038128,90,27,14,13,1
SBI28LDV5704073,88,28,15,13,1
SBI36LZD6356759,71,25,18,7,1
SBI04BPK0940978,67,39,25,14,1
SBI61FUH7857851,24,20,17,3,1
SBI42THM2531148,68,29,23,6,1
SBI55HAV3866907,72,25,15,10,1
SBI23ZQI6556233,60,25,17,8,1
SBI09THY3154805,76,31,28,3,1
SBI84EXR1558833,19,22,20,2,1
SBI21UJA1530153,80,26,24,2,1
SBI28IQB8771568,86,17,11,6,1
SBI10JBH5733797,86,24,16,8,1
SBI24DXL9248689,89,31,20,11,1
SBI21FGD3891667,87,23,18,5,1
SBI91ICF2876948,84,39,22,17,1
SBI96RPP1738511,60,28,26,2,1
SBI02GYK4503983,70,35,19,16,1
SBI55VSL2416105,63,27,20,7,1
SBI94LSZ2995708,94,21,12,9,1
SBI07CHT4443734,62,23,15,8,1
SBI57GWE4254072,22,22,16,6,1
SBI16EEM2713799,74,26,24,2,1
SBI82ASP1821617,24,20,14,6,1
SBI49FRZ0349499,23,31,22,9,1
SBI40DLY2204213,85,23,16,7,1
SBI03XHP6965594,25,24,18,6,1
SBI62ETS4379145,93,32,31,1,1
SBI56SSQ9783811,61,18,15,3,1
SBI95EBM5882615,74,31,16,15,1
SBI48YWD7961980,81,28,25,3,1
SBI14TNS2091522,93,24,23,1,1
SBI15DDZ3249076,80,20,15,5,1
SBI33XCJ1986853,81,23,21,2,1
SBI75AZY8133390,62,25,16,9,1
SBI28NUG8714829,60,30,25,5,1
SBI14GIS2153889,62,17,11,6,1
SBI92SDP9444386,87,20,16,4,1
SBI14EGD6736106,23,22,18,4,1
SBI22WNM5205937,84,22,16,6,1
SBI49BYY4092217,80,23,15,8,1
SBI96QVZ8496458,94,25,14,11,1
SBI21XFA0016581,18,25,20,5,1
SBI03ZCD3696188,92,21,17,4,1
SBI28URT9083668,74,22,18,4,1
SBI38EKS4381798,88,21,13,8,1
SBI02CTX3580822,61,22,17,5,1
SBI75RYN6057916,71,27,20,7,1
SBI49TUM1214423,76,26,19,7,1
SBI69YNJ7391111,71,28,26,2,1
SBI56QFT0049718,65,22,13,9,1
SBI63AEX4774018,18,28,27,1,1
SBI83TFP5888277,87,20,15,5,1
SBI01YKR8282169,97,26,16,10,1
SBI78OEH2866423,98,23,12,11,1
SBI48OTI5971477,60,33,18,15,1
SBI83HCK2691776,77,23,12,11,1
SBI58JMJ8879549,70,25,16,9,1
SBI64PNG4782946,74,31,27,4,1
SBI96ZXI3753334,99,27,17,10,1
SBI13YZC0602049,65,23,16,7,1
SBI97KRO0470049,92,19,11,8,1
SBI55FKA7542537,87,25,14,11,1
SBI59DMM6772126,20,19,15,4,1
SBI10WVA2836427,89,20,14,6,1
SBI92XGK0604434,92,19,12,7,1
SBI14TLZ3630943,67,26,20,6,1
SBI18TTH6586343,91,32,26,6,1
SBI35YJN4013167,75,23,16,7,1
SBI92JKL4950126,70,28,22,6,1
SBI22COI0595029,99,35,18,17,1
SBI44URP1486388,92,25,20,5,1
SBI01JUT4812617,97,28,23,5,1
SBI24PZH8147761,21,27,24,3,1
SBI28XJO9917834,76,24,14,10,1
SBI47LBK3094569,62,27,20,7,1
SBI84FZN1903944,62,25,24,1,1
SBI94GSW0639173,62,16,12,4,1
SBI63YID4384452,21,27,17,10,1
SBI18VWV5931759,79,25,21,4,1
SBI60KBO0629168,71,22,14,8,1
SBI02GLG6752033,89,32,17,15,1
SBI03NYY1590833,97,19,13,6,1
SBI87IOT5611309,78,24,22,2,1
SBI08MDM4585883,85,24,18,6,1
SBI30MLZ5878646,95,26,21,5,1
SBI35GXH4318560,62,18,15,3,1
SBI53KIN2343847,70,25,18,7,1
SBI78ZDF9296403,64,25,22,3,1
SBI04SIH4309368,60,26,23,3,1
SBI65NFN7612854,85,24,22,2,1
SBI05BKD4267291,62,16,15,1,1
SBI93PGW8705106,64,28,19,9,1
SBI95RKJ1802381,82,29,26,3,1
SBI15JDX1907551,97,20,19,1,1
SBI68GLH3818456,72,21,11,10,1
SBI85JMA4971687,77,25,16,9,1
SBI11PMI0751318,23,32,19,13,1
SBI74RQY6137049,25,23,13,10,1
SBI21XSB5439835,20,19,14,5,1
SBI98TXV6225032,74,22,12,10,1
SBI53JNO5532490,63,27,19,8,1
SBI56BWG2247404,82,21,16,5,1
SBI19AKI6857991,79,24,14,10,1
SBI39FSD7481813,98,25,15,10,1
SBI25RQQ1779578,63,23,13,10,1
SBI85EGX3824913,20,23,15,8,1
SBI10XWF3276116,98,16,10,6,1
SBI52TTF2311736,72,14,12,2,1
SBI75DEL7105950,65,25,18,7,1
SBI80PGX5588953,93,39,24,15,1
SBI49CID2889192,25,20,12,8,1
SBI14VWE0356515,78,29,19,10,1
SBI11BTY9732478,67,17,16,1,1
SBI08VUL7614487,78,30,26,4,1
SBI73DRP6832829,72,27,14,13,1
SBI00XXE6233562,83,19,17,2,1
SBI63EOQ9085279,72,20,16,4,1
SBI30DPX3021626,83,18,11,7,1
SBI50RNC6507627,88,15,11,4,1
SBI66LPI7851036,74,15,11,4,1
SBI96JPZ0803908,93,25,18,7,1
SBI65OCT5644954,98,26,22,4,1
SBI75WNL0166041,63,28,25,3,1
SBI14JWZ7511992,95,24,21,3,1
SBI06TCW0241761,93,27,17,10,1
SBI08TAD7792290,20,34,27,7,1
SBI57LPI7315966,99,19,13,6,1
SBI89DCW1407476,82,22,16,6,1
SBI89HPN2057244,81,27,14,13,1
SBI86SYA5502257,21,27,17,10,1
SBI17UGR8323554,96,24,17,7,1
SBI64HYT2922615,75,29,25,4,1
SBI02AAV8438451,19,20,12,8,1
SBI61UTQ0531107,18,27,18,9,1
SBI24MHM2895615,65,30,19,11,1
SBI90ELQ7296719,98,27,23,4,1
SBI99TIS7535406,70,20,17,3,1
SBI39IUZ4279457,93,23,21,2,1
SBI57GZT2341808,98,27,18,9,1
SBI73AAW4537061,23,25,20,5,1
SBI59YBK4692418,62,23,19,4,1
SBI46LDY8480950,62,28,23,5,1
SBI85YGL5745861,82,20,19,1,1
SBI81HYT1286924,64,17,16,1,1
SBI48NUC1678898,82,23,16,7,1
SBI64XMX8853991,80,17,16,1,1
SBI51ESZ2990425,82,22,18,4,1
SBI45ITA7792384,75,23,17,6,1
SBI43MAL7578600,92,22,18,4,1
SBI96SXT7972920,78,28,20,8,1
SBI19SUZ6461849,71,31,21,10,1
SBI57VAL0461087,84,28,19,9,1
SBI93RSC1949455,68,27,26,1,1
SBI78LZQ0520701,91,30,18,12,1
SBI25CNE4963064,70,25,19,6,1
SBI27NFB0452459,88,27,25,2,1
SBI06PXS0734177,19,30,23,7,1
SBI19SGF4099940,23,16,9,7,1
SBI54JLP6244186,22,18,12,6,1
SBI95GSH8541290,77,20,15,5,1
SBI06PTO0296476,22,31,21,10,1
SBI60AKO0052539,84,31,22,9,1
SBI11AUT5808964,71,16,12,4,1
SBI37WSJ6116939,61,23,12,11,1
SBI86KRV7632815,68,23,16,7,1
SBI04TZX2906998,78,19,17,2,1
SBI11SJV6365727,98,28,21,7,1
SBI13ZGJ0288506,76,32,27,5,1
SBI97AEE8438545,65,25,16,9,1
SBI58RRS6137518,95,19,17,2,1
SBI75LDY5378481,89,22,12,10,1
SBI75PND3421849,74,26,18,8,1
SBI90BHQ6960139,89,15,13,2,1
SBI41LFD1803082,93,20,11,9,1
SBI20WGC3289891,25,26,21,5,1
SBI71IDN3338509,73,28,22,6,1
SBI06VKL4588736,84,21,14,7,1
SBI43REC5317337,19,26,25,1,1
SBI86MQB5611608,88,30,26,4,1
SBI98TNX7198291,60,18,14,4,1
SBI97TVW2458892,18,22,16,6,1
SBI18DIZ4544457,81,29,26,3,1
SBI88OWO1835646,66,27,14,13,1
SBI86IWT5327207,85,14,11,3,1
SBI60CND0716138,77,25,20,5,1
SBI73TVY3433653,20,26,16,10,1
SBI73FIQ7442563,18,25,16,9,1
SBI45EFR7124348,62,25,15,10,1
SBI51GDW1720264,63,18,16,2,1
SBI40CYY4804700,24,23,16,7,1
SBI76TES5116133,73,28,24,4,1
SBI77KTU4347088,63,24,15,9,1
SBI05PZI7783146,62,23,22,1,1
SBI74NRP0507339,67,35,33,2,1
SBI42CID2123008,25,25,19,6,1
SBI56XOO1385822,92,30,16,14,1
SBI68NCU7492103,79,25,22,3,1
SBI32BFR9265896,83,28,22,6,1
SBI33AYM1622946,67,16,14,2,1
SBI21PUT8852537,85,24,14,10,1
SBI74PUA1781443,77,25,16,9,1
SBI98TGJ4112992,60,30,28,2,1
SBI28GJQ0327835,78,28,27,1,1
SBI53JKA6433467,95,21,17,4,1
SBI33IAZ7575559,22,38,31,7,1
SBI32VVJ5927200,75,23,13,10,1
SBI00WNR1258704,91,25,23,2,1
SBI09CCK2841449,66,16,11,5,1
SBI04CFR3454300,77,23,19,4,1
SBI54JGZ5530442,63,30,27,3,1
SBI68NNH8203990,78,25,23,2,1
SBI15QDD2411177,21,26,24,2,1
SBI58UAM5930148,96,28,17,11,1
SBI04KAO9426315,82,30,26,4,1
SBI41GMO1561918,68,25,21,4,1
SBI64DRB3342800,25,27,16,11,1
SBI41ICH2475140,67,19,11,8,1
SBI38FHV6143642,73,24,21,3,1
SBI54AKL7079257,88,15,9,6,1
SBI91EIA8819671,23,17,12,5,1
SBI71QIQ5988605,71,30,27,3,1
SBI09AZX0769488,89,29,19,10,1
SBI84WGI5905526,96,28,19,9,1
SBI67TOX7971151,80,26,25,1,1
SBI96MKT9532305,76,26,20,6,1
SBI79HLK1033754,92,25,20,5,1
SBI81XNB2170029,80,25,23,2,1
SBI92RYG6115214,96,28,17,11,1
SBI30CIC8044619,62,35,28,7,1
SBI85QQU9688038,60,21,20,1,1
SBI41BYC9826334,79,24,18,6,1
SBI53OKD8737125,92,31,26,5,1
SBI67GCE3272061,81,28,27,1,1
SBI62VDO4411992,19,21,11,10,1
SBI24OMT7910293,76,21,16,5,1
SBI02LCI1263024,21,28,17,11,1
SBI88XDT1217637,62,21,20,1,1
SBI19QLN0321997,24,19,16,3,1
SBI88NAS2121372,64,23,20,3,1
SBI14ENB7649335,61,20,12,8,1
SBI53XWQ8835814,95,27,24,3,1
SBI23AMY0551833,19,36,29,7,1
SBI67DBH1193268,62,25,21,4,1
SBI31RAE1986489,85,22,21,1,1
SBI09IVJ6351488,88,30,25,5,1
SBI91AZL1940084,65,22,18,4,1
SBI98TSC1798358,77,25,19,6,1
SBI78IEW3156513,98,18,10,8,1
SBI86MAM4054364,91,16,10,6,1
SBI50YHO1508071,22,27,26,1,1
SBI94BTO1083621,83,31,16,15,1
SBI68FZW3637156,21,30,23,7,1
SBI66ZGQ0014328,85,21,17,4,1
SBI48QQQ7414383,75,24,20,4,1
SBI36XGJ2793621,94,24,15,9,1
SBI61VBL0056252,69,32,30,2,1
SBI75QKY9549322,61,22,18,4,1
SBI58HZT2599817,72,21,12,9,1
SBI82KPY7369605,80,24,23,1,1
SBI31RPL7038678,82,29,22,7,1
SBI44MCX7552500,71,21,16,5,1
SBI06ONT2117738,70,16,11,5,1
SBI25HIQ6398279,89,25,19,6,1
SBI62EZA3868003,23,12,11,1,1
SBI73PGI5620447,83,18,10,8,1
SBI81UYF4014246,97,25,24,1,1
SBI31ZRS9441172,76,27,17,10,1
SBI24AWO1470697,91,23,22,1,1
SBI41QOW5650941,86,27,21,6,1
SBI15LRZ3725031,85,31,22,9,1
SBI35VBK9401158,94,16,14,2,1
SBI28MCR3232798,84,16,11,5,1
SBI82PQQ0863702,69,39,28,11,1
SBI37EWI3190013,61,28,17,11,1
SBI61RSM0005583,64,32,22,10,1
SBI95LAR9890453,97,26,25,1,1
SBI58DIN7993008,94,26,17,9,1
SBI57KRZ3797651,99,36,33,3,1
SBI41UDH4788584,73,27,23,4,1
SBI42CVU2922849,98,20,14,6,1
SBI56ZGU4113176,90,34,32,2,1
SBI01VSP3221846,85,30,27,3,1
SBI47DHB5234752,60,29,26,3,1
SBI38EFY9385219,75,19,14,5,1
SBI72VOD2439562,67,23,19,4,1
SBI39XGB2347021,98,24,21,3,1
SBI25YUF4744849,61,27,16,11,1
SBI55OBN1430525,76,26,16,10,1
SBI03BON1127009,95,21,14,7,1
SBI01LBA9613214,72,21,19,2,1
SBI67DLJ8390476,78,23,22,1,1
SBI02ZWI9219366,70,17,13,4,1
SBI55QAB6457652,79,23,12,11,1
SBI46PGL1812355,80,19,16,3,1
SBI59XFH0778036,60,27,22,5,1
SBI51SOG9036738,67,20,12,8,1
SBI16DYX1764307,79,20,11,9,1
SBI98YVJ4339663,92,22,21,1,1
SBI71SIQ9503343,74,34,22,12,1
SBI05OBB3603393,63,31,17,14,1
SBI83OJX5319097,95,23,17,6,1
SBI50PUV6234237,65,21,14,7,1
SBI37JFJ6875974,92,14,11,3,1
SBI15ACJ1729128,77,22,17,5,1
SBI69AUZ2553076,60,24,15,9,1
SBI04FDZ1443732,63,28,20,8,1
SBI65GYO0868416,22,19,15,4,1
SBI46JZQ2835337,89,30,18,12,1
SBI85DCI8480621,94,29,26,3,1
SBI95KYQ1505660,85,26,18,8,1
SBI05BRD6407703,85,35,32,3,1
SBI86JRC8321201,64,27,16,11,1
SBI48NRT8719458,86,17,9,8,1
SBI80AYU5945085,22,23,21,2,1
SBI30QGT9893405,71,21,13,8,1
SBI88QBI4061647,94,30,22,8,1
SBI88ERV6860311,91,21,17,4,1
SBI55STE0564531,97,32,24,8,1
SBI81RVA8763379,21,20,12,8,1
SBI04BBE1644658,21,33,23,10,1
SBI60XEY4046069,93,22,19,3,1
SBI95RPZ2044899,97,22,19,3,1
SBI34XTJ8416697,83,18,11,7,1
SBI34XKY0909281,75,15,9,6,1
SBI05ELW1002573,77,27,24,3,1
SBI94OMC6857681,87,24,15,9,1
SBI28VIL3539939,64,19,15,4,1
SBI80CHJ5663036,75,32,28,4,1
SBI06VPQ2433788,24,31,23,8,1
SBI65FDO2511336,82,27,18,9,1
SBI49WPG0897992,88,28,24,4,1
SBI43OZQ9707542,98,23,21,2,1
SBI73YOV9463817,71,21,14,7,1
SBI85DTS9610964,20,22,12,10,1
SBI10MCO0411606,70,22,18,4,1
SBI13NQV1525454,87,20,12,8,1
SBI32MCW4988104,70,22,16,6,1
SBI43HTX6598560,77,32,18,14,1
SBI16ALH5685150,24,27,20,7,1
SBI41XYE1131414,89,23,14,9,1
SBI26CUJ3120009,77,31,20,11,1
SBI89ECQ2859643,64,19,13,6,1
SBI57VCL6317168,96,27,23,4,1
SBI77UXE2070578,64,30,23,7,1
SBI49QDL7493117,19,23,16,7,1
SBI16VAB4978623,64,16,13,3,1
SBI17OEJ4678107,72,26,22,4,1
SBI79IIE8636911,92,29,26,3,1
SBI19MVT2174237,95,23,18,5,1
SBI13RJX0188678,24,21,12,9,1
SBI98DVQ3330788,24,20,12,8,1
SBI92ILT2719529,60,32,18,14,1
SBI92MVK2347766,95,27,19,8,1
SBI80OUG4153560,74,22,19,3,1
SBI18WZK6013472,60,25,18,7,1
SBI16CIQ0585269,91,22,13,9,1
SBI96VDK3846800,84,27,24,3,1
SBI13MKQ2172957,94,30,25,5,1
SBI52JLC5520206,62,30,22,8,1
SBI10BXM9307911,64,33,27,6,1
SBI44DXP5406306,98,23,15,8,1
SBI51BOL1978026,89,31,19,12,1
SBI10OPG7816748,90,18,14,4,1
SBI64IFX6686468,88,35,23,12,1
SBI65DBG5178065,97,34,27,7,1
SBI09QBT6201801,98,22,19,3,1
SBI22WCA6404693,77,31,18,13,1
SBI29YGW2959482,22,23,19,4,1
SBI07MAZ4963354,85,25,22,3,1
SBI76REA5362509,96,21,14,7,1
SBI52OIZ4095614,95,27,23,4,1
SBI37EYM1861793,88,17,12,5,1
SBI77BNM5685824,21,33,22,11,1
SBI18SBG5517797,83,29,24,5,1
SBI32XXL1122888,84,24,18,6,1
SBI22FFR1015411,66,25,20,5,1
SBI63IKR3124554,68,22,14,8,1
SBI67AOE7529244,25,28,21,7,1
SBI03HXC1511268,67,31,18,13,1
SBI87MCN0787279,96,23,13,10,1
SBI88ALF3440684,72,25,13,12,1
SBI94EFX4620075,77,17,15,2,1
SBI31IFH4788787,67,19,10,9,1
SBI13XSO1801875,98,17,14,3,1
SBI59AAW5217345,88,28,15,13,1
SBI87NFB0017461,90,25,17,8,1
SBI30WLH5911410,25,27,18,9,1
SBI82OMX2429445,24,33,19,14,1
SBI95HZL9789670,98,23,21,2,1
SBI20CAM2323959,74,24,20,4,1
SBI46OYR0995263,78,25,17,8,1
SBI75FYX8315424,75,25,19,6,1
SBI85SKB7331797,70,27,16,11,1
SBI79OWM6421946,89,19,13,6,1
SBI82RNG4367659,84,31,23,8,1
SBI71KUX6592690,63,20,19,1,1
SBI72AKQ9725803,76,25,17,8,1
SBI60IQW2316217,99,19,18,1,1
SBI63GIT5949962,84,22,15,7,1
SBI46JNI7412525,70,24,19,5,1
SBI16RVZ3441422,95,21,11,10,1
SBI92IHJ7530388,65,19,12,7,1
SBI27RWA6977502,71,23,12,11,1
SBI80PRM1306060,24,20,14,6,1
SBI81NVZ8784572,22,25,17,8,1
SBI31UIK3730414,74,31,23,8,1
SBI05LXN1206589,73,20,12,8,1
SBI98TEP9408719,64,20,17,3,1
SBI71HUZ4203109,88,13,7,6,1
SBI22KHX5303612,83,18,12,6,1
SBI75RAQ0595538,23,24,20,4,1
SBI93RQN5560071,82,30,24,6,1
SBI09KJX3376343,20,24,14,10,1
SBI04SVU9051989,88,20,16,4,1
SBI49LRW0000987,82,22,12,10,1
SBI80RVN4645673,94,24,17,7,1
SBI98MEV7381548,62,20,16,4,1
SBI18VYE3941037,18,21,12,9,1
SBI27KFB6375850,60,25,16,9,1
SBI34MXO1398467,66,29,27,2,1
SBI21LOZ3458851,75,33,21,12,1
SBI46OCH1724256,65,31,25,6,1
SBI37BJD0190173,25,32,25,7,1
SBI87TTP9564935,20,17,10,7,1
SBI29GVK3849042,24,18,11,7,1
SBI85QUB1582093,96,19,13,6,1
SBI22IEU4789776,24,21,11,10,1
SBI70CER7403898,83,24,22,2,1
SBI56JYZ0226564,71,19,11,8,1
SBI23OSS7528919,69,27,14,13,1
SBI06UMQ8006832,21,21,12,9,1
SBI32WWX4124045,61,28,16,12,1
SBI51BPM3246681,61,18,12,6,1
SBI21CRE9781724,94,29,28,1,1
SBI37IJL4235277,64,20,11,9,1
SBI47MNN9404831,66,17,10,7,1
SBI77YUA2456484,61,37,24,13,1
SBI78AHU3952469,79,26,19,7,1
SBI73JEE7489833,69,17,15,2,1
SBI98VAL9849944,89,23,21,2,1
SBI74MKP8727541,79,22,16,6,1
SBI06JRI2945457,25,18,13,5,1
SBI00AAL8914831,20,31,18,13,1
SBI69DTI6705116,79,23,17,6,1
SBI87PNZ4162214,88,26,17,9,1
SBI22IEL8864987,71,23,16,7,1
SBI63HNJ8777851,83,13,11,2,1
SBI31TSV6222642,86,23,18,5,1
SBI79NNI9735836,68,28,25,3,1
SBI00TDM7972787,21,22,17,5,1
SBI99DSN6194158,78,18,14,4,1
SBI72FJH8573863,18,28,18,10,1
SBI24YFA6338455,25,28,24,4,1
SBI42RZH5916008,95,19,14,5,1
SBI54TCG4065028,95,25,18,7,1
SBI55GEU7377702,89,19,10,9,1
SBI79TNE3917491,86,26,18,8,1
SBI66KFE6090394,80,25,17,8,1
SBI34OJP3703316,65,22,21,1,1
SBI33MNF0003435,92,24,14,10,1
SBI13JYJ3755311,61,24,15,9,1
SBI51ANT8313174,89,28,27,1,1
SBI46JZM7085857,73,19,16,3,1
SBI85XXG7788392,18,20,11,9,1
SBI37XTQ5152755,94,24,23,1,1
SBI30HWV1834938,85,24,20,4,1
SBI42BEH3795940,96,24,14,10,1
SBI25UVT7265547,76,27,16,11,1
SBI17KTP5116514,84,33,31,2,1
SBI84AWR8813234,73,23,16,7,1
SBI79EXN7839233,19,28,27,1,1
SBI12ZKC5829361,19,31,19,12,1
SBI16AKD2767660,75,31,29,2,1
SBI08AIO5368581,22,22,15,7,1
SBI79VZN8288666,77,29,19,10,1
SBI13HZU4151834,18,27,19,8,1
SBI66FUE4058022,73,31,24,7,1
SBI13JPQ9296898,71,33,27,6,1
SBI52LNV6788145,20,24,17,7,1
SBI21LHU0017746,60,18,17,1,1
SBI07JAH3958254,93,24,13,11,1
SBI78BUO4767283,86,21,18,3,1
SBI38FPA5025254,66,31,24,7,1
SBI62KNF3166820,60,29,21,8,1
SBI02OZM1278519,69,38,35,3,1
SBI23UZZ9257781,64,32,25,7,1
SBI03WDH0582317,96,24,15,9,1
SBI69DJV3712057,88,20,11,9,1
SBI44XFK8375816,71,23,18,5,1
SBI21OBH4492180,93,20,13,7,1
SBI60BIR1605344,25,27,18,9,1
SBI74REE1447938,93,19,14,5,1
SBI47NTV0448594,99,25,23,2,1
SBI06QKH7186700,70,26,18,8,1
SBI55JRK8120859,97,25,21,4,1
SBI86FJV1338369,69,36,20,16,1
SBI92JDX1701417,99,29,25,4,1
SBI73DKH3001855,64,29,21,8,1
SBI14RJN1379267,62,25,17,8,1
SBI81HFY8455345,80,16,12,4,1
SBI19CIT9134046,73,34,33,1,1
SBI81LGU2970209,93,22,21,1,1
SBI65MBB6919899,94,26,15,11,1
SBI60RTX8857423,24,28,23,5,1
SBI18ZPW5574041,97,20,15,5,1
SBI33WNC8730307,64,23,15,8,1
SBI29QGJ2269158,70,25,23,2,1
SBI64XFK5403674,90,32,22,10,1
SBI74EVQ6085187,72,24,21,3,1
SBI67MGT1827025,70,21,14,7,1
SBI81PJV4125563,72,29,27,2,1
SBI22HMO9922905,25,18,15,3,1
SBI02QFE5714039,89,34,25,9,1
SBI33PFN9434327,91,19,11,8,1
SBI74YFN7769404,85,22,15,7,1
SBI76ZOW0070518,24,21,17,4,1
SBI96XYL8433743,63,27,17,10,1
SBI43JNI4187060,22,24,23,1,1
SBI73XVP4577415,93,25,16,9,1
SBI90QVR5896141,79,25,18,7,1
SBI33ETX9492889,79,11,6,5,1
SBI10GZL2583665,83,23,15,8,1
SBI99MSK6638192,70,32,21,11,1
SBI41REE0937111,91,26,16,10,1
SBI26ZON8902692,71,18,14,4,1
SBI93PCV4379877,72,30,29,1,1
SBI53DCN9687638,70,28,15,13,1
SBI51AVM0818480,83,22,20,2,1
SBI19EJO6289709,83,26,22,4,1
SBI56MNC7894358,92,24,21,3,1
SBI65KLH6875501,95,31,26,5,1
SBI25AJU8488222,98,26,16,10,1
SBI94UQY6064416,69,27,15,12,1
SBI12QHQ8503172,75,18,13,5,1
SBI63IET6284365,99,29,25,4,1
SBI33RZC5759502,72,20,17,3,1
SBI04CJU0110504,86,28,15,13,1
SBI89CAD2656033,79,17,13,4,1
SBI00STI7221460,21,21,19,2,1
SBI04SJJ7261769,18,32,28,4,1
SBI95CGM5666908,25,25,23,2,1
SBI01KXJ0354759,19,25,23,2,1
SBI98XOI4599560,70,22,18,4,1
SBI02UNW0863945,84,32,20,12,1
SBI59UCE5345553,20,30,18,12,1
SBI51VQA3800870,96,17,13,4,1
SBI93EFB2962493,76,22,18,4,1
SBI05QYU2115104,66,25,21,4,1
SBI24GDP3169574,63,29,25,4,1
SBI41ICG6116941,67,24,13,11,1
SBI30OXH3682955,24,17,12,5,1
SBI02USG9836573,22,23,19,4,1
SBI32JEZ1628920,83,22,12,10,1
SBI08PZC8684945,73,21,19,2,1
SBI63NCN0162753,92,23,15,8,1
SBI02VTD1443485,24,20,12,8,1
SBI98BFH0158476,68,19,14,5,1
SBI73YDU5569447,25,20,12,8,1
SBI82SEI1287418,65,28,24,4,1
SBI26JIF8935849,92,27,15,12,1
SBI76YWO0639505,20,26,14,12,1
SBI62LJT0826494,96,24,23,1,1
SBI64DRN9617911,99,33,20,13,1
SBI34WEL7910042,80,24,14,10,1
SBI86RIR7242024,61,28,15,13,1
SBI90CPG7904937,78,21,18,3,1
SBI38VTQ6587797,70,20,16,4,1
SBI98QUW8453712,20,25,17,8,1
SBI01ZPA6321985,91,24,18,6,1
SBI17OIJ7923117,67,20,11,9,1
SBI17FAD2248716,84,22,18,4,1
SBI27OOH6190693,81,21,20,1,1
SBI84EZC0883904,94,33,23,10,1
SBI33SGE3357476,85,26,14,12,1
SBI81RJZ5052117,19,21,17,4,1
SBI75XLJ4833957,21,26,21,5,1
SBI98XJS6736869,97,35,19,16,1
SBI31BHM3430036,78,28,21,7,1
SBI71ZNI7363343,22,25,16,9,1
SBI94PSL8137467,99,23,21,2,1
SBI93MLY3292204,75,22,20,2,1
SBI07NRU9908211,63,25,19,6,1
SBI93CNU3128178,87,16,15,1,1
SBI27SJM3384925,84,24,22,2,1
SBI83OUY0438190,85,14,10,4,1
SBI72KMU8634245,21,18,10,8,1
SBI59ZLP3809330,24,31,29,2,1
SBI25SRP6628185,94,28,19,9,1
SBI29FHJ3620466,23,22,17,5,1
SBI62GOF8458332,25,26,15,11,1
SBI20DQZ1501313,22,20,19,1,1
SBI69ZCB0867490,61,17,10,7,1
SBI49DZV5338890,97,34,26,8,1
SBI46UNL2378322,78,27,26,1,1
SBI01TUQ1178349,21,16,15,1,1
SBI39XJD3265449,95,27,18,9,1
SBI79LGF4818156,21,24,21,3,1
SBI57RWE3906350,98,22,17,5,1
SBI63DHL3884109,84,24,21,3,1
SBI85AMI5304264,19,29,21,8,1
SBI62USI4835324,21,31,16,15,1
SBI13VDQ0599052,87,30,23,7,1
SBI59LTO6453474,97,23,15,8,1
SBI06RYR4191583,25,31,30,1,1
SBI18MNB8557709,78,16,11,5,1
SBI35BZF9898286,72,22,21,1,1
SBI44OGY4024113,80,24,18,6,1
SBI80ATC8225553,64,24,21,3,1
SBI95JKK2139217,81,26,21,5,1
SBI29ICG6088926,99,26,15,11,1
SBI54WES7511506,95,28,17,11,1
SBI80DCT5658701,98,37,31,6,1
SBI57JBD3421004,19,29,16,13,1
SBI12BJI2439126,73,27,23,4,1
SBI21QDH6885341,62,23,14,9,1
SBI34PZS9079494,71,14,12,2,1
SBI25SRK8142541,63,27,18,9,1
SBI21FES9157516,67,29,19,10,1
SBI82LOU6415859,85,24,13,11,1
SBI48ADD6918163,88,25,15,10,1
SBI87XFF0125124,76,23,21,2,1
SBI77ZAJ4348763,98,28,15,13,1
SBI72VRF4537979,90,28,25,3,1
SBI82CXJ3068148,69,23,22,1,1
SBI64GOS3754107,89,27,24,3,1
SBI78AXK5255017,68,34,28,6,1
SBI56BPT8758770,77,25,18,7,1
SBI57DKZ7525670,83,22,13,9,1
SBI70XPQ7915499,22,29,27,2,1
SBI90XWJ2180359,94,22,15,7,1
SBI58WKF8728630,88,26,24,2,1
SBI94EDG7342637,87,16,10,6,1
SBI39QMN6189714,64,31,20,11,1
SBI92VIY2198967,21,29,24,5,1
SBI43YCO3420147,23,25,24,1,1
SBI27LFU0528189,64,21,11,10,1
SBI17PCM4156597,74,26,19,7,1
SBI53ZRN4326230,83,24,17,7,1
SBI65AHX9881481,99,23,16,7,1
SBI41ZWD0043237,69,30,26,4,1
SBI59RDJ0612061,80,31,28,3,1
SBI53SRN8027687,96,31,23,8,1
SBI64AMJ2855163,66,19,15,4,1
SBI83UGY8056292,89,24,13,11,1
SBI41JNE9270191,77,26,14,12,1
SBI92KUW6468975,71,18,16,2,1
SBI96PIR6991104,86,20,19,1,1
SBI76BRE2517205,98,25,21,4,1
SBI81FLB9602363,18,35,20,15,1
SBI12BKX2634879,91,30,29,1,1
SBI57RDM0517185,96,25,24,1,1
SBI71EXW3108293,63,22,21,1,1
SBI85BLZ8245815,61,28,22,6,1
SBI24QER0185495,99,33,19,14,1
SBI01MNP9774657,79,27,22,5,1
SBI98EXP6739699,68,25,15,10,1
SBI21CHB0914300,62,26,23,3,1
SBI72DMY2450965,77,24,13,11,1
SBI83HAO4510838,19,25,20,5,1
SBI71PCN9032300,83,25,14,11,1
SBI45IET6306821,62,28,25,3,1
SBI14HAF3260741,91,28,15,13,1
SBI67LAO7210120,64,31,23,8,1
SBI48JYX7333563,71,29,28,1,1
SBI55FMI4873032,25,30,26,4,1
SBI80JQP2389625,60,25,20,5,1
SBI57OOG6284018,62,27,15,12,1
SBI59RIG7726723,64,28,19,9,1
SBI61SZI6722679,86,24,14,10,1
SBI09BHQ2592692,76,24,17,7,1
SBI61WXN2712439,93,24,15,9,1
SBI95NFM0311182,20,26,23,3,1
SBI83MIC1722667,81,29,19,10,1
SBI85EMQ2014079,87,23,22,1,1
SBI54XAC7323766,93,25,16,9,1
SBI01NEE0169666,91,23,15,8,1
SBI68QWN4197267,80,23,18,5,1
SBI62QYQ2626807,62,24,15,9,1
SBI31JPP0516420,78,28,17,11,1
SBI66DQK4954410,89,21,18,3,1
SBI10XGK5767482,71,27,14,13,1
SBI79TIN4896280,93,16,13,3,1
SBI49XIR0001458,79,26,21,5,1
SBI70ENT8505096,68,25,13,12,1
SBI35SEQ2907372,86,32,20,12,1
SBI84BDM3604865,73,14,9,5,1
SBI25SDL2747387,94,23,16,7,1
SBI22WTA8225408,60,18,11,7,1
SBI21NPL2419487,86,30,25,5,1
SBI04YLR9649802,81,18,11,7,1
SBI21RCP5839301,77,31,17,14,1
SBI29DUA2957269,83,25,14,11,1
SBI83VZN6360240,81,24,18,6,1
SBI91AWG7322721,61,16,10,6,1
SBI61VDX4920880,80,31,29,2,1
SBI65MJG6317738,77,17,15,2,1
SBI44VMT2316009,84,15,8,7,1
SBI26XWS0699341,80,26,19,7,1
SBI90SUV5991718,92,18,10,8,1
SBI92IGJ4482352,23,25,15,10,1
SBI07ERY0813738,69,23,21,2,1
SBI90KRA4567961,97,28,19,9,1
SBI39SAH1632952,79,25,18,7,1
SBI41RWV9778105,75,22,21,1,1
SBI47RQO0579407,76,22,18,4,1
SBI27RMB1568970,19,21,16,5,1
SBI06TQK4650181,62,32,17,15,1
SBI87GMK6359905,60,27,25,2,1
SBI18QFN7948625,18,19,12,7,1
SBI47PSO5528747,78,22,20,2,1
SBI84ESU4476608,20,28,19,9,1
SBI77HWC6462535,61,22,15,7,1
SBI70XOP1248020,24,19,12,7,1
SBI32RPS8856696,73,25,13,12,1
SBI23DDA3647089,89,22,20,2,1
SBI21XUR0000502,80,20,13,7,1
SBI65PFD2047208,18,23,17,6,1
SBI57TMN2596242,81,20,18,2,1
SBI54GNE9557473,89,22,21,1,1
SBI23BNY5506060,72,23,14,9,1
SBI96PDP7074885,87,19,14,5,1
SBI13LFY3487032,83,37,32,5,1
SBI74UMZ4811151,72,29,20,9,1
SBI85FJP9455833,20,26,23,3,1
SBI80WFU6386489,75,36,27,9,1
SBI55JRG5901072,87,22,15,7,1
SBI53BEO9458984,99,20,13,7,1
SBI87SDZ5316450,61,21,16,5,1
SBI21JHO6311110,20,22,21,1,1
SBI97ESG5008878,81,26,23,3,1
SBI95INV2941944,86,27,16,11,1
SBI24QZC4680254,20,16,14,2,1
SBI44HKA6814704,62,25,17,8,1
SBI09FIL7416080,85,31,20,11,1
SBI63NRM2318574,92,27,19,8,1
SBI60VAP7045728,63,25,24,1,1
SBI93NNX7017412,79,15,14,1,1
SBI91YZW0739067,99,24,17,7,1
SBI49QUL7040010,78,32,28,4,1
SBI48UIA5642978,23,28,24,4,1
SBI50JIY7395670,97,18,14,4,1
SBI25NNO7696933,20,33,28,5,1
SBI94WOL9965610,81,30,20,10,1
SBI94FTW4638943,21,28,23,5,1
SBI44LOD3791839,62,26,23,3,1
SBI03WTV4297940,18,19,11,8,1
SBI21TMZ8027533,18,35,34,1,1
SBI63MLM4747155,85,21,18,3,1
SBI57BTQ3364666,70,29,27,2,1
SBI40WMP5808465,68,25,17,8,1
SBI41HSJ3460738,70,28,21,7,1
SBI86ZPH4961338,81,28,24,4,1
SBI65RXD3617782,89,24,14,10,1
SBI42YOW8889351,85,17,11,6,1
SBI55BPW2542609,87,26,22,4,1
SBI66IOF1568432,21,34,21,13,1
SBI23URH0358848,83,18,10,8,1
SBI28DON1666814,89,30,23,7,1
SBI10NHH8151889,71,23,20,3,1
SBI64ZZZ8416060,77,20,13,7,1
SBI77KOV2035075,77,21,16,5,1
SBI76CEM8042784,97,33,29,4,1
SBI92HJX7143413,61,28,16,12,1
SBI84DZC0115869,63,21,18,3,1
SBI03EUP9499856,71,25,13,12,1
SBI68NTF1483033,98,17,10,7,1
SBI86EBL1734120,61,21,17,4,1
SBI94IDN5177964,91,39,23,16,1
SBI28LHO5144598,90,33,19,14,1
SBI39MOD0577183,65,29,18,11,1
SBI66OTM2472298,61,31,16,15,1
SBI98ILS1212422,77,28,25,3,1
SBI86DSO4015232,60,22,13,9,1
SBI05ZQL0485772,95,28,16,12,1
SBI67SLK1956413,80,26,25,1,1
SBI11EPP3531497,24,22,17,5,1
SBI56HWT2320597,72,21,17,4,1
SBI12HAQ7485344,89,32,28,4,1
SBI18OOP2972152,67,25,22,3,1
SBI49VGO0421491,67,23,13,10,1
SBI76QRQ1619481,93,25,16,9,1
SBI84PKA7055430,92,17,12,5,1
SBI49DDZ7819555,98,34,19,15,1
SBI83IUT7678402,97,31,29,2,1
SBI74KPZ3554249,68,25,17,8,1
SBI62VWB0656318,19,20,15,5,1
SBI54BTW8329711,67,30,18,12,1
SBI52XQP4209614,74,36,20,16,1
SBI05VJX0471106,95,22,18,4,1
SBI28VHS1483940,91,25,24,1,1
SBI04IOM1430271,78,23,17,6,1
SBI47IKP2365808,19,32,27,5,1
SBI71QYK6314977,62,19,10,9,1
SBI73TDR7659318,22,29,17,12,1
SBI82SOZ4244051,72,21,15,6,1
SBI15ERO9777648,97,17,13,4,1
SBI54CWN3826113,83,23,12,11,1
SBI94HEP9810335,96,28,16,12,1
SBI44NCZ2988507,68,27,19,8,1
SBI79XSW4341914,23,24,13,11,1
SBI38MFD5252669,99,29,24,5,1
SBI79ZYU2895242,83,23,18,5,1
SBI21SYN5075734,92,29,15,14,1
SBI69AFY8979109,62,15,12,3,1
SBI65GJF1934708,86,23,19,4,1
SBI50EYK7540505,90,26,17,9,1
SBI42JWK1709745,74,27,20,7,1
SBI30REX0694041,94,18,10,8,1
SBI44XYO0164272,80,26,18,8,1
SBI33RAD4299731,71,32,23,9,1
SBI83AZB1620680,90,28,17,11,1
SBI42ZHZ5682069,87,27,21,6,1
SBI96FPY0825652,66,28,17,11,1
SBI86HZR9313305,97,27,21,6,1
SBI53MQB1212567,88,24,20,4,1
SBI89SST2865250,95,17,10,7,1
SBI71IGC6278306,85,28,23,5,1
SBI61BQH8255652,92,28,15,13,1
SBI54CPV9177035,18,24,13,11,1
SBI14PSL3589243,81,30,26,4,1
SBI02WIZ9513119,76,25,21,4,1
SBI33HVT8701729,21,26,18,8,1
SBI72JGT0879809,69,28,17,11,1
SBI96EZP9153283,60,24,19,5,1
SBI03KBE1979255,21,25,23,2,1
SBI10HFK3761931,62,32,31,1,1
SBI24HSF2616981,92,18,16,2,1
SBI41BRZ4747358,79,19,16,3,1
SBI93XTX0555155,62,27,22,5,1
SBI27XPS8141593,94,26,14,12,1
SBI74NIA3715472,71,30,23,7,1
SBI47XSH8453006,88,23,13,10,1
SBI25MLJ7688675,86,29,19,10,1
SBI70YAF5799452,89,21,11,10,1
SBI74YUB9581953,71,24,20,4,1
SBI76CWP3791446,22,25,13,12,1
SBI25KHH7805126,84,31,19,12,1
SBI34OSZ9346168,91,24,17,7,1
SBI52IKC1353703,85,29,21,8,1
SBI58ZRE8244050,76,18,10,8,1
SBI84JKF2418090,23,31,28,3,1
SBI98DRX9886043,90,23,13,10,1
SBI95XLA3817069,67,27,26,1,1
SBI44KXV9885208,95,35,22,13,1
SBI57KPB3428107,68,31,27,4,1
SBI79RBF5773203,82,24,14,10,1
SBI61KEQ4641261,80,32,26,6,1
SBI26FNP9179517,74,25,24,1,1
SBI53DLF6851100,73,39,27,12,1
SBI72JKB9306538,64,23,21,2,1
SBI19HHH9196004,73,20,19,1,1
SBI38RVS6655410,75,26,18,8,1
SBI13ZAK1603251,95,25,17,8,1
SBI58CUQ4549563,66,20,16,4,1
SBI11WSO0582551,79,30,27,3,1
SBI98KMG4549212,78,34,27,7,1
SBI11XTF2785501,61,17,13,4,1
SBI49GFN7820588,22,21,13,8,1
SBI95IOI6340515,74,24,21,3,1
SBI21EWX3953286,87,28,20,8,1
SBI77HCL1201605,76,19,12,7,1
SBI82HPI5513277,82,24,17,7,1
SBI41QRC0073678,65,23,13,10,1
SBI50XAX3009038,60,24,23,1,1
SBI97EQM8429640,98,17,15,2,1
SBI97JEJ2823900,85,38,30,8,1
SBI34PAN8291633,71,20,17,3,1
SBI21ZXV9174628,21,22,15,7,1
SBI02ACK1897116,91,28,25,3,1
SBI18AWH5377392,77,26,25,1,1
SBI56ZBT5253645,91,30,29,1,1
SBI34PNX2193474,91,19,10,9,1
SBI53GRZ1802529,67,11,9,2,1
SBI73LMP5413094,65,24,17,7,1
SBI35ZKZ6180586,90,24,18,6,1
SBI89DLQ7512310,90,24,19,5,1
SBI88GPF1291905,67,24,22,2,1
SBI37MJR1325043,93,17,12,5,1
SBI88ITG3726521,64,25,17,8,1
SBI47XGP3545167,21,36,20,16,1
SBI47QZH3832366,64,22,21,1,1
SBI38IPF4250452,88,26,23,3,1
SBI05NDM5347805,73,23,22,1,1
SBI97EGE4623159,61,30,22,8,1
SBI92TYM9514295,90,25,23,2,1
SBI88DAP1111842,85,23,12,11,1
SBI83MBI3367498,96,17,14,3,1
SBI70OTU5951398,66,27,19,8,1
SBI72YMC1236395,96,25,23,2,1
SBI60NZS0206253,72,16,15,1,1
SBI36FIT7242378,68,19,14,5,1
SBI75NNO7543126,73,22,15,7,1
SBI51FKP7841757,71,25,15,10,1
SBI34RQP1893809,82,29,25,4,1
SBI00UGF7163412,75,25,17,8,1
SBI52QBN7210185,21,29,28,1,1
SBI10QIC7061118,90,27,20,7,1
SBI40CDH0830696,77,25,14,11,1
SBI98QLY5277350,88,29,16,13,1
SBI35HHB6534126,98,16,10,6,1
SBI53IPL2526825,24,28,22,6,1
SBI51YAP8531788,79,29,16,13,1
SBI76RIJ0402533,88,26,18,8,1
SBI69ANW5723431,84,20,12,8,1
SBI77ULK3477945,63,7,6,1,1
SBI99WGO1578360,77,20,17,3,1
SBI25TBS2379408,88,30,18,12,1
SBI94ZOD9764745,97,31,26,5,1
SBI04TGA9684940,25,32,31,1,1
SBI36ZRV0485149,21,28,18,10,1
SBI86CED2853282,88,27,26,1,1
SBI65FZX2445561,22,24,23,1,1
SBI07JHR3847407,95,21,12,9,1
SBI53ICZ1761342,83,31,26,5,1
SBI18AYL1424462,97,23,17,6,1
SBI64WTM6981677,22,17,14,3,1
SBI02UEB0868418,86,32,17,15,1
SBI56SYO6315186,71,22,19,3,1
SBI19KKY7226302,20,25,19,6,1
SBI96IYM0161891,23,14,12,2,1
SBI00IAV8629492,73,13,9,4,1
SBI79HMI2306087,22,21,14,7,1
SBI32WXU0474664,61,28,15,13,1
SBI27UFR9887646,73,12,9,3,1
SBI53VZF4448156,82,27,22,5,1
SBI83DGU9659092,64,17,9,8,1
SBI84BGN2465766,24,23,13,10,1
SBI15ROU1028042,73,16,12,4,1
SBI76PEC0824475,93,28,27,1,1
SBI26LQP6409175,90,27,20,7,1
SBI81HNN1241216,21,33,26,7,1
SBI83DIZ1033964,87,28,15,13,1
SBI20GKL7622220,68,24,18,6,1
SBI36ONO5539628,86,24,23,1,1
SBI01BMH1593083,78,37,24,13,1
SBI64GPC9678160,95,27,15,12,1
SBI51XOE1458615,79,21,14,7,1
SBI72SGO7236000,69,33,29,4,1
SBI40WCO4901604,92,22,15,7,1
SBI86EJY6085357,85,22,19,3,1
SBI86CSV8255660,81,16,15,1,1
SBI07ZGO5690076,25,29,25,4,1
SBI52QQD0138218,99,14,8,6,1
SBI07WXQ8546387,77,33,24,9,1
SBI42SFQ0727110,81,30,22,8,1
SBI27PNH0800163,23,26,19,7,1
SBI98IOR8011467,93,26,23,3,1
SBI04QLB2112329,23,24,13,11,1
SBI75ERV7970708,88,21,20,1,1
SBI84YAL1003257,24,21,16,5,1
SBI37NFD0520911,74,22,17,5,1
SBI66QQP4965289,89,28,18,10,1
SBI75MCI7910711,82,27,24,3,1
SBI04AGG6265591,88,31,16,15,1
SBI61LRZ0644469,71,28,22,6,1
SBI46QFG8693305,78,26,18,8,1
SBI15XDF7846642,25,29,20,9,1
SBI35ZUP8597996,61,27,19,8,1
SBI02XEO5111448,60,25,15,10,1
SBI70JOH0200495,23,21,17,4,1
SBI50CRT9989462,62,20,17,3,1
SBI69PFT9769087,85,28,19,9,1
SBI49GLS8490388,81,13,12,1,1
SBI57HNG9815109,78,22,18,4,1
SBI06HQE2016392,92,25,19,6,1
SBI00SKW6414646,90,36,28,8,1
SBI99JLM7691838,62,25,18,7,1
SBI07KVJ1480934,96,21,17,4,1
SBI68EDZ6732403,95,26,23,3,1
SBI16KKJ6140507,76,24,13,11,1
SBI49QIN2695143,72,23,13,10,1
SBI89REO8622519,84,17,11,6,1
SBI33YGL9726668,77,29,18,11,1
SBI70AVK7854528,19,29,16,13,1
SBI92XTU4147191,89,33,20,13,1
SBI14TJY8257277,70,35,21,14,1
SBI79CCQ0083579,77,21,16,5,1
SBI93HOL0762462,81,26,25,1,1
SBI21FPE8370520,67,15,8,7,1
SBI34MIJ4962648,24,28,20,8,1
SBI03WFC3322835,60,19,12,7,1
SBI51CTR0935312,88,22,21,1,1
SBI47EPD0827296,68,25,13,12,1
SBI60BMB1895918,77,21,12,9,1
SBI05XRI6933582,84,24,19,5,1
SBI92NJK5207589,61,26,15,11,1
SBI65LHW2712651,70,27,20,7,1
SBI74WKY3507460,65,22,14,8,1
SBI53MNY2030765,88,27,16,11,1
SBI46WHB5722393,70,32,27,5,1
SBI64GZL9899632,98,25,21,4,1
SBI82TNW0884598,71,25,16,9,1
SBI97OPS2149830,83,21,11,10,1
SBI71KSV2663393,63,33,20,13,1
SBI38CYB5262255,83,27,25,2,1
SBI11NTG9067599,81,27,20,7,1
SBI15IDA6661403,19,25,14,11,1
SBI43KIF2902577,68,29,23,6,1
SBI22PRM2610903,25,19,10,9,1
SBI44AXZ1998683,94,25,17,8,1
SBI37WVH4167603,89,20,13,7,1
SBI87VUT2717709,92,34,20,14,1
SBI01WQN0315070,88,35,23,12,1
SBI29WXY0531953,68,21,13,8,1
SBI47ZWV4052964,18,34,20,14,1
SBI46LQF5217563,99,18,13,5,1
SBI50CET0307302,62,27,22,5,1
SBI93CZX5099318,65,25,16,9,1
SBI99RND3841432,97,27,25,2,1
SBI19VTD6623695,95,32,23,9,1
SBI99PIW3952796,98,28,27,1,1
SBI80JPD0060642,99,19,11,8,1
SBI81MPH6027263,85,27,24,3,1
SBI27EJI1699057,72,28,24,4,1
SBI99WJD1816808,74,27,21,6,1
SBI68OUO9681083,94,37,24,13,1
SBI51BMV5528526,94,18,11,7,1
SBI26LRN4095272,92,30,19,11,1
SBI21FPY7958760,92,25,15,10,1
SBI05QPM8028634,65,37,19,18,1
SBI84XHH1704687,64,27,21,6,1
SBI19ZHJ0696122,90,19,17,2,1
SBI34OGS5867862,97,28,15,13,1
SBI07NKA3704561,89,26,24,2,1
SBI21NMP9876826,97,30,18,12,1
SBI51EGE0805524,92,27,16,11,1
SBI70SHQ3714042,77,22,18,4,1
SBI05SWT5554838,22,13,12,1,1
SBI31NYE0103854,81,20,19,1,1
SBI94NMS2275260,99,25,17,8,1
SBI46LTT0066871,21,18,11,7,1
SBI90RGD8147778,70,34,21,13,1
SBI25EKR6433252,78,19,15,4,1
SBI23YDW2179369,25,30,23,7,1
SBI43YAG7126795,63,25,16,9,1
SBI12OAW9387296,78,31,18,13,1
SBI28LAE1581020,85,25,23,2,1
SBI76RTD9217499,77,24,22,2,1
SBI62BQJ5603950,70,30,17,13,1
SBI12UNT5688355,81,22,19,3,1
SBI75ISI0114929,61,27,15,12,1
SBI26ZNR6027605,65,23,18,5,1
SBI39BZO0962485,23,19,14,5,1
SBI32MZI3875416,74,22,21,1,1
SBI09FNO6358737,87,28,22,6,1
SBI30MXI1007982,90,23,22,1,1
SBI67ZCQ6439783,24,17,13,4,1
SBI06PWN8011686,94,30,22,8,1
SBI53FMK0896265,91,26,25,1,1
SBI37NET4337787,82,23,17,6,1
SBI29AYW5760314,18,24,22,2,1
SBI27XGG0032413,71,25,18,7,1
SBI09CFY1025287,20,24,16,8,1
SBI80FJN8732163,75,26,16,10,1
SBI85LRI0682609,78,17,14,3,1
SBI93BJS3475771,96,20,19,1,1
SBI88RBT4066309,92,29,17,12,1
SBI97JEH4973759,83,21,20,1,1
SBI43GMV4932515,21,35,27,8,1
SBI35IIR6020843,94,23,17,6,1
SBI11TZY8027324,86,17,16,1,1
SBI83BRD2205906,82,27,26,1,1
SBI91ANJ4135103,86,22,15,7,1
SBI24UOA0175000,92,23,12,11,1
SBI40XIR5440393,96,25,19,6,1
SBI25LGK6406095,83,31,30,1,1
SBI57CEO5185406,70,22,15,7,1
SBI20JYB3637653,84,25,24,1,1
SBI93SYJ6063264,84,30,17,13,1
SBI68WQG2451235,94,22,16,6,1
SBI26EOT6131976,99,20,19,1,1
SBI89YDQ1042076,72,21,12,9,1
SBI07IWG7788130,21,27,18,9,1
SBI23KKU7790528,67,24,16,8,1
SBI02EYU8594491,85,17,9,8,1
SBI11ZVN5809481,68,18,16,2,1
SBI26IEJ5334672,22,22,17,5,1
SBI36VJO3865730,69,17,13,4,1
SBI15BRA1051888,97,23,12,11,1
SBI78GJT5547410,71,27,21,6,1
SBI39SQU1301918,86,32,22,10,1
SBI82LOG8596397,81,28,18,10,1
SBI38COM9423586,90,23,17,6,1
SBI07BTD7457639,65,30,19,11,1
SBI45ZCJ4899218,62,27,23,4,1
SBI63LUT1118005,98,19,11,8,1
SBI75FAE3020191,62,27,21,6,1
SBI32QMD5698385,74,22,12,10,1
SBI97XSN9328713,73,19,15,4,1
SBI76BFQ7688124,93,22,15,7,1
SBI22XAZ5721692,98,27,17,10,1
SBI56GVW8326974,71,24,23,1,1
SBI04TTJ0643895,77,24,19,5,1
SBI94USY9907497,87,23,12,11,1
SBI92THY8237003,97,23,19,4,1
SBI00DXT2339374,93,24,23,1,1
SBI68SBT6941316,75,31,27,4,1
SBI04DAM7318711,80,34,25,9,1
SBI80PQL0311588,21,23,13,10,1
SBI45WTB6702271,64,31,20,11,1
SBI56BDO2952120,65,25,21,4,1
SBI74AMK7296641,20,23,16,7,1
SBI74KKX2204715,24,26,17,9,1
SBI24LXO4408417,95,30,20,10,1
SBI11BPP5492583,99,24,16,8,1
SBI13UYQ3686580,77,33,27,6,1
SBI90IIV9494690,73,16,13,3,1
SBI40WQO0204222,22,24,13,11,1
SBI97ZXI8565688,23,32,21,11,1
SBI68HJL4159341,93,15,8,7,1
SBI28SJR6390588,90,28,20,8,1
SBI07NBX6731200,66,24,17,7,1
SBI70MZH7104285,20,19,13,6,1
SBI59KLJ1252603,81,24,18,6,1
SBI33TZE7932427,19,31,26,5,1
SBI08RPH4390970,92,14,8,6,1
SBI33TUB2084275,21,30,19,11,1
SBI28SPM8415583,19,19,13,6,1
SBI94HKI0666276,74,20,14,6,1
SBI54MXC5754146,75,24,13,11,1
SBI80TOD6349324,84,17,16,1,1
SBI49WWH0170832,21,34,20,14,1
SBI30XXW0967206,67,21,16,5,1
SBI38QND4917837,79,29,19,10,1
SBI56JNW8167684,60,24,22,2,1
SBI08FUK6925854,86,31,20,11,1
SBI93LEZ7339513,63,22,14,8,1
SBI81OLY6908772,78,25,15,10,1
SBI48FFH4305744,86,21,13,8,1
SBI49DAW7932593,63,21,12,9,1
SBI59VXM8302959,90,24,19,5,1
SBI11THS5394831,73,21,17,4,1
SBI38KJS6929527,19,29,15,14,1
SBI89XLB7899337,21,27,14,13,1
SBI99VOB7572745,24,18,14,4,1
SBI06KUH8958682,96,31,16,15,1
SBI97CUN9441488,83,24,16,8,1
SBI08VEO1816891,75,22,16,6,1
SBI83FTM7503813,70,27,17,10,1
SBI40ZLM9828361,91,23,14,9,1
SBI13QQJ2999313,66,22,20,2,1
SBI52XTF3271803,77,20,18,2,1
SBI26TPE7635390,80,25,18,7,1
SBI56MRI1666849,80,30,19,11,1
SBI28LBW3634091,79,35,33,2,1
SBI02ZFJ6406028,85,30,27,3,1
SBI07CCH7534830,87,27,19,8,1
SBI94PAQ7043215,78,24,22,2,1
SBI52JBP8966129,18,19,16,3,1
SBI61IDP6987491,71,37,24,13,1
SBI58MLT8828868,99,17,13,4,1
SBI83GYR7867902,62,30,20,10,1
SBI06ZXI1141796,25,26,22,4,1
SBI41ZEL4032437,64,25,21,4,1
SBI67ZHG8011736,22,26,15,11,1
SBI92KQL6335192,81,28,19,9,1
SBI36AQT9729618,79,25,17,8,1
SBI16OQR7431492,25,22,13,9,1
SBI70DNB0932734,22,26,22,4,1
SBI06DBP2055057,22,16,10,6,1
SBI72SPQ4398196,77,23,19,4,1
SBI90RDL9416189,95,23,20,3,1
SBI70VGK3845919,85,30,25,5,1
SBI60FOF2236147,61,32,29,3,1
SBI42FHZ5777641,79,22,18,4,1
SBI83XFS7701118,86,29,28,1,1
SBI06XQO4839740,70,19,18,1,1
SBI22DZG9132616,98,25,18,7,1
SBI23SWV2634032,74,31,28,3,1
SBI28MRK8278235,24,21,16,5,1
SBI14HRI0419500,18,24,23,1,1
SBI20DHP7492896,85,24,21,3,1
SBI60QXU6591432,18,28,15,13,1
SBI88JQX2786931,20,19,11,8,1
SBI15ZLV0435222,99,23,14,9,1
SBI03TJG1216914,23,21,18,3,1
SBI01OCZ7729473,21,34,28,6,1
SBI20KLC5801794,85,16,11,5,1
SBI35EGB0232550,65,22,12,10,1
SBI46AAG8481753,69,30,20,10,1
SBI92JXM3544687,83,27,23,4,1
SBI26UDV0162678,18,27,24,3,1
SBI22KRI1969509,65,28,24,4,1
SBI37IUC1998639,64,30,27,3,1
SBI57ICU0053931,93,34,32,2,1
SBI21FIN2815612,61,25,14,11,1
SBI21ERH1457419,92,29,26,3,1
SBI60LUE1643110,83,21,12,9,1
SBI18YQQ5980245,79,24,15,9,1
SBI39GDY5691408,81,30,25,5,1
SBI13YXJ4897646,72,19,18,1,1
SBI99BGH3465990,98,22,15,7,1
SBI37LAA9699597,90,29,18,11,1
SBI49HOR7749443,20,27,22,5,1
SBI95BSA7298605,83,16,9,7,1
SBI25LJQ2030143,24,28,17,11,1
SBI30EFQ6713094,81,24,22,2,1
SBI47VQB0086104,22,34,22,12,1
SBI68PRA7955634,25,36,34,2,1
SBI48UWI5623655,69,24,20,4,1
SBI06RWP8917315,79,29,23,6,1
SBI67QAC7070250,61,30,17,13,1
SBI33AYH2387377,23,29,24,5,1
SBI98RFQ7754367,73,21,18,3,1
SBI11WON3301538,67,29,28,1,1
SBI15MWN1748729,95,23,17,6,1
SBI25IIS3672837,70,25,21,4,1
SBI63JKC2697171,21,29,15,14,1
SBI10KJY1642963,60,23,21,2,1
SBI42LZW0087767,90,19,11,8,1
SBI42CZC5433088,60,23,19,4,1
SBI71DEH0665141,65,24,13,11,1
SBI28BCQ3298333,91,26,20,6,1
SBI48ZWW2829805,93,24,16,8,1
SBI16GUM0103728,86,31,22,9,1
SBI73AIS1530267,73,31,27,4,1
SBI15UHK6278945,81,24,19,5,1
SBI06MGS0068473,84,27,21,6,1
SBI16URW0377471,77,24,19,5,1
SBI66WAJ2172346,66,18,10,8,1
SBI36FLV9550882,96,26,17,9,1
SBI88QAS4319315,90,22,16,6,1
SBI69VAU4366470,79,28,27,1,1
SBI97IKM0017147,64,17,16,1,1
SBI96CBF1730655,95,28,18,10,1
SBI97WAS7418937,23,21,12,9,1
SBI89BYW4454110,87,27,14,13,1
SBI57RUN7611565,66,26,25,1,1
SBI52VIW3588839,66,21,14,7,1
SBI98BPY6377360,67,28,22,6,1
SBI69BFB3636499,69,32,29,3,1
SBI18NYS3116261,83,28,27,1,1
SBI36JDS2620811,99,22,20,2,1
SBI32TFV6926721,91,28,24,4,1
SBI87EUR6532044,79,24,19,5,1
SBI34YWW3230219,90,21,16,5,1
SBI53ONH9935825,84,20,12,8,1
SBI62WAG9857500,82,29,25,4,1
SBI38HNC8331300,77,30,16,14,1
SBI60PFZ6976801,72,28,18,10,1
SBI43KBT5614634,75,22,20,2,1
SBI52PQA6024174,71,20,18,2,1
SBI80UCT3150653,79,30,22,8,1
SBI28ZEW7800920,78,17,9,8,1
SBI42EXT2468317,74,20,17,3,1
SBI75MLW8457512,77,17,13,4,1
SBI71VCQ8325294,68,32,31,1,1
SBI91OTN0448389,97,24,13,11,1
SBI78PKS9312516,64,27,14,13,1
SBI51FSR7929811,79,20,14,6,1
SBI49AKX0213066,90,26,17,9,1
SBI43DAH2374994,61,22,17,5,1
SBI02SZT8557926,65,37,33,4,1
SBI79FDM5322469,66,15,14,1,1
SBI07ZHS9780943,80,21,20,1,1
SBI69YEW2771163,18,23,12,11,1
SBI97PHC1708758,81,23,18,5,1
SBI71NDL9117659,83,25,17,8,1
SBI27FPR5410081,18,21,14,7,1
SBI90GBL8857364,75,21,15,6,1
SBI31KFB1098275,95,20,18,2,1
SBI47LHF2900286,62,18,14,4,1
SBI97NVL0858703,19,25,22,3,1
SBI59JGB1220100,24,23,17,6,1
SBI79PQA4156791,69,22,20,2,1
SBI61DQV4500609,65,23,21,2,1
SBI57XAV1875504,90,25,14,11,1
SBI17PZS4184164,88,31,19,12,1
SBI20WKS6801621,19,31,28,3,1
SBI75PUE0531229,20,22,21,1,1
SBI22YTR1476786,68,17,12,5,1
SBI01TXW7118617,72,17,14,3,1
SBI17QDW9846455,91,30,18,12,1
SBI78KAF5056622,92,19,18,1,1
SBI24HLQ9692665,91,25,24,1,1
SBI92LSZ3062880,87,20,11,9,1
SBI80GWY9669159,97,25,24,1,1
SBI81KVQ1346316,78,21,16,5,1
SBI38FGL8838879,75,19,11,8,1
SBI78KYK5419775,80,39,32,7,1
SBI19LKE4387359,60,24,21,3,1
SBI89ZFH4225676,93,26,18,8,1
SBI92UIL8206938,19,25,13,12,1
SBI21CXW1834493,61,26,17,9,1
SBI76CEG7059061,66,19,15,4,1
SBI53AEU2159199,87,21,11,10,1
SBI40MOY0144395,83,26,18,8,1
SBI65KNT5357979,24,29,19,10,1
SBI97GVO2593603,19,22,16,6,1
SBI67SVD3630958,22,16,10,6,1
SBI27IRK4828077,95,27,19,8,1
SBI22OAA8590884,74,16,15,1,1
SBI18YBZ3634738,70,26,24,2,1
SBI70KMH2188111,68,21,19,2,1
SBI06RYF3297462,24,27,22,5,1
SBI35EPY0265878,78,24,14,10,1
SBI13CGS2846145,83,19,12,7,1
SBI71DLF8365124,91,23,13,10,1
SBI07QAP0184108,78,25,21,4,1
SBI34VMP0541079,82,28,18,10,1
SBI78GMH0815780,94,30,18,12,1
SBI50ESN3813338,96,29,19,10,1
SBI29EZU0067455,72,23,20,3,1
SBI82MRL6051698,94,17,12,5,1
SBI12LAD6978415,75,24,16,8,1
SBI75JTT4434579,78,22,16,6,1
SBI26BWB7714135,24,25,16,9,1
SBI81CPT1510544,80,23,20,3,1
SBI41DAH5968573,97,19,11,8,1
SBI72DHA7655050,94,29,25,4,1
SBI93IZR0701097,64,30,20,10,1
SBI52UIK7479081,78,29,19,10,1
SBI76QVN7570290,64,19,13,6,1
SBI25IOY0156549,64,24,23,1,1
SBI01DKO6055400,95,27,18,9,1
SBI32ASB2464815,86,30,29,1,1
SBI73MOR1073325,64,30,22,8,1
SBI43MRJ5850065,18,23,21,2,1
SBI24HEW1177714,97,25,19,6,1
SBI97ECN9676673,99,25,22,3,1
SBI32VWM4381168,75,26,23,3,1
SBI23YQC3155358,69,19,12,7,1
SBI33KWS4475006,63,21,18,3,1
SBI33HNV2648588,84,25,15,10,1
SBI44BNJ8792332,78,20,14,6,1
SBI15BVR0477340,82,32,19,13,1
SBI82WQX3783128,70,21,13,8,1
SBI62BNG6616899,22,25,20,5,1
SBI54ZYD4809560,62,24,23,1,1
SBI62JZK8282298,86,30,21,9,1
SBI95HBF5058445,80,26,15,11,1
SBI40JXA2387989,61,27,22,5,1
SBI27BFC9274893,87,21,12,9,1
SBI25ENW3523860,60,26,14,12,1
SBI56SZD0404029,90,25,18,7,1
SBI41APS0101385,81,29,22,7,1
SBI98MNQ3658814,97,29,16,13,1
SBI60GKM8231436,99,29,21,8,1
SBI20CSQ1929350,62,33,25,8,1
SBI64ZSD2943381,63,26,17,9,1
SBI21YMP1117683,63,26,23,3,1
SBI54MMW9980589,85,25,17,8,1
SBI83ZYZ6351591,90,32,18,14,1
SBI15WBK2605541,75,27,21,6,1
SBI81KGW2749927,94,19,10,9,1
SBI96DQN4713230,82,33,32,1,1
SBI87UOP7176664,74,29,21,8,1
SBI44ZYC5692542,65,16,15,1,1
SBI13WJK3546937,22,22,18,4,1
SBI04CPK0764213,93,31,30,1,1
SBI00QES8463558,92,26,16,10,1
SBI98PLY4352736,76,22,13,9,1
SBI65LIU8983681,82,18,13,5,1
SBI76HUR2380991,97,20,15,5,1
SBI73JKP4885749,65,20,15,5,1
SBI44GZK6633209,89,28,15,13,1
SBI19KNO2745577,78,20,11,9,1
SBI03JNP6226727,80,17,10,7,1
SBI93RHK4485097,62,20,19,1,1
SBI20OXU5330506,99,22,12,10,1
SBI97ZFA3373021,80,23,13,10,1
SBI62LAE3352601,80,24,22,2,1
SBI66VNT4575124,61,21,12,9,1
SBI77PIN0419030,84,28,17,11,1
SBI76DLZ4064319,75,25,13,12,1
SBI79FLI3539290,82,19,12,7,1
SBI15SHH9216420,72,24,23,1,1
SBI06QND4341026,94,23,17,6,1
SBI67POV2568545,75,19,14,5,1
SBI53PHE9627997,95,26,21,5,1
SBI34BVG8772782,74,24,14,10,1
SBI33QLQ6137041,84,33,22,11,1
SBI28AAD8513868,75,23,16,7,1
SBI71WNG9942185,90,21,18,3,1
SBI98KQH4409082,66,29,26,3,1
SBI88CUX0038322,66,33,25,8,1
SBI94UWN3955803,88,26,21,5,1
SBI21DRQ0109989,99,28,18,10,1
SBI54DEU7120388,71,26,25,1,1
SBI05STG5762987,65,24,22,2,1
SBI70HTQ4744911,80,19,14,5,1
SBI65GAP2528097,78,32,25,7,1
SBI99GGF8541365,70,22,20,2,1
SBI48MPR2121148,64,23,22,1,1
SBI71RCN9769384,69,33,29,4,1
SBI85RGP0391521,92,29,26,3,1
SBI85JGP0578349,86,18,13,5,1
SBI79ZMI7869360,88,24,15,9,1
SBI63NTH7141187,80,30,28,2,1
SBI34NDU0998503,64,29,17,12,1
SBI90MSE9490370,65,23,18,5,1
SBI76NLE3798084,84,25,17,8,1
SBI07XPM3604408,87,24,19,5,1
SBI30HGL0768716,97,23,15,8,1
SBI46UZS6482097,95,32,21,11,1
SBI48VFA2189021,69,30,16,14,1
SBI15KXQ1836148,24,24,14,10,1
SBI01TBV7908743,70,18,12,6,1
SBI79UYF1571332,23,17,10,7,1
SBI82PWC4929906,61,24,14,10,1
SBI01SSM1066840,85,29,26,3,1
SBI77MDM0142548,89,28,20,8,1
SBI28TLM9445132,79,26,15,11,1
SBI83AHQ6444147,80,27,21,6,1
SBI39JTG7663093,89,23,17,6,1
SBI40RMD3585951,74,22,19,3,1
SBI04KFN4553640,24,32,17,15,1
SBI56LFK8980955,97,18,14,4,1
SBI98ABM4087725,92,21,14,7,1
SBI85BPZ6371493,93,32,20,12,1
SBI33XLV1817499,20,33,26,7,1
SBI75STW8580163,63,31,27,4,1
SBI21WQZ0850597,96,20,18,2,1
SBI42BIW5955983,70,18,17,1,1
SBI78WMQ3994046,76,29,17,12,1
SBI54NUD2068385,85,34,25,9,1
SBI10BLH4118261,84,25,20,5,1
SBI49CDR4589918,88,18,16,2,1
SBI32QOU9741004,74,27,17,10,1
SBI55OZJ2400915,88,32,31,1,1
SBI65VZV3243528,84,25,22,3,1
SBI00WQW3039671,72,32,20,12,1
SBI18LOW8420613,22,25,16,9,1
SBI64GXW2349505,75,19,17,2,1
SBI10TCL1148949,61,22,13,9,1
SBI97YDK0719212,62,27,24,3,1
SBI58OFZ3823350,75,21,13,8,1
SBI20FEY5732280,98,21,12,9,1
SBI59MNT9439108,68,29,27,2,1
SBI50VKW9701962,96,21,16,5,1
SBI84EFZ9046395,92,24,14,10,1
SBI66KVR4155576,83,28,26,2,1
SBI79EFS1189901,90,20,11,9,1
SBI92JRQ1104752,67,25,14,11,1
SBI08OGH8980187,62,32,24,8,1
SBI73XMH1913229,95,22,15,7,1
SBI13ZUC4734787,60,24,13,11,1
SBI31VKB4951454,88,21,15,6,1
SBI43HFS4650054,66,19,12,7,1
SBI71RMO6635109,81,25,23,2,1
SBI29DXV7272592,89,20,11,9,1
SBI67VZV7227218,20,26,19,7,1
SBI31RNN4877616,22,21,18,3,1
SBI71OMW4712306,78,19,13,6,1
SBI96PAX9248411,93,25,19,6,1
SBI42MOM1138228,97,26,18,8,1
SBI62ZWV1335279,63,28,20,8,1
SBI82ORU6672736,77,25,19,6,1
SBI82MZJ0489149,88,16,13,3,1
SBI13MVH6870816,92,25,15,10,1
SBI92AQX0435513,67,25,20,5,1
SBI02TLN0919040,82,16,13,3,1
SBI49FUS5516999,22,34,19,15,1
SBI40JLG0859637,94,20,16,4,1
SBI94ZDB8776841,98,26,17,9,1
SBI68FRD8698684,18,21,17,4,1
SBI55XMJ4450297,77,21,18,3,1
SBI90CEM4545036,84,23,16,7,1
SBI20AIK8286053,66,39,22,17,1
SBI54SNT9978634,96,28,21,7,1
SBI94FKJ5840630,63,18,10,8,1
SBI76QPO1008627,65,24,20,4,1
SBI14FKZ0419110,23,30,19,11,1
SBI05GWW1062366,97,16,14,2,1
SBI19VXY3253740,89,25,14,11,1
SBI42EKX7381813,78,28,26,2,1
SBI34NTG2616596,22,29,20,9,1
SBI20RWE2440366,82,28,24,4,1
SBI51ECU7023316,88,34,18,16,1
SBI26XXB8476678,75,26,24,2,1
SBI30GFD7917009,65,23,13,10,1
SBI65UJX8822342,84,22,17,5,1
SBI87FJD5051920,94,23,18,5,1
SBI93YCK9314322,68,22,20,2,1
SBI78YPS8311707,64,25,22,3,1
SBI86IUE5615680,79,24,23,1,1
SBI53OTO1658702,18,26,16,10,1
SBI78YLT3299812,91,27,23,4,1
SBI37JRE9989050,71,21,15,6,1
SBI09ZSO4319483,68,22,19,3,1
SBI05QDJ4874745,19,25,13,12,1
SBI59TBX6035975,91,26,22,4,1
SBI91HZB1296539,73,17,11,6,1
SBI41KVH7247658,22,28,19,9,1
SBI69ZFK1851412,86,21,19,2,1
SBI96GZG0980897,74,26,21,5,1
SBI57IPQ6023688,94,27,14,13,1
SBI31AHV6396980,75,18,17,1,1
SBI94XAB8534684,60,28,27,1,1
SBI43NJI3130969,80,18,13,5,1
SBI27QIV2085012,97,23,14,9,1
SBI44RZY9803289,81,26,19,7,1
SBI86MVQ8628384,87,26,23,3,1
SBI02OII7736414,76,31,20,11,1
SBI25IUO9313098,65,35,34,1,1
SBI63OGY1577643,93,24,15,9,1
SBI06TFR0741177,85,30,17,13,1
SBI72ROH1842920,71,22,20,2,1
SBI70JNX2678892,96,23,22,1,1
SBI33JRE2778117,91,25,21,4,1
SBI08DUV8078337,71,24,17,7,1
SBI75HKI4985491,92,33,28,5,1
SBI58LTO8922802,94,18,12,6,1
SBI25WIF5537750,94,23,17,6,1
SBI23WLC0210025,62,35,26,9,1
SBI02WPZ5985848,22,22,14,8,1
SBI18XQZ2076917,90,24,19,5,1
SBI34REB4992323,80,23,15,8,1
SBI59MFE2066779,22,20,17,3,1
SBI19XCB2002150,80,30,27,3,1
SBI33HCO5565782,91,16,12,4,1
SBI56ACE3784115,77,20,12,8,1
SBI08IMX8036840,79,28,20,8,1
SBI19RZL6889649,64,24,23,1,1
SBI61XJM3043935,19,30,29,1,1
SBI92VOU6260118,69,18,17,1,1
SBI07KRJ9544337,81,23,20,3,1
SBI44ZYF5592077,87,23,18,5,1
SBI81YMI8038726,71,17,13,4,1
SBI07NTI6562890,76,23,22,1,1
SBI88IKM0507687,90,25,21,4,1
SBI12SST6937093,21,20,12,8,1
SBI38XLD1993509,21,33,26,7,1
SBI49XRS2212630,78,20,18,2,1
SBI44EUH7185086,67,25,17,8,1
SBI91PMM0229654,88,25,14,11,1
SBI86MIN7159928,89,28,20,8,1
SBI12BAH6455563,20,29,27,2,1
SBI81RIJ2848283,68,32,23,9,1
SBI44LNA1331660,78,21,19,2,1
SBI74ALG6109735,78,32,28,4,1
SBI11ZZV4874284,84,21,18,3,1
SBI53UTL0247205,93,24,18,6,1
SBI08GTU3575241,21,31,18,13,1
SBI87ZTX9826001,67,24,13,11,1
SBI11KKO0008456,91,29,18,11,1
SBI64BZR9611869,22,16,11,5,1
SBI56RII4830782,73,28,25,3,1
SBI95PHB0947116,81,22,19,3,1
SBI34LRH6934487,96,19,10,9,1
SBI95JQA7170370,90,23,18,5,1
SBI32DLY1620345,85,21,19,2,1
SBI21BGZ1998101,91,26,15,11,1
SBI54KEC3805682,97,29,16,13,1
SBI44THA8408526,66,23,16,7,1
SBI18BOZ1281632,71,18,11,7,1
SBI32KGP9436671,64,15,10,5,1
SBI23IFY6170519,99,26,25,1,1
SBI14YQQ0510242,82,23,17,6,1
SBI78OYS9683015,78,29,22,7,1
SBI86OBH9275555,94,22,19,3,1
SBI71HCU2040198,64,24,20,4,1
SBI06AFD1881284,70,18,14,4,1
SBI07BHL7408049,90,21,14,7,1
SBI51YOE4621852,66,25,20,5,1
SBI83TJL9759474,78,31,28,3,1
SBI05EWH1731279,90,42,28,14,1
SBI40TWV1890257,18,24,17,7,1
SBI82GPW8864810,72,37,35,2,1
SBI31EEL9332670,95,29,23,6,1
SBI70DGG5212997,60,21,12,9,1
SBI07AIS4193927,83,18,15,3,1
SBI81PBZ3660357,70,29,19,10,1
SBI14EWU8725366,89,24,14,10,1
SBI81JBF7276690,94,23,18,5,1
SBI21HKX8119174,89,42,25,17,1
SBI30TRL5313305,73,24,21,3,1
SBI68BUJ0168141,74,21,15,6,1
SBI21JUF5759582,61,24,17,7,1
SBI24HZX8083028,70,17,14,3,1
SBI23GUA0978631,21,26,18,8,1
SBI45VRE3428232,85,32,20,12,1
SBI99KKA9773097,77,22,12,10,1
SBI85TGG7408131,81,26,14,12,1
SBI11ZUH7285946,96,21,16,5,1
SBI52FSV8219403,70,24,15,9,1
SBI15BSO1616758,78,27,20,7,1
SBI60OGT5603824,88,25,22,3,1
SBI30GIX2649239,99,21,20,1,1
SBI50VCQ2322854,74,18,13,5,1
SBI69HEO5381115,76,25,24,1,1
SBI82UQH0967392,68,21,16,5,1
SBI39BAG7635097,76,18,13,5,1
SBI29UQT5711928,97,30,28,2,1
SBI01WWW2475670,23,24,14,10,1
SBI65SUH6623998,74,24,18,6,1
SBI45QQF0075453,93,30,26,4,1
SBI76CJH0384094,80,24,15,9,1
SBI12UMN3806498,21,28,19,9,1
SBI91QYR0693060,89,18,11,7,1
SBI90VTP8027208,75,21,11,10,1
SBI12MDH3824521,88,21,19,2,1
SBI10GZX4945150,68,25,14,11,1
SBI72EHP5664616,91,27,15,12,1
SBI44JOS5244227,71,24,21,3,1
SBI15IOG2522304,63,19,15,4,1
SBI72COZ9293711,74,23,16,7,1
SBI51BIQ8170267,62,27,16,11,1
SBI84OEA0414717,19,20,12,8,1
SBI00UGN4085964,74,19,11,8,1
SBI15UNB3941626,74,32,30,2,1
SBI70VVR6058633,96,19,15,4,1
SBI27MDG6605519,23,16,9,7,1
SBI26IHM1937554,21,21,14,7,1
SBI57CRG2976597,75,21,15,6,1
SBI06KAS4184712,21,27,20,7,1
SBI22UKG6087769,69,32,26,6,1
SBI95UXN3037369,70,20,14,6,1
SBI18FDX8364033,77,26,23,3,1
SBI41XPR6565823,21,21,20,1,1
SBI62HEL5839389,24,26,15,11,1
SBI31PGD7552710,80,25,20,5,1
SBI38APT7423424,82,20,19,1,1
SBI34GUI2253545,62,20,19,1,1
SBI49ORR7740205,86,27,20,7,1
SBI78CSE3951544,68,22,16,6,1
SBI51LFM4633243,73,19,11,8,1
SBI03WJU3034612,89,32,27,5,1
SBI46SZX7554968,75,11,6,5,1
SBI35MZN9253626,60,20,13,7,1
SBI33XNL9230903,97,27,14,13,1
SBI29DLI6432238,65,18,13,5,1
SBI20MQX3672538,91,27,22,5,1
SBI39FHL5975648,61,20,19,1,1
SBI70DGC6437658,23,25,24,1,1
SBI91FBU6291425,90,26,15,11,1
SBI06KKV1900957,61,31,20,11,1
SBI67ZTD3266986,22,29,27,2,1
SBI85SQA2619441,80,28,27,1,1
SBI43GTU7721175,71,38,25,13,1
SBI99EZY9532237,19,29,26,3,1
SBI32NSJ8640859,74,23,14,9,1
SBI28QHP0669967,64,20,14,6,1
SBI00GMD0024175,21,28,22,6,1
SBI53CPM4213297,19,29,22,7,1
SBI90LOL5822338,92,23,17,6,1
SBI48MZY4970925,64,20,14,6,1
SBI61KCW0724496,94,30,17,13,1
SBI25DZR2792596,65,20,19,1,1
SBI40QSF3658988,89,24,22,2,1
SBI87KTG6151785,25,23,20,3,1
SBI41ALA3052308,65,28,15,13,1
SBI97YXO0441686,72,32,24,8,1
SBI69AFK9259218,21,15,14,1,1
SBI76YTF8716669,72,19,12,7,1
SBI09PXI1950874,96,34,25,9,1
SBI98UJV0490181,74,25,24,1,1
SBI33YXW0454194,24,23,22,1,1
SBI35ZWD1448718,72,17,13,4,1
SBI71HIE5348543,78,19,18,1,1
SBI79FHT6312874,92,26,14,12,1
SBI21POL7627875,83,31,27,4,1
SBI27IZM9076085,94,22,14,8,1
SBI71GXH8682769,66,31,25,6,1
SBI43PVN1061644,78,22,21,1,1
SBI08TWH4663768,75,30,28,2,1
SBI57WJZ4891521,70,34,20,14,1
SBI50PPG1139462,97,23,17,6,1
SBI61SLK6651811,22,22,12,10,1
SBI07ZQI8242914,69,29,25,4,1
SBI97IMK2375088,70,30,23,7,1
SBI28BUB5208363,61,25,13,12,1
SBI05USN4386532,71,22,15,7,1
SBI35GGV3955626,94,24,14,10,1
SBI44VWG2504816,63,26,20,6,1
SBI92VPC9871414,96,28,16,12,1
SBI81VZL6743598,72,31,23,8,1
SBI84KBM3352072,86,18,10,8,1
SBI27CMP7638519,80,21,16,5,1
SBI12HOT9056029,64,28,25,3,1
SBI29PIU0338783,99,22,13,9,1
SBI84BEF4879711,70,20,11,9,1
SBI40TEJ7606400,87,20,13,7,1
SBI65DSK1842322,91,25,17,8,1
SBI41VHJ5188606,64,25,18,7,1
SBI40HNF0707898,98,13,12,1,1
SBI69HNH7602019,84,29,26,3,1
SBI01TNV5919273,70,28,25,3,1
SBI56JBD6581224,66,18,16,2,1
SBI58URP6130085,19,34,32,2,1
SBI54YWX2024110,66,22,19,3,1
SBI48UUH8112076,70,29,16,13,1
SBI21OXA4062152,71,30,18,12,1
SBI22DLH9340484,68,28,27,1,1
SBI08ZET8159573,91,26,22,4,1
SBI96LNK0435451,72,21,14,7,1
SBI87UWI7084820,67,26,15,11,1
SBI42UNJ8685562,92,19,12,7,1
SBI35IKG4753413,73,22,19,3,1
SBI92VRY2980965,71,28,16,12,1
SBI47SXK8159013,80,15,13,2,1
SBI24DGW8132123,67,23,12,11,1
SBI05MMC1916530,60,24,14,10,1
SBI20VJL7730607,86,21,14,7,1
SBI53TQQ0361456,75,12,9,3,1
SBI20FNE7586984,86,25,21,4,1
SBI14OSX7029021,92,32,31,1,1
SBI80LXG1490278,70,24,19,5,1
SBI96QSD0383169,91,22,15,7,1
SBI02KIL3033940,68,21,13,8,1
SBI17YZJ3429247,78,18,13,5,1
SBI45JKZ4368896,97,18,11,7,1
SBI39AGY3097887,80,18,10,8,1
SBI14YPF4419911,93,30,17,13,1
SBI84FWD1368090,98,26,22,4,1
SBI49WNF8806800,95,18,17,1,1
SBI15QUV1181915,65,23,18,5,1
SBI09TJG8960099,69,28,22,6,1
SBI59UYP9988208,60,20,15,5,1
SBI09DQN5818499,77,20,17,3,1
SBI59RFM5058855,20,24,18,6,1
SBI04GXB0727830,61,31,19,12,1
SBI35FJX6619818,20,29,15,14,1
SBI15FWB0110021,85,19,11,8,1
SBI91TUG9726493,92,31,26,5,1
SBI46NLC0494731,71,23,19,4,1
SBI60MPT1526222,98,24,16,8,1
SBI30MHY8498418,68,29,27,2,1
SBI20KGC1223651,80,20,13,7,1
SBI01XTL5669158,62,27,20,7,1
SBI41QTJ2178794,99,25,22,3,1
SBI01CLD0730641,20,25,18,7,1
SBI20RWS1417858,81,24,13,11,1
SBI30DHK4533684,93,22,16,6,1
SBI24SID5347814,72,34,19,15,1
SBI45GED0575069,68,22,18,4,1
SBI90JHR1789045,70,23,18,5,1
SBI54OSL7634071,22,30,22,8,1
SBI06XRF0241447,71,30,22,8,1
SBI65DHL6764163,63,31,24,7,1
SBI30KRQ1276622,23,28,15,13,1
SBI91LHC9363255,88,23,15,8,1
SBI22GLD9353978,76,28,26,2,1
SBI44EGQ1214700,77,21,15,6,1
SBI84NFN2519510,79,29,17,12,1
SBI49WKE3146340,91,32,22,10,1
SBI64UXO5888223,22,29,20,9,1
SBI52FLU8713038,63,27,24,3,1
SBI98ACP6503123,21,21,11,10,1
SBI62KES6748935,18,19,13,6,1
SBI75OUF2287631,22,27,15,12,1
SBI11XPR6478240,67,16,13,3,1
SBI05PIO5814443,20,24,18,6,1
SBI90YMO7197286,21,21,17,4,1
SBI75TMJ6743634,24,32,27,5,1
SBI58LQI6967878,94,21,15,6,1
SBI92HAV5162534,20,33,18,15,1
SBI05TXI8136767,91,20,14,6,1
SBI07CUD9004161,24,25,19,6,1
SBI28KCG1549411,86,19,11,8,1
SBI14TBA1262846,79,24,23,1,1
SBI35XTB6903351,93,28,26,2,1
SBI65XLX8446287,79,26,23,3,1
SBI81AQP8617211,73,21,11,10,1
SBI26CTO8431408,91,18,11,7,1
SBI34IQV9112054,73,26,18,8,1
SBI24XFW1996577,86,30,20,10,1
SBI62YXQ2472167,79,20,16,4,1
SBI73IJL9993814,80,26,17,9,1
SBI73OVG9573108,65,18,17,1,1
SBI97AGJ1184640,65,20,15,5,1
SBI33QVT0635802,64,23,17,6,1
SBI97RHB4092066,25,19,13,6,1
SBI10TNT6153656,82,12,7,5,1
SBI05HCI6844725,97,26,17,9,1
SBI81RDM0680420,86,26,19,7,1
SBI74LSS6854797,79,29,16,13,1
SBI61AFK0417378,68,22,21,1,1
SBI24BDZ7512353,84,22,21,1,1
SBI82OLO5837278,85,25,17,8,1
SBI62CAA4076398,60,27,21,6,1
SBI76SLW0445237,94,31,20,11,1
SBI27NNX9137495,96,21,13,8,1
SBI79EAL8577037,25,28,27,1,1
SBI61BJI1234654,66,26,19,7,1
SBI68FLC3436810,97,25,19,6,1
SBI13RZF7144108,22,32,17,15,1
SBI54RIF1840835,92,16,10,6,1
SBI81WYY7569932,86,26,21,5,1
SBI02QGQ2025542,86,23,22,1,1
SBI71LUT6278554,71,33,20,13,1
SBI05PUT4693543,97,18,11,7,1
SBI98NXS6784555,69,18,11,7,1
SBI05UVG5792106,61,25,13,12,1
SBI66EJQ0469118,80,25,18,7,1
SBI25WAI7794434,67,25,14,11,1
SBI06UGK9406465,71,29,27,2,1
SBI84WSW9315340,65,18,15,3,1
SBI18DYP6796442,84,17,10,7,1
SBI86VCS8967811,77,31,24,7,1
SBI29ENW6587910,97,26,25,1,1
SBI64GUF7126710,74,20,15,5,1
SBI55WNX1078344,91,19,15,4,1
SBI78BJQ6045411,78,20,13,7,1
SBI56FCV2644697,70,28,23,5,1
SBI65SLW5416693,84,18,17,1,1
SBI87EMB0898709,98,19,18,1,1
SBI99OTC7346796,82,24,14,10,1
SBI65SEM7858039,74,23,19,4,1
SBI46ZLB2693183,89,23,16,7,1
SBI87ZAF0271301,62,35,33,2,1
SBI09ABZ1470208,23,25,18,7,1
SBI20CLD9833177,64,23,18,5,1
SBI55LZL3290565,21,19,18,1,1
SBI86UZP8449740,69,29,24,5,1
SBI77BWL3866684,76,23,22,1,1
SBI33WRV7086290,68,23,15,8,1
SBI93ZJW6667663,97,8,5,3,1
SBI99SYD8015726,18,27,26,1,1
SBI15NDK0840088,98,28,27,1,1
SBI49UGH2904913,61,24,18,6,1
SBI39MTV8560022,78,18,16,2,1
SBI69QXT7555589,24,21,15,6,1
SBI33CCY3563319,62,26,23,3,1
SBI92UOS4775211,85,24,23,1,1
SBI57SZO8152840,74,17,13,4,1
SBI96KZK7490508,79,28,26,2,1
SBI55PEV4056002,99,25,23,2,1
SBI39CPK6185312,19,23,17,6,1
SBI53ATR4490979,94,20,14,6,1
SBI49PDM9891406,25,25,16,9,1
SBI74EBN1242391,65,27,24,3,1
SBI38TPO2178570,60,19,12,7,1
SBI79SXO0195511,64,23,21,2,1
SBI94UXG5305689,83,22,14,8,1
SBI78IHH7616938,97,29,15,14,1
SBI43KKT5292970,21,25,20,5,1
SBI98VNS5152287,89,18,11,7,1
SBI80GFL0335050,70,27,18,9,1
SBI77YSG9071646,77,15,11,4,1
SBI04AEZ2096215,62,25,22,3,1
SBI45VGJ6401486,61,24,14,10,1
SBI08GRW0472788,86,28,16,12,1
SBI07QET7869942,99,27,17,10,1
SBI09QUG0100720,68,26,20,6,1
SBI44BPX5700150,71,24,15,9,1
SBI33TVQ8536159,87,22,15,7,1
SBI72IKY8021819,74,21,11,10,1
SBI52KZP1134356,84,21,17,4,1
SBI47QHH8482847,92,29,15,14,1
SBI09WHR1466832,61,36,30,6,1
SBI00AHR6637855,85,18,13,5,1
SBI73PEV5499456,69,27,20,7,1
SBI67XYX2513191,63,23,15,8,1
SBI33LWP8452425,75,16,15,1,1
SBI69KMX1035686,20,26,22,4,1
SBI01LYB5699716,70,26,23,3,1
SBI76JVN2723419,85,24,14,10,1
SBI33IUL7334976,87,34,23,11,1
SBI57MYB1861092,65,35,26,9,1
SBI50RAH7594685,24,26,21,5,1
SBI05BJM7876171,88,16,10,6,1
SBI64RGP1360188,92,23,16,7,1
SBI08ZAX4888084,25,28,23,5,1
SBI80MSI1426332,22,24,18,6,1
SBI30AWT8697207,19,11,9,2,1
SBI29JXD9145598,79,16,11,5,1
SBI10GYU3142219,62,25,21,4,1
SBI39MVH2559486,86,22,21,1,1
SBI73UCX8319837,61,23,15,8,1
SBI71TCV9095308,64,22,20,2,1
SBI50MTI8296669,80,22,12,10,1
SBI04XDQ4392030,70,23,18,5,1
SBI08MZD0268879,76,23,14,9,1
SBI67IFA4641827,78,21,15,6,1
SBI32BON1816753,67,19,14,5,1
SBI89LWF4036991,69,19,11,8,1
SBI51YBG7426852,22,37,29,8,1
SBI15GRI1242897,91,29,18,11,1
SBI60OAQ6721416,98,22,18,4,1
SBI27FYF2029303,19,28,19,9,1
SBI90ILL6322832,79,19,12,7,1
SBI21WFO8398663,97,22,21,1,1
SBI45UGS6707237,23,17,10,7,1
SBI80AZO6194550,93,16,11,5,1
SBI91VNL7745980,94,23,18,5,1
SBI25JJO9688688,19,20,11,9,1
SBI91ZUN3401349,25,11,8,3,1
SBI57TVM1316945,20,29,15,14,1
SBI72MIB0239084,64,25,16,9,1
SBI83RFO0222738,65,25,23,2,1
SBI21DAK7258395,88,24,14,10,1
SBI20ROU7636441,73,33,32,1,1
SBI71NZZ5182881,99,25,15,10,1
SBI86QZW5062037,79,23,18,5,1
SBI89SCV1507870,96,28,26,2,1
SBI43LEB9315991,75,29,23,6,1
SBI00FZK0388409,92,30,29,1,1
SBI53IBY4000041,20,16,9,7,1
SBI17EHL5777032,18,24,15,9,1
SBI82ZKS4178319,92,19,11,8,1
SBI45UPJ0987294,93,30,19,11,1
SBI48VTP0809075,61,21,15,6,1
SBI31YAJ4671201,89,21,19,2,1
SBI47GYV7693067,76,33,26,7,1
SBI55CFM0507775,80,24,23,1,1
SBI55NWI5395290,86,25,23,2,1
SBI96QMF5511517,20,22,17,5,1
SBI81PBU2179656,65,23,19,4,1
SBI49XUV7345063,63,24,22,2,1
SBI54VEW0259443,66,25,15,10,1
SBI24CHG1471728,95,22,14,8,1
SBI98ONL7023287,62,24,14,10,1
SBI24KAU1042403,73,28,16,12,1
SBI95ZKP7170825,71,15,14,1,1
SBI29QAW8271528,87,21,15,6,1
SBI85MAU7248412,62,29,27,2,1
SBI38DCE4595970,67,24,19,5,1
SBI33TWQ4959888,19,27,23,4,1
SBI58UTU7725287,70,22,13,9,1
SBI84HEL2758689,83,25,13,12,1
SBI93QTZ6052589,92,23,20,3,1
SBI07PZO4918669,76,20,11,9,1
SBI63TMA7037113,66,27,21,6,1
SBI22WEO4258139,62,27,16,11,1
SBI32BVX8971896,61,25,14,11,1
SBI06PJF1006036,20,24,17,7,1
SBI99TQW4421092,84,25,17,8,1
SBI80XZA6632158,89,16,9,7,1
SBI57POL7145056,72,17,12,5,1
SBI93KKK2507475,76,17,15,2,1
SBI03NBE7119587,99,27,25,2,1
SBI52FSM4677262,71,29,16,13,1
SBI84HDK3875977,64,31,19,12,1
SBI71FCN7323229,82,22,20,2,1
SBI10QLT7580415,71,33,23,10,1
SBI82XBM1290874,80,15,13,2,1
SBI19YHB6082700,71,26,23,3,1
SBI84PYB7154754,73,34,24,10,1
SBI84IKJ0420486,67,25,18,7,1
SBI16EPR4264393,90,18,11,7,1
SBI27AAQ3568969,25,33,20,13,1
SBI50VKD9201183,87,31,20,11,1
SBI95ZDD0978231,94,29,24,5,1
SBI08SHQ4717957,74,22,21,1,1
SBI82AWS7973683,19,22,21,1,1
SBI49GRW3931927,93,27,24,3,1
SBI70LWJ8952359,72,29,19,10,1
SBI63DNB2073309,67,18,11,7,1
SBI42YXW4509665,88,22,14,8,1
SBI56FMC5767535,99,24,17,7,1
SBI55MCK2944165,19,25,17,8,1
SBI39HTH1607744,77,19,15,4,1
SBI18VSV5451492,75,22,14,8,1
SBI72JCS5796761,24,23,16,7,1
SBI77DXQ8247266,64,18,13,5,1
SBI77IRA0701474,18,28,19,9,1
SBI41PTN6163221,92,28,20,8,1
SBI90IZM6431648,65,24,17,7,1
SBI96BHW2759765,21,23,17,6,1
SBI83BHP0677795,20,23,17,6,1
SBI79EGN1832873,74,19,15,4,1
SBI34DJV1608857,20,24,13,11,1
SBI41PWE1368908,21,27,22,5,1
SBI49LEQ8089480,87,25,23,2,1
SBI99NLB2890502,25,28,26,2,1
SBI48EIM9966737,21,24,16,8,1
SBI87XML2136634,90,18,12,6,1
SBI79SJB9905856,65,20,16,4,1
SBI32XDO2607203,61,30,19,11,1
SBI41ZFS6124484,24,25,18,7,1
SBI07CHK9497007,94,30,22,8,1
SBI62JMU4221095,91,25,17,8,1
SBI84KTW4157840,89,24,22,2,1
SBI21PMW3253785,98,21,12,9,1
SBI74AJF1762261,69,26,24,2,1
SBI93DZA9525040,69,26,18,8,1
SBI02YZP0899397,84,25,22,3,1
SBI65EOE2738499,19,30,17,13,1
SBI90QLQ6241085,92,24,13,11,1
SBI31QOS0232949,94,18,15,3,1
SBI94XAM6405459,84,23,21,2,1
SBI22ZBC3637496,97,30,22,8,1
SBI38VSL5493318,71,29,26,3,1
SBI20BAQ6189321,84,27,23,4,1
SBI48IFP8613923,97,21,13,8,1
SBI10AED5878945,21,25,14,11,1
SBI03JWI4855973,76,24,13,11,1
SBI76HZB2401732,81,31,17,14,1
SBI20RLJ4420286,92,29,20,9,1
SBI83RUQ7566827,88,25,20,5,1
SBI36MTP9408200,84,28,24,4,1
SBI41YSA9423333,65,21,14,7,1
SBI36ISF9814629,76,28,22,6,1
SBI69HLB8448048,63,26,20,6,1
SBI77OHF5838830,69,19,11,8,1
SBI16HIK1515571,90,20,13,7,1
SBI35IUM9074526,89,23,15,8,1
SBI41NBL8318039,22,23,15,8,1
SBI49XGG0884991,99,27,18,9,1
SBI13LBX8165469,86,31,16,15,1
SBI10ETZ2110789,60,23,14,9,1
SBI53CXM3652749,86,20,16,4,1
SBI51QTU1777196,89,25,24,1,1
SBI10LTY9529774,99,27,18,9,1
SBI66QKD1298569,84,30,29,1,1
SBI32EJO7230618,69,29,25,4,1
SBI50WHC0674553,74,30,26,4,1
SBI75GHD8109572,87,26,25,1,1
SBI55IHY4868694,70,33,26,7,1
SBI53JHU3435112,67,19,13,6,1
SBI54PCX3100694,89,24,13,11,1
SBI61IZQ3126820,72,24,23,1,1
SBI17TJV0076437,93,20,11,9,1
SBI57PNI5220349,82,25,20,5,1
SBI55YUJ6785736,86,25,17,8,1
SBI64ZHK4001805,63,28,16,12,1
SBI91MPY5803483,94,19,10,9,1
SBI78YOB7151158,82,26,24,2,1
SBI16DME0682999,84,24,16,8,1
SBI43CQO6000830,66,26,15,11,1
SBI19RZD7605066,79,29,18,11,1
SBI53GRF0670725,60,26,21,5,1
SBI93UFF6765045,85,23,21,2,1
SBI15XTG9144790,92,19,17,2,1
SBI52NIU2198227,84,33,25,8,1
SBI02IGH6130069,25,27,23,4,1
SBI63WFT6332656,60,14,10,4,1
SBI66VRM2712476,85,16,15,1,1
SBI96STZ9869433,21,19,14,5,1
SBI66NMS1478520,25,23,12,11,1
SBI13GMA9893629,66,29,17,12,1
SBI92RXJ5979919,23,26,20,6,1
SBI48MEC4171508,89,23,13,10,1
SBI11FJL1681778,99,28,16,12,1
SBI82TNL6268029,86,16,9,7,1
SBI31UZO7642166,67,19,15,4,1
SBI21KYN6709517,22,25,15,10,1
SBI11BLU3628767,84,23,14,9,1
SBI97LSS7600825,23,23,14,9,1
SBI46OMH9045743,85,24,18,6,1
SBI77HYM0828975,80,30,23,7,1
SBI11RRD6135276,67,24,18,6,1
SBI51EBH0749873,80,24,15,9,1
SBI89ABM0894783,23,20,11,9,1
SBI05DAM7855289,68,28,25,3,1
SBI03XPO0341434,72,20,15,5,1
SBI89QDJ7799169,76,32,27,5,1
SBI38PBM0858128,73,29,27,2,1
SBI06CWO1045814,73,23,14,9,1
SBI95QWM7986984,93,22,21,1,1
SBI35YEN6503101,22,25,19,6,1
SBI77TRG3014137,18,24,17,7,1
SBI33CFD6573355,60,21,15,6,1
SBI69XLD4737360,80,23,18,5,1
SBI87ALC1060051,69,28,17,11,1
SBI72HEL2314516,98,35,20,15,1
SBI69WGD1710178,22,18,10,8,1
SBI07LMJ7495838,81,30,27,3,1
SBI86JKG7792115,19,21,16,5,1
SBI69FRD8265042,18,22,15,7,1
SBI41LBH3610341,95,26,20,6,1
SBI81STG3733515,75,27,16,11,1
SBI19HTV1013645,99,26,22,4,1
SBI71OXS7061664,95,31,28,3,1
SBI59INC0083323,86,23,19,4,1
SBI58GTK5347289,86,23,15,8,1
SBI61YBC4407265,71,22,12,10,1
SBI67OXY5951059,97,28,25,3,1
SBI42PAQ0609226,86,29,27,2,1
SBI60LQQ3200146,94,29,18,11,1
SBI75EQE9061044,79,17,10,7,1
SBI30ONO6315713,21,24,18,6,1
SBI09BWO9387018,87,30,24,6,1
SBI82DJW7422073,75,23,13,10,1
SBI55SZB8634720,73,33,24,9,1
SBI26JVN2571339,22,24,21,3,1
SBI79PRQ4190914,61,34,26,8,1
SBI35BST0614269,81,28,26,2,1
SBI36BSC4068596,72,20,19,1,1
SBI98BVC7675243,83,29,17,12,1
SBI97TUQ3008585,61,14,10,4,1
SBI52CRJ0946272,22,22,17,5,1
SBI54AUP4251308,21,21,20,1,1
SBI12OCH4589262,89,30,17,13,1
SBI67FBX0846255,69,29,25,4,1
SBI32DHZ0020340,22,25,18,7,1
SBI66TTA1930935,21,26,16,10,1
SBI05OIL3002835,21,33,30,3,1
SBI71SBU3307762,63,23,19,4,1
SBI69NAH8341438,76,28,24,4,1
SBI82WTC5403913,22,28,15,13,1
SBI84QEA5476976,79,20,12,8,1
SBI21SMZ8658099,61,24,21,3,1
SBI11XXD6988068,73,24,18,6,1
SBI28QSY0936306,20,28,16,12,1
SBI75XUY1245450,76,28,17,11,1
SBI26MJS3061735,94,25,20,5,1
SBI16IOR8396674,24,24,22,2,1
SBI00ODN1236718,75,33,29,4,1
SBI16ZJX0703319,96,30,24,6,1
SBI18GVE1964516,78,25,23,2,1
SBI79OZC1119060,99,20,11,9,1
SBI02YXZ9623638,70,27,24,3,1
SBI54KRY9792263,18,32,29,3,1
SBI08VIJ1496652,97,28,22,6,1
SBI68MTI0430037,64,27,21,6,1
SBI06QZA3261848,60,31,25,6,1
SBI26GCZ2236633,96,28,27,1,1
SBI47VGH9944592,20,22,13,9,1
SBI37FNA7478959,96,29,26,3,1
SBI77DSH3493788,97,21,13,8,1
SBI23RXJ0400975,66,26,20,6,1
SBI14JWF7172845,20,25,20,5,1
SBI51WXJ7798953,72,24,16,8,1
SBI28DHB5470353,83,23,17,6,1
SBI00KCQ4892866,24,27,25,2,1
SBI14ALZ2640268,67,26,25,1,1
SBI86EMR9068281,18,30,28,2,1
SBI36GGS7539664,66,28,26,2,1
SBI77LBM2069031,68,27,15,12,1
SBI25SHM3969565,60,25,13,12,1
SBI30BGE9413258,72,20,13,7,1
SBI73ZRJ3936539,70,25,18,7,1
SBI71QPR0017628,97,27,24,3,1
SBI50SMJ6770263,89,24,17,7,1
SBI18ENA1023560,65,24,20,4,1
SBI54BVU2663843,64,22,15,7,1
SBI52NOO4814182,87,25,16,9,1
SBI18YXT7375434,91,18,13,5,1
SBI10ZBU7518855,96,15,11,4,1
SBI31MGW9526611,83,18,13,5,1
SBI95GQO3145938,70,15,8,7,1
SBI55QGQ2040272,99,21,18,3,1
SBI17HOC1968610,22,26,15,11,1
SBI08IJD9938734,63,27,14,13,1
SBI36VTS1612382,62,25,21,4,1
SBI06ZDB9235166,98,27,22,5,1
SBI61WAG3119945,96,26,23,3,1
SBI79QJK8569639,93,23,21,2,1
SBI84SHM5175289,89,26,14,12,1
SBI11AAM7299552,66,26,21,5,1
SBI48OYC0319380,84,18,16,2,1
SBI25CZI3482558,99,30,28,2,1
SBI07VCI8688149,93,23,14,9,1
SBI54KDE8067888,19,24,13,11,1
SBI74GUV8358403,73,26,15,11,1
SBI92IZK4529619,20,22,15,7,1
SBI24KGU1400137,80,26,17,9,1
SBI12ZZQ0603693,72,18,14,4,1
SBI61EOL4364080,25,18,14,4,1
SBI04GKR0407248,70,29,23,6,1
SBI03BSD4052738,76,25,21,4,1
SBI51IME9220826,79,26,15,11,1
SBI30TJX9452601,68,24,14,10,1
SBI17UTB4471217,63,24,20,4,1
SBI79GFX4118168,95,20,15,5,1
SBI15FJB2559066,19,32,24,8,1
SBI23AFD0520281,60,20,15,5,1
SBI95IFH2855413,22,25,14,11,1
SBI81UDQ7635742,92,30,29,1,1
SBI88WIN6657955,61,26,15,11,1
SBI25GVI4136470,25,29,24,5,1
SBI67ZHN9970585,96,18,15,3,1
SBI56VMM3680430,80,17,10,7,1
SBI85UJN1352417,97,23,21,2,1
SBI51UQB3131054,69,29,26,3,1
SBI13XAX6359026,75,28,25,3,1
SBI35BYK1344643,96,28,16,12,1
SBI20QNG1127448,75,28,19,9,1
SBI18KTA9330194,80,19,17,2,1
SBI93KLR9670938,69,22,21,1,1
SBI88URI1091237,89,18,13,5,1
SBI75WME2543064,97,24,18,6,1
SBI72PUP2324617,98,21,17,4,1
SBI16DPM0785025,75,21,12,9,1
SBI04VGN0987453,61,28,20,8,1
SBI40HTD8773884,99,18,17,1,1
SBI89ELW9478121,20,26,24,2,1
SBI90OHA4157049,66,24,15,9,1
SBI75KXK1896294,62,34,22,12,1
SBI05BJJ0082754,86,27,24,3,1
SBI31TYZ1475983,74,26,20,6,1
SBI62GTM4467309,62,27,23,4,1
SBI40SBG8617270,65,27,21,6,1
SBI74ZVJ5969510,98,29,25,4,1
SBI66GDF5264228,85,16,11,5,1
SBI27PRO6563888,72,33,28,5,1
SBI92BVM7728374,94,31,25,6,1
SBI40DYY4653638,23,12,9,3,1
SBI44ADG9305538,25,25,16,9,1
SBI11ADG9043970,66,18,13,5,1
SBI95UHL4934809,90,19,13,6,1
SBI10DRT5243009,88,28,16,12,1
SBI87YGN0501572,88,17,13,4,1
SBI65PVB0032444,99,25,18,7,1
SBI79KTX1425705,81,22,13,9,1
SBI85NCT3876454,83,26,21,5,1
SBI77EDN9936239,76,25,22,3,1
SBI94YVS5573339,22,27,19,8,1
SBI26DFD4231761,62,27,14,13,1
SBI85MKJ6476014,73,23,17,6,1
SBI86NOS8984857,66,20,15,5,1
SBI87VSF4460791,72,21,17,4,1
SBI13FKL5782226,94,27,25,2,1
SBI24CLY7477196,83,36,31,5,1
SBI99IBI8478713,96,17,14,3,1
SBI81YWF9142101,99,23,18,5,1
SBI57VHJ2980823,96,24,16,8,1
SBI74UWS9872322,86,27,17,10,1
SBI40TVQ6262515,98,26,18,8,1
SBI55HUT0066218,86,26,20,6,1
SBI10RLG0560089,87,26,25,1,1
SBI20AJQ1478097,68,29,26,3,1
SBI94CMI2864767,97,26,25,1,1
SBI54YJC0379229,60,25,16,9,1
SBI95FAG2573941,20,19,16,3,1
SBI47WYE8332413,18,20,11,9,1
SBI50CSN0558335,65,26,21,5,1
SBI68ETY8996387,22,19,15,4,1
SBI76RXD2140765,70,24,23,1,1
SBI44WKU1348362,86,24,20,4,1
SBI23QJM9559665,89,27,24,3,1
SBI12RJX0754452,83,30,28,2,1
SBI49HSF8074841,76,19,10,9,1
SBI57ZHR3955104,66,31,18,13,1
SBI22CTO7518923,20,27,22,5,1
SBI53KNR8967513,73,21,17,4,1
SBI74YRP0904804,78,20,18,2,1
SBI70QVL1896679,82,25,17,8,1
SBI63WFT7781359,22,21,12,9,1
SBI25CET2733996,79,26,23,3,1
SBI09AFX7862647,86,22,13,9,1
SBI69FCD3452820,79,22,18,4,1
SBI76ZRN7745255,65,26,24,2,1
SBI04YLU5852545,91,24,13,11,1
SBI13LQF9408152,75,22,13,9,1
SBI89BLW6335515,60,15,13,2,1
SBI31OGT9811305,92,31,24,7,1
SBI87CLO3776531,77,24,15,9,1
SBI75ECF9705704,76,21,20,1,1
SBI63JGS6241892,68,27,18,9,1
SBI27ANQ5002265,73,29,23,6,1
SBI96FFS2806125,77,31,19,12,1
SBI30VVT1610373,87,25,16,9,1
SBI96JMQ2036201,25,24,23,1,1
SBI94PAA5517079,80,34,28,6,1
SBI45WYS9254084,19,24,23,1,1
SBI87BHH2767816,89,23,19,4,1
SBI73VST2192789,86,14,8,6,1
SBI67FXX2161260,20,24,14,10,1
SBI13EDW6138860,18,25,16,9,1
SBI69BCN1499183,25,25,19,6,1
SBI89SSR9201191,87,29,18,11,1
SBI39OES8114081,67,26,21,5,1
SBI18LMZ2447549,25,23,18,5,1
SBI84XQU8710469,91,29,17,12,1
SBI05SLE0461976,90,28,24,4,1
SBI66AOD1077917,69,13,7,6,1
SBI80FGU8269508,87,25,17,8,1
SBI49KLU6028118,86,23,14,9,1
SBI53VKV9238558,21,23,16,7,1
SBI35VQN3050367,77,19,17,2,1
SBI79IGU5553172,97,14,9,5,1
SBI90GWE6147800,91,22,13,9,1
SBI59CPC9581378,77,25,19,6,1
SBI98BUA1739679,96,27,21,6,1
SBI98ODF6045089,97,27,18,9,1
SBI32KWK2560318,75,24,21,3,1
SBI46PXD5872626,64,30,17,13,1
SBI84JTY7367280,91,24,20,4,1
SBI18CTU7732493,74,17,11,6,1
SBI68AJV5230158,81,25,23,2,1
SBI62PAO2831686,74,40,32,8,1
SBI89DZB0106026,83,30,22,8,1
SBI06XBZ6664147,91,17,12,5,1
SBI07AJA1506281,65,28,21,7,1
SBI92EEU2963930,23,22,12,10,1
SBI91PES0483245,91,20,19,1,1
SBI18LOJ0086477,70,24,20,4,1
SBI77UGM5063638,73,23,20,3,1
SBI89YOY9559678,86,22,18,4,1
SBI77PWN5782495,71,21,17,4,1
SBI40MYV5587537,77,22,21,1,1
SBI64GPL6785408,96,19,15,4,1
SBI54RIH0323565,65,35,20,15,1
SBI40OET4743265,65,22,20,2,1
SBI83DQK0627574,85,25,20,5,1
SBI38RDU6837528,65,31,18,13,1
SBI42QAF5103125,21,21,13,8,1
SBI91SSG4025652,64,26,14,12,1
SBI82FNB8075130,70,29,16,13,1
SBI21LHQ4920591,65,27,24,3,1
SBI66POB1925004,85,23,12,11,1
SBI98DCP9752014,18,27,14,13,1
SBI15VZY1080666,93,16,11,5,1
SBI30YOO8354039,70,28,18,10,1
SBI09WXY9847199,65,25,13,12,1
SBI93VYO8299211,98,27,16,11,1
SBI48VOQ6546312,95,25,14,11,1
SBI87TRY7750128,96,27,19,8,1
SBI07WSZ6040559,93,25,14,11,1
SBI51BKF7381482,92,24,19,5,1
SBI45OUC7806192,82,31,23,8,1
SBI31MQC7877758,19,28,23,5,1
SBI86JHB2850746,91,25,16,9,1
SBI18SCT7341942,82,17,10,7,1
SBI25TXN9011354,71,19,10,9,1
SBI11NLS7262346,95,22,21,1,1
SBI68HCY8224755,91,26,15,11,1
SBI90ORZ2673054,78,27,15,12,1
SBI47BFS1022921,91,20,14,6,1
SBI22NUE7248030,83,16,13,3,1
SBI27PPQ2767242,24,22,19,3,1
SBI39KQP6953930,90,28,22,6,1
SBI32IXK3217781,75,13,7,6,1
SBI54WKA0976015,65,23,22,1,1
SBI54RXS1938046,24,23,20,3,1
SBI85EGI9342722,74,27,24,3,1
SBI42KLS1723637,90,22,13,9,1
SBI28QUV6807449,64,22,16,6,1
SBI39RXF8509952,61,17,10,7,1
SBI08NSN4152662,72,21,17,4,1
SBI18NJJ9032940,91,21,14,7,1
SBI59DEU5590261,62,21,16,5,1
SBI67GCY1761800,78,27,24,3,1
SBI17XTO1722908,64,24,15,9,1
SBI55UTI1781172,88,24,13,11,1
SBI93SII4149164,91,29,17,12,1
SBI16PYN5608335,64,28,23,5,1
SBI05PUJ2074612,25,28,20,8,1
SBI88WZM8722062,72,30,23,7,1
SBI51QWO0006110,94,33,24,9,1
SBI87PDU2142335,62,17,12,5,1
SBI35NKQ1502249,74,21,11,10,1
SBI88KWX0915274,75,26,20,6,1
SBI15LLY4152131,66,22,14,8,1
SBI56XJW9781925,24,26,20,6,1
SBI40GKX0053831,94,25,13,12,1
SBI08SKH6619503,21,12,11,1,1
SBI02AFU0867138,70,28,23,5,1
SBI08BQP2463417,75,28,19,9,1
SBI26WTG3825997,70,26,24,2,1
SBI00SCD1358793,21,27,18,9,1
SBI14JEK5876801,69,16,12,4,1
SBI36CEG4945017,95,24,13,11,1
SBI95IVB2899486,86,26,18,8,1
SBI67DII5422949,76,29,18,11,1
SBI35ORT0817682,97,16,12,4,1
SBI48CYU9951602,62,27,14,13,1
SBI91OVK0395642,68,23,20,3,1
SBI87UCD6941354,64,19,12,7,1
SBI07JIM1859300,73,26,14,12,1
SBI63SRM8043016,63,19,15,4,1
SBI03CRO7447801,89,26,16,10,1
SBI64KCX1004187,98,19,15,4,1
SBI97IXW7502990,82,24,20,4,1
SBI46HRA8624666,92,32,20,12,1
SBI73ZSM2485303,86,24,13,11,1
SBI60RUE4385025,85,26,14,12,1
SBI71KYO4476738,21,18,10,8,1
SBI40PUD6650592,93,37,32,5,1
SBI76OVF0350362,25,25,22,3,1
SBI53OYZ8236081,72,25,16,9,1
SBI43YCR7373894,84,30,26,4,1
SBI12LDZ6583818,18,23,12,11,1
SBI09MPA6399767,18,27,18,9,1
SBI15WWF7409837,21,25,14,11,1
SBI58NIJ0993275,65,25,21,4,1
SBI95WVI6391342,69,24,14,10,1
SBI54UAT1913942,63,22,19,3,1
SBI40POP5090801,99,25,21,4,1
SBI32DUO7920387,79,31,21,10,1
SBI86DMK2900543,67,27,20,7,1
SBI55JEW6566034,22,37,30,7,1
SBI37QCU7028048,91,32,20,12,1
SBI82EJK7195154,71,26,20,6,1
SBI31EWN6035750,87,21,16,5,1
SBI15GOR1335398,90,26,24,2,1
SBI58YBI0542987,61,25,22,3,1
SBI62AZE6062874,78,19,12,7,1
SBI17DSV2357127,65,29,25,4,1
SBI19HEG9133160,25,25,15,10,1
SBI20ECJ9337235,23,35,24,11,1
SBI04LIC6892428,81,25,14,11,1
SBI89EPE4027587,78,19,15,4,1
SBI11DHW8398596,97,19,14,5,1
SBI27TSZ3738710,89,28,23,5,1
SBI87UET1590791,91,23,17,6,1
SBI25BBS5017287,91,20,19,1,1
SBI36BOK3139407,64,11,8,3,1
SBI16JQE9525230,22,25,17,8,1
SBI72CRO3018741,84,28,18,10,1
SBI22MXI0964721,70,27,24,3,1
SBI33YXD0846415,77,29,26,3,1
SBI43SVJ1322045,65,28,22,6,1
SBI25FVE9695086,68,21,13,8,1
SBI78GDC9289459,76,31,21,10,1
SBI81UJS5572536,90,20,17,3,1
SBI75WHP7052569,73,23,18,5,1
SBI91VXM1446739,18,27,14,13,1
SBI00MAT6961840,61,32,22,10,1
SBI72ZFF5411181,82,30,27,3,1
SBI43OIH1551791,80,22,16,6,1
SBI44TUK5251347,88,23,20,3,1
SBI07UUG6314423,66,23,14,9,1
SBI94CXB1612424,84,29,26,3,1
SBI07UPV0848067,79,29,15,14,1
SBI92KLU4504585,80,16,14,2,1
SBI84NNZ6651973,94,24,22,2,1
SBI61DHS8154649,72,32,20,12,1
SBI83UYM7000453,65,21,19,2,1
SBI12RLJ4123773,24,25,22,3,1
SBI80CMV6715947,60,23,22,1,1
SBI90NYT7445457,77,32,24,8,1
SBI20JYL1168563,18,20,18,2,1
SBI66CIE0970592,97,20,18,2,1
SBI40MMU2548925,96,26,16,10,1
SBI45TPW6297524,95,34,23,11,1
SBI77MTE3642691,67,21,20,1,1
SBI38WII2340811,81,24,22,2,1
SBI52JHN4090267,69,31,30,1,1
SBI21OSU0964715,77,23,21,2,1
SBI27YWX9032668,97,29,23,6,1
SBI44DHK7782091,23,25,24,1,1
SBI71WNV2131418,98,22,18,4,1
SBI80PII4265610,23,35,32,3,1
SBI23QRR3843794,99,23,12,11,1
SBI47OKG8456492,91,27,24,3,1
SBI47XTC9225148,88,20,14,6,1
SBI98ZSE8333437,19,29,15,14,1
SBI84RMD1038312,78,26,19,7,1
SBI12VAY4617075,73,23,20,3,1
SBI26QAP2712085,98,30,20,10,1
SBI40ACF7848859,86,29,16,13,1
SBI05QUC1005989,21,24,22,2,1
SBI29ZSJ5200479,99,25,17,8,1
SBI32IHD3278686,92,25,16,9,1
SBI23EPE5660996,97,24,22,2,1
SBI19AIZ0736650,65,22,17,5,1
SBI67VRT6661520,76,21,13,8,1
SBI94XTM1206230,60,24,16,8,1
SBI02YUA9207983,83,27,22,5,1
SBI41GXM9283425,97,18,15,3,1
SBI86AEM7732915,94,26,16,10,1
SBI61GYY7436915,91,33,28,5,1
SBI68WRE8013836,18,26,24,2,1
SBI04HNZ5008623,80,22,21,1,1
SBI43TCI7633583,69,22,16,6,1
SBI93EAI7110462,73,18,13,5,1
SBI41QVL3503104,82,27,16,11,1
SBI23HDH2934164,70,23,19,4,1
SBI64BYY4183804,77,32,21,11,1
SBI71SYU9359835,94,16,9,7,1
SBI12PSH5941800,64,24,16,8,1
SBI49WUG3931446,77,28,17,11,1
SBI37KBJ8242778,71,34,24,10,1
SBI63LWF6914806,80,19,10,9,1
SBI66JNV8768323,22,19,15,4,1
SBI82YDU0667308,80,14,9,5,1
SBI08JOB8037448,65,31,19,12,1
SBI56RKR1718460,24,25,21,4,1
SBI12FBB9283193,63,26,23,3,1
SBI95OXK3597141,82,23,22,1,1
SBI12LSW0133491,80,20,12,8,1
SBI26VIR6628202,25,24,16,8,1
SBI17ATV3181693,81,28,17,11,1
SBI01BTF9150236,74,21,13,8,1
SBI39FAI0404146,76,31,18,13,1
SBI13DQD8709887,25,27,19,8,1
SBI49KJT9895820,22,25,23,2,1
SBI29YYY1767482,21,34,33,1,1
SBI38SUR6560421,76,25,16,9,1
SBI33TCW0978480,62,28,19,9,1
SBI95SNQ7560325,24,24,22,2,1
SBI54YWY8003771,73,21,15,6,1
SBI27INL4216591,74,31,30,1,1
SBI48JWJ1130283,19,23,21,2,1
SBI60GGK3507402,78,29,27,2,1
SBI47PCM3227715,87,23,17,6,1
SBI38SOC5534773,82,19,14,5,1
SBI35LOQ2534918,21,28,25,3,1
SBI12AQA2238439,18,24,23,1,1
SBI76EWV6356421,76,23,13,10,1
SBI54PAZ1365004,95,24,18,6,1
SBI71PET6690750,78,21,15,6,1
SBI57EGG3826296,74,25,22,3,1
SBI61NLF4846296,68,35,29,6,1
SBI02RDN1109196,79,26,24,2,1
SBI45PVP6684117,78,27,15,12,1
SBI13MVY9974869,96,28,26,2,1
SBI92ZVA9989244,67,23,16,7,1
SBI52ORA0531008,93,30,18,12,1
SBI85RFR1238563,63,28,24,4,1
SBI30OAE5884995,83,26,22,4,1
SBI99HMZ2281823,87,26,22,4,1
SBI23VKR6588446,19,29,23,6,1
SBI95BKF7830023,81,25,19,6,1
SBI26VWA5106705,87,23,20,3,1
SBI21RND6093528,93,19,18,1,1
SBI33AIX2571856,69,22,18,4,1
SBI94IYH9897133,25,18,17,1,1
SBI60DFI8922769,78,28,23,5,1
SBI44LGR8319698,89,21,14,7,1
SBI54YXX6202008,77,28,16,12,1
SBI13GBW6490382,87,21,17,4,1
SBI09KBW1256960,62,18,11,7,1
SBI63HNQ7061765,23,16,10,6,1
SBI20DGV6102789,25,30,21,9,1
SBI51ZTP6356856,71,30,24,6,1
SBI52EMO0791833,24,15,8,7,1
SBI44ENU4266139,79,22,19,3,1
SBI33RWK6516751,82,27,14,13,1
SBI54BQR2420464,67,21,13,8,1
SBI11HYR9807424,97,20,18,2,1
SBI08MMC8437425,76,35,29,6,1
SBI87PGC9239087,65,23,18,5,1
SBI53JMA8246413,63,18,17,1,1
SBI90CCU4246773,64,23,15,8,1
SBI56LBQ5311399,20,20,11,9,1
SBI00SWW3313478,92,18,14,4,1
SBI06DAV0588122,75,32,25,7,1
SBI84BDR3686473,78,23,22,1,1
SBI33NTU7332064,78,24,20,4,1
SBI74EEY8095770,23,26,15,11,1
SBI47OQN0630759,84,31,28,3,1
SBI50JCH9747271,76,30,26,4,1
SBI79KWF5284361,84,23,16,7,1
SBI00GTF5269521,68,26,14,12,1
SBI45MUP1293690,93,24,23,1,1
SBI64ZQS6603122,60,14,12,2,1
SBI56CPH9876205,77,27,14,13,1
SBI48VLB2169781,79,32,28,4,1
SBI82KFP5421376,95,21,17,4,1
SBI79XQU6613263,61,28,27,1,1
SBI89VGT6488176,80,34,29,5,1
SBI75UPD5283234,21,25,17,8,1
SBI83TFG0929945,91,25,21,4,1
SBI89AHW7119474,65,24,23,1,1
SBI59GRP5838570,86,25,19,6,1
SBI68RDC9739257,20,24,13,11,1
SBI65OBV1051406,84,23,15,8,1
SBI02MTA8671858,84,31,16,15,1
SBI73TUU0040806,71,21,19,2,1
SBI45SHS5837860,77,20,12,8,1
SBI33YZD5844140,84,23,19,4,1
SBI50WIY3279901,87,26,24,2,1
SBI84III1715187,79,32,23,9,1
SBI07ZFV5913755,70,29,20,9,1
SBI72GXJ5165353,95,24,22,2,1
SBI84GOW2212946,67,23,17,6,1
SBI81YNN7888489,69,21,20,1,1
SBI71KJP4222805,85,22,13,9,1
SBI92KKM9459710,70,29,15,14,1
SBI13LGC1205592,66,19,14,5,1
SBI04JUR9889471,94,27,15,12,1
SBI32YFW8853336,72,24,19,5,1
SBI56YAZ9907016,88,28,19,9,1
SBI61MLT8366467,88,29,15,14,1
SBI36VKG3874319,72,15,14,1,1
SBI73RYP2136356,70,8,7,1,1
SBI55XLE8586352,90,20,18,2,1
SBI55ROZ6861884,78,20,11,9,1
SBI08LRX8706052,85,15,9,6,1
SBI29ZQE9145119,72,24,22,2,1
SBI91IMU5558732,88,15,14,1,1
SBI76BSQ4170557,90,21,13,8,1
SBI68HVN8207564,62,20,15,5,1
SBI61RZV8841487,87,29,24,5,1
SBI75TQH0537094,83,17,15,2,1
SBI36UYP9439882,91,21,19,2,1
SBI70EWG1061575,66,24,22,2,1
SBI56NRP3552526,73,25,13,12,1
SBI21LFE2322305,91,27,24,3,1
SBI77IST1250772,21,15,9,6,1
SBI58IJK1703342,61,27,15,12,1
SBI21WEI2342333,22,25,14,11,1
SBI12YUE1677278,91,21,15,6,1
SBI94WVA4493980,75,17,14,3,1
SBI04HCL3921603,80,22,15,7,1
SBI27HTG3948780,62,19,13,6,1
SBI04HEI8135337,67,27,26,1,1
SBI32PTJ8747590,20,16,10,6,1
SBI20NEK4427487,82,22,17,5,1
SBI24POS5985708,23,32,25,7,1
SBI36FIY4386621,90,25,15,10,1
SBI26TDT0503350,91,25,17,8,1
SBI34UAA3741656,21,22,12,10,1
SBI40LMW0041687,19,24,22,2,1
SBI85APB5927444,22,31,24,7,1
SBI89CFF6753238,96,21,16,5,1
SBI42DED5744892,76,27,24,3,1
SBI76TWM7132212,96,31,19,12,1
SBI23VMC7958421,89,23,17,6,1
SBI76DYW0575610,85,30,29,1,1
SBI57HEQ6225494,72,23,15,8,1
SBI41VJX0988429,18,25,24,1,1
SBI61HIS9280791,77,28,26,2,1
SBI93OOT8641300,75,26,25,1,1
SBI54DYC7952395,82,23,18,5,1
SBI79VJJ1346954,94,19,12,7,1
SBI30NUX6705999,86,24,20,4,1
SBI88LGI3600721,95,34,32,2,1
SBI91MBH6841554,63,32,27,5,1
SBI29LOC2618390,86,24,16,8,1
SBI95TDT1487401,68,23,13,10,1
SBI55LCE5749022,88,16,12,4,1
SBI25FEG6771655,86,26,21,5,1
SBI48RLC7212032,95,32,18,14,1
SBI92GEN3486779,65,24,18,6,1
SBI11TQI7218245,71,29,17,12,1
SBI65SYS4668361,25,22,14,8,1
SBI14USA0274731,20,25,15,10,1
SBI65BBJ6901158,87,21,15,6,1
SBI88VDR3631034,65,23,19,4,1
SBI40OTH5990175,65,24,19,5,1
SBI89NOL8114921,65,23,14,9,1
SBI02ZAH4614073,77,28,26,2,1
SBI57CHZ8217528,94,21,14,7,1
SBI85VEY9216897,85,31,29,2,1
SBI80VNC8452192,96,23,15,8,1
SBI76ODT9433764,69,24,16,8,1
SBI74WMN3610001,71,24,16,8,1
SBI33MVM8778350,71,25,24,1,1
SBI07HOG8166097,86,22,18,4,1
SBI81UXP7339609,96,22,12,10,1
SBI38GYZ9438587,72,21,15,6,1
SBI81GUJ5090821,92,25,18,7,1
SBI84IRH7607352,62,26,15,11,1
SBI64UWJ4821192,89,26,22,4,1
SBI82VIT2315302,84,26,14,12,1
SBI55ATK1703669,61,28,23,5,1
SBI26SYW6017790,73,19,12,7,1
SBI86IEN0440982,96,18,10,8,1
SBI86WOB2562714,68,24,15,9,1
SBI71WFT5309520,94,22,13,9,1
SBI87SNG6434059,69,30,17,13,1
SBI46BJO9385381,82,28,16,12,1
SBI14EIZ5516946,69,27,17,10,1
SBI19TCJ8134384,73,28,22,6,1
SBI38ACW8493829,97,26,24,2,1
SBI39VGI0092117,99,22,16,6,1
SBI90LKQ0158023,22,24,19,5,1
SBI76XBV3494917,70,26,16,10,1
SBI44UFN5901959,72,25,19,6,1
SBI36OLT9018761,97,27,23,4,1
SBI75JJV8992072,79,28,21,7,1
SBI12HZQ8291696,99,21,19,2,1
SBI63WXJ6130589,91,23,18,5,1
SBI91OUY3632062,20,21,11,10,1
SBI02SAU1511821,96,25,16,9,1
SBI17OXM6592566,88,28,19,9,1
SBI53MEG3302792,85,26,21,5,1
SBI50NJY2217422,89,27,16,11,1
SBI94CBY3366598,91,26,16,10,1
SBI60FVR5133539,86,29,27,2,1
SBI98YCG1644764,25,19,15,4,1
SBI67MLL6807007,18,28,22,6,1
SBI46MHB8896677,24,28,19,9,1
SBI69LKP1871623,95,18,12,6,1
SBI40VKS4409260,90,29,27,2,1
SBI21SZB5704963,25,26,18,8,1
SBI66KTY9676934,81,23,12,11,1
SBI43YLG6398777,20,25,23,2,1
SBI19YLF7565209,75,31,26,5,1
SBI17UHD8283321,19,31,24,7,1
SBI55ORW5656821,63,26,21,5,1
SBI96WJV4323973,66,23,22,1,1
SBI29RCY9321652,82,29,15,14,1
SBI81JKA5609210,85,21,15,6,1
SBI21MJG0886321,99,27,22,5,1
SBI07IRF1533804,78,31,23,8,1
SBI09NHH1431260,90,24,15,9,1
SBI01VIR3128018,76,17,15,2,1
SBI72SIY3891632,87,23,17,6,1
SBI80OAE2368192,63,19,13,6,1
SBI85TCX8839922,65,26,16,10,1
SBI85UVF3733915,67,29,17,12,1
SBI90RDJ6286003,86,19,17,2,1
SBI58LWC2033049,77,31,22,9,1
SBI69KOH0578841,24,18,13,5,1
SBI07SMC1210632,77,39,28,11,1
SBI14ZJK8496373,67,21,14,7,1
SBI73ECX1015020,72,26,24,2,1
SBI12WLH7959359,94,17,14,3,1
SBI89RNO6863469,69,20,14,6,1
SBI42RYS9415092,82,23,21,2,1
SBI95QIT9419569,89,32,26,6,1
SBI55UQM2580178,92,18,17,1,1
SBI50UME0570000,98,33,21,12,1
SBI48ZQQ6693209,99,27,15,12,1
SBI07HPE6706664,88,23,14,9,1
SBI79BYH3488216,25,34,19,15,1
SBI08GDK8232166,99,29,22,7,1
SBI46DEE7017389,23,21,11,10,1
SBI78ZDF0234512,78,30,17,13,1
SBI51AKG3010598,99,24,22,2,1
SBI74ZYK8833283,98,19,10,9,1
SBI61IMF1923726,21,25,17,8,1
SBI60RFY6225313,73,28,15,13,1
SBI68TJN6208220,71,21,15,6,1
SBI74WBL3045739,69,19,16,3,1
SBI83AKT9051202,92,23,13,10,1
SBI12ZAK2545751,78,24,18,6,1
SBI63LPX4959425,84,24,21,3,1
SBI28LMN6233043,81,20,17,3,1
SBI35USI0807203,60,27,20,7,1
SBI08EQQ2774669,19,23,18,5,1
SBI89UQS3888951,78,29,20,9,1
SBI11VWP6394980,66,30,23,7,1
SBI08EDB9142913,75,25,16,9,1
SBI44DZG6577048,93,23,12,11,1
SBI99FRC6100038,24,32,17,15,1
SBI39KOD9739913,95,25,21,4,1
SBI39BGT8123918,98,28,17,11,1
SBI08YKM8180497,25,19,17,2,1
SBI23TES6713066,98,22,12,10,1
SBI16WRL9500090,24,17,16,1,1
SBI36FDM8437143,64,22,13,9,1
SBI59KZD8561996,25,28,25,3,1
SBI72GRW4892764,97,24,15,9,1
SBI80CWY2715525,96,28,19,9,1
SBI83LNP6660742,80,24,18,6,1
SBI58JIZ0759905,25,20,18,2,1
SBI70UDD8322694,60,14,11,3,1
SBI96VUA3538179,67,21,20,1,1
SBI20DXK2901536,63,33,19,14,1
SBI17VWE7231455,70,31,21,10,1
SBI68UVM3965583,86,19,13,6,1
SBI96PGW2168076,91,20,15,5,1
SBI91AHU9268874,21,27,19,8,1
SBI23NCN7005186,89,28,18,10,1
SBI18IOF0755165,87,26,23,3,1
SBI75JGI6335756,64,15,11,4,1
SBI89DVN9460757,86,25,18,7,1
SBI93NDJ9098376,83,23,19,4,1
SBI98PSW2080683,75,22,15,7,1
SBI34QSA1771841,22,24,16,8,1
SBI22ESE4332908,88,25,15,10,1
SBI29IOY9868199,96,22,12,10,1
SBI49WTL3492713,68,30,17,13,1
SBI56OMJ1722936,69,19,16,3,1
SBI68OCI1295675,92,17,11,6,1
SBI87EOJ9670861,76,29,27,2,1
SBI46GOV9486338,69,22,14,8,1
SBI09SNF7983220,91,34,33,1,1
SBI37AMI9430078,93,24,21,3,1
SBI42DJS4980788,85,27,15,12,1
SBI65XGF1395430,91,25,24,1,1
SBI40ZTY3635327,88,25,24,1,1
SBI16YMJ6816755,70,21,20,1,1
SBI69HYD7630496,80,36,30,6,1
SBI27LPP0081553,74,24,19,5,1
SBI19PLO7365684,77,19,17,2,1
SBI69RBS9155488,77,28,27,1,1
SBI33YIW4362897,88,29,15,14,1
SBI73URE6828053,77,24,17,7,1
SBI72WTI0103497,62,26,18,8,1
SBI93OBB1323489,21,19,18,1,1
SBI99KAW9654581,86,24,23,1,1
SBI89GCO6159595,96,25,24,1,1
SBI65OJH4268539,19,22,19,3,1
SBI27DJA4573426,80,32,25,7,1
SBI89QSU4400686,90,25,23,2,1
SBI97JPP4287058,75,32,18,14,1
SBI23FNY6235909,22,27,26,1,1
SBI30MGA2790180,93,20,13,7,1
SBI36XXS3110228,66,21,20,1,1
SBI16HLT1269267,77,35,20,15,1
SBI04LZC6230668,99,22,20,2,1
SBI25SFR0581958,20,19,18,1,1
SBI93LMB7205780,80,25,19,6,1
SBI55SZF1657914,95,30,26,4,1
SBI75QTV9976843,86,25,14,11,1
SBI72CDP4371095,64,23,18,5,1
SBI55EYA1778878,74,34,27,7,1
SBI97EEH7372020,62,17,10,7,1
SBI34TER0302988,78,29,15,14,1
SBI57CSK5621332,19,32,21,11,1
SBI13PSC0088514,23,20,18,2,1
SBI85YPK5716592,72,24,16,8,1
SBI38PYT0751646,70,19,18,1,1
SBI19VKA9422451,72,23,19,4,1
SBI32MXC2016589,82,25,16,9,1
SBI61RJP4517156,95,23,17,6,1
SBI00ELF7179563,64,22,16,6,1
SBI13TDO0556500,62,33,18,15,1
SBI77CJB9140188,61,23,20,3,1
SBI95JXU0936976,82,16,11,5,1
SBI36FTQ8359064,71,22,21,1,1
SBI69FDM3333842,22,21,20,1,1
SBI13QWX9487331,98,31,26,5,1
SBI52EXW2780463,73,22,18,4,1
SBI26MOI2932376,25,20,12,8,1
SBI00DQD8652170,84,26,24,2,1
SBI26PIN9385334,96,22,18,4,1
SBI07XII3728613,18,25,18,7,1
SBI91UXQ4958264,72,22,21,1,1
SBI22PMT1892375,81,28,22,6,1
SBI66TJM1419640,85,30,26,4,1
SBI88ABR4278697,98,35,26,9,1
SBI43ZRV1908882,90,15,11,4,1
SBI75YIC9073335,79,19,16,3,1
SBI93IAV6772131,70,23,19,4,1
SBI01KSG9142815,72,17,14,3,1
SBI90DJD4716039,67,20,13,7,1
SBI01NEV2113532,83,25,19,6,1
SBI04PBI5268651,25,19,17,2,1
SBI49JOX3180812,69,22,13,9,1
SBI79VNR3996430,96,19,10,9,1
SBI83QUA4652591,76,28,20,8,1
SBI87UHD5061963,19,20,18,2,1
SBI28OKK0838137,67,27,17,10,1
SBI41LHY8397173,76,27,16,11,1
SBI14QXA9754089,87,21,12,9,1
SBI58IPS9663368,20,26,15,11,1
SBI60ZXM5543323,87,31,21,10,1
SBI28ILL6628888,66,33,21,12,1
SBI69RWE8770419,91,27,15,12,1
SBI46LKK7105694,99,24,18,6,1
SBI96TJK7095777,95,26,23,3,1
SBI65KOV3659651,22,21,14,7,1
SBI65NXO2471595,73,27,26,1,1
SBI44JHV5396602,69,19,16,3,1
SBI32NET0310394,90,31,27,4,1
SBI81INM7033298,92,22,21,1,1
SBI27RRW8146058,74,22,19,3,1
SBI36GSV1839594,80,34,28,6,1
SBI06ABC7958301,85,23,12,11,1
SBI69RDX5793997,24,27,19,8,1
SBI46REK5977546,64,22,15,7,1
SBI90LSO8977367,23,27,26,1,1
SBI87UZW4430419,94,30,16,14,1
SBI75ASP4673257,65,16,14,2,1
SBI98FXB2911523,64,27,21,6,1
SBI10RGX7713702,19,26,15,11,1
SBI64VNR3334937,25,27,16,11,1
SBI44EZG6037790,81,22,21,1,1
SBI90KHZ7089703,96,32,25,7,1
SBI96BRA9871172,92,18,16,2,1
SBI00QVW1849409,92,30,16,14,1
SBI60KGM6527812,60,16,13,3,1
SBI20CEF7044726,24,22,20,2,1
SBI10FOH2282941,99,23,16,7,1
SBI08OLN1855018,20,21,19,2,1
SBI72VHM8578255,18,16,15,1,1
SBI32GYB4089384,91,25,14,11,1
SBI19ZPU6968065,89,20,14,6,1
SBI46GLW1781745,23,30,21,9,1
SBI12ZBH1415368,89,37,36,1,1
SBI00UXL0541035,92,22,12,10,1
SBI78SOC5940539,62,21,19,2,1
SBI71VLC4347822,20,40,21,19,1
SBI90NYZ0035603,85,35,29,6,1
SBI84IET7195070,22,30,17,13,1
SBI34MUF1477865,66,16,15,1,1
SBI79ANB6019621,91,19,18,1,1
SBI66CSW3032916,75,22,16,6,1
SBI94PVQ7407189,69,34,20,14,1
SBI67BOC6422063,23,28,19,9,1
SBI01QCV9763925,85,26,23,3,1
SBI23FLP1466426,82,20,15,5,1
SBI74BLE4728990,79,22,13,9,1
SBI36CVV6589053,87,21,12,9,1
SBI43AEW1632104,63,23,16,7,1
SBI41RNU6077243,95,27,17,10,1
SBI38WCO1155062,96,20,12,8,1
SBI14VMI6318171,90,22,20,2,1
SBI09HOZ6044877,91,18,14,4,1
SBI00JRP4131438,25,20,16,4,1
SBI09QJP9866063,64,21,17,4,1
SBI21KTW9852553,24,26,14,12,1
SBI07FZU6334147,25,35,28,7,1
SBI75MFZ2173261,98,28,15,13,1
SBI78PNZ7683799,67,19,18,1,1
SBI54OPL6538609,60,29,21,8,1
SBI45DJI0706211,76,20,18,2,1
SBI58HMZ4062142,87,28,21,7,1
SBI49RJL8414064,93,33,27,6,1
SBI39QQN4018698,66,31,26,5,1
SBI61BNT7078148,88,26,17,9,1
SBI51XOP0879640,85,27,14,13,1
SBI33RBZ4151507,70,21,16,5,1
SBI02MGW2053304,72,21,15,6,1
SBI04QSF9453905,70,30,22,8,1
SBI80PXL3207665,80,26,17,9,1
SBI00BOI2994688,68,20,17,3,1
SBI41WFV5529234,20,24,23,1,1
SBI86PYG7328793,76,27,19,8,1
SBI70IHV3181550,98,25,19,6,1
SBI72XBZ6791513,83,15,12,3,1
SBI98JPW6406188,84,21,18,3,1
SBI78FBQ6918453,79,17,11,6,1
SBI90EAS1626181,69,21,20,1,1
SBI61KYV5850546,18,31,23,8,1
SBI02RMZ5963089,93,25,22,3,1
SBI02SAA6114853,86,25,19,6,1
SBI37RBC6317303,75,26,17,9,1
SBI48TZP7950227,60,25,19,6,1
SBI44XVK3863085,22,22,13,9,1
SBI53SDW6855931,91,22,18,4,1
SBI53KDF6677343,83,21,20,1,1
SBI48DAK6011152,83,17,9,8,1
SBI69FEE1566315,86,23,14,9,1
SBI38KOG2018087,79,13,7,6,1
SBI80YCY2489426,93,26,17,9,1
SBI15URT2233739,60,22,15,7,1
SBI03EUR0679924,84,20,19,1,1
SBI84EGT6781810,60,25,23,2,1
SBI23LXY8201583,91,26,15,11,1
SBI84ZJL3398772,88,33,25,8,1
SBI22HNU5184613,19,15,9,6,1
SBI27HAC7367577,79,16,15,1,1
SBI03ERZ6911928,22,21,17,4,1
SBI20UVH9853422,99,18,10,8,1
SBI27GCV0422374,96,28,25,3,1
SBI52JHI1396367,92,24,13,11,1
SBI66FAW6655082,88,26,24,2,1
SBI08RCX2751701,67,24,23,1,1
SBI19SCV4258364,73,21,17,4,1
SBI69FZL2393432,19,29,19,10,1
SBI64DBH4177090,85,16,10,6,1
SBI95PXA0859355,72,24,22,2,1
SBI30STQ4422892,62,29,19,10,1
SBI27QXO2099999,21,21,15,6,1
SBI18MWL5968972,85,27,16,11,1
SBI01QKD5391160,69,27,24,3,1
SBI47NNS0025428,99,24,19,5,1
SBI51MDS3197440,83,23,22,1,1
SBI73QEL2221144,62,23,20,3,1
SBI15RRE3275494,83,26,15,11,1
SBI33XHX8178097,23,24,19,5,1
SBI67WCI9340249,66,18,13,5,1
SBI72RQV0754823,98,33,17,16,1
SBI22RLP9084327,79,19,18,1,1
SBI89ALD8508422,71,35,23,12,1
SBI19UNF6072432,19,32,21,11,1
SBI24SGT1404692,18,32,21,11,1
SBI11LEU6932791,76,31,18,13,1
SBI70ZKB2521421,85,24,15,9,1
SBI06IYO7093477,77,22,18,4,1
SBI35CKD4981027,82,30,23,7,1
SBI75DAY3236214,88,17,11,6,1
SBI76KHL1022307,82,27,25,2,1
SBI88GKG8481097,21,23,16,7,1
SBI09NHM8186520,67,27,20,7,1
SBI59MMN8644099,98,20,16,4,1
SBI41XCQ6654298,60,23,22,1,1
SBI62LCM2080697,85,23,16,7,1
SBI97KKQ8839001,67,21,19,2,1
SBI32LAM9885246,92,29,25,4,1
SBI31QUB7345319,70,28,19,9,1
SBI16GOB5743285,74,34,28,6,1
SBI37ZCN2522556,98,23,22,1,1
SBI54WZN0055306,73,20,12,8,1
SBI74TNV2463481,68,18,11,7,1
SBI12BRT3003407,86,25,19,6,1
SBI18WNS7037934,96,23,21,2,1
SBI50DFI9390842,21,19,18,1,1
SBI13SAT8861604,92,30,23,7,1
SBI01UWH6527666,92,32,29,3,1
SBI45YSA1694585,70,29,20,9,1
SBI25JXD9232540,64,24,14,10,1
SBI92XZX6106596,20,26,20,6,1
SBI36YVU4897869,70,27,20,7,1
SBI72VUQ4574267,83,32,21,11,1
SBI60ISO0814606,18,27,15,12,1
SBI77JWY7850212,71,22,18,4,1
SBI52JMH3515818,25,23,14,9,1
SBI07CRA3312907,79,31,24,7,1
SBI30QFK5336582,25,29,22,7,1
SBI68LKV8591355,95,26,16,10,1
SBI28LDE9280780,80,27,21,6,1
SBI19PZA5380129,96,32,18,14,1
SBI72ANS2834919,23,23,18,5,1
SBI32FVX8650366,88,23,16,7,1
SBI36MGW8437142,24,32,31,1,1
SBI04VPS9691652,76,22,19,3,1
SBI95YQW5756402,83,25,18,7,1
SBI79UWG7824372,71,29,15,14,1
SBI66PPT3343850,62,25,24,1,1
SBI99LIM8650969,92,21,18,3,1
SBI25HFE0601300,60,32,20,12,1
SBI17OYZ7454879,23,27,15,12,1
SBI82ZYD0970461,88,19,12,7,1
SBI91MCO1884663,70,20,15,5,1
SBI71DFI9357586,91,24,14,10,1
SBI74CTR1858045,63,16,10,6,1
SBI82APN8574609,60,22,20,2,1
SBI74CUJ4999954,74,17,12,5,1
SBI42QXL8356156,99,24,16,8,1
SBI58XTR0384503,67,32,31,1,1
SBI17XCL4659043,25,25,23,2,1
SBI12HIU8431004,82,32,22,10,1
SBI78DEF8991493,72,19,15,4,1
SBI56TIQ8099072,69,26,18,8,1
SBI23VJZ3347184,70,15,14,1,1
SBI37JEU0142889,61,24,14,10,1
SBI47RMH2575204,65,26,22,4,1
SBI77CCI5455148,71,25,17,8,1
SBI46OGI6070228,84,28,23,5,1
SBI00MVR5484294,60,20,11,9,1
SBI52HPA3195151,23,37,29,8,1
SBI22LWB6073390,82,32,31,1,1
SBI72BRR3675227,81,27,21,6,1
SBI04XAN4250071,90,29,20,9,1
SBI18XOM0065006,23,20,13,7,1
SBI79KIW2813088,23,27,14,13,1
SBI04TGP2296181,83,21,14,7,1
SBI58LBJ0291368,78,24,17,7,1
SBI53TVZ3089742,98,22,19,3,1
SBI79HPJ7800886,78,27,23,4,1
SBI15FRR4066633,24,30,23,7,1
SBI64JWY8360451,63,21,19,2,1
SBI12JFC1769298,73,30,17,13,1
SBI20LPP3092806,66,20,13,7,1
SBI69SFI1471466,74,28,17,11,1
SBI69TID6416484,62,30,27,3,1
SBI26QHW6924363,68,30,19,11,1
SBI93DLW7326505,71,24,20,4,1
SBI06PAJ2235653,89,21,13,8,1
SBI16QWY0299826,87,29,20,9,1
SBI37HJR6196957,98,28,21,7,1
SBI02IWN0002899,62,25,22,3,1
SBI53JDA0850330,77,19,10,9,1
SBI25SKX7756505,82,27,14,13,1
SBI37HFP2073432,88,27,16,11,1
SBI63UUI2362291,98,32,21,11,1
SBI84MNW7831814,66,31,22,9,1
SBI44OJR5093479,78,20,14,6,1
SBI07FHD9141322,75,21,20,1,1
SBI65UKM2929805,20,30,24,6,1
SBI47MFB5833890,87,28,19,9,1
SBI40RLZ2512378,20,27,23,4,1
SBI85KUZ2438549,94,24,16,8,1
SBI79NET2531043,61,24,14,10,1
SBI77ACJ5315184,62,27,20,7,1
SBI58KJJ2224385,81,23,15,8,1
SBI80CTN2973554,61,28,27,1,1
SBI28XSY3663808,78,12,9,3,1
SBI03KSG8186518,84,26,15,11,1
SBI31OBO9643241,19,23,21,2,1
SBI03VTJ4484936,60,11,9,2,1
SBI29YOC0957222,61,20,18,2,1
SBI98UNL9219394,19,30,22,8,1
SBI67UHT7836297,72,29,21,8,1
SBI58HOQ4366011,86,24,20,4,1
SBI70PCI9629513,97,29,27,2,1
SBI08SST2441821,75,24,23,1,1
SBI89WKV6317741,79,36,23,13,1
SBI81ZHP7981116,88,20,16,4,1
SBI62WEO9200631,62,25,19,6,1
SBI48PZP4733932,62,19,18,1,1
SBI90QOV4028062,81,24,13,11,1
SBI62QQZ1596369,85,26,24,2,1
SBI79NYM5245877,87,25,15,10,1
SBI89CNY9178509,90,15,8,7,1
SBI85PNF7439428,75,26,22,4,1
SBI74PML6694827,63,21,11,10,1
SBI62TSW7897674,94,20,19,1,1
SBI32NVW8785132,21,20,19,1,1
SBI83XCW8764583,20,29,27,2,1
SBI79ULD6703687,90,18,16,2,1
SBI28ELS5129556,18,26,14,12,1
SBI06RWF2074319,89,22,21,1,1
SBI78VOH9925480,68,32,30,2,1
SBI51NPJ3187373,79,25,16,9,1
SBI71ESQ4231516,70,26,19,7,1
SBI56AUD8756035,92,24,23,1,1
SBI42DKE5516017,76,28,19,9,1
SBI59ZHG1270804,64,31,26,5,1
SBI90ZQK7475804,62,19,13,6,1
SBI19UTZ0852377,64,25,15,10,1
SBI83FVG2631439,80,26,23,3,1
SBI18FNG6393738,64,27,14,13,1
SBI87IKW6766437,97,25,14,11,1
SBI58UMB8079632,83,20,13,7,1
SBI41OOX6017363,60,25,20,5,1
SBI34CTQ2042085,82,22,17,5,1
SBI60GLJ5606046,99,22,12,10,1
SBI66LQJ7958831,60,23,19,4,1
SBI75WPC1427255,21,21,12,9,1
SBI10RSE2432079,24,25,22,3,1
SBI67TZL1982554,65,25,24,1,1
SBI29QGM9654513,24,26,18,8,1
SBI16IMF9654774,82,26,20,6,1
SBI28ABP8970787,61,19,17,2,1
SBI97AJO0568093,82,30,26,4,1
SBI23UAD9427448,87,29,21,8,1
SBI02FXB6142754,63,26,16,10,1
SBI98JCG8606345,92,24,13,11,1
SBI48HMY0815958,69,25,23,2,1
SBI85XLX2677682,72,25,15,10,1
SBI75MFP9195395,22,28,24,4,1
SBI37RNA5716936,99,27,22,5,1
SBI00GFU8121084,23,24,22,2,1
SBI25QXH1160727,72,24,22,2,1
SBI68XGQ5656925,20,18,14,4,1
SBI12PJE7341577,80,25,16,9,1
SBI22WUU8006684,84,22,12,10,1
SBI67UCU3202814,98,21,17,4,1
SBI44GOH1160313,21,19,11,8,1
SBI88YTX0004522,83,22,19,3,1
SBI87YXP0121302,93,29,17,12,1
SBI59QVR1647746,70,30,29,1,1
SBI22TFW3275831,77,21,18,3,1
SBI53ABR8998961,23,31,20,11,1
SBI46DQG9658732,98,29,27,2,1
SBI63FIO3152198,93,27,18,9,1
SBI11RGS1385150,20,16,10,6,1
SBI10HTQ3835538,62,32,25,7,1
SBI12IVY4682300,89,20,16,4,1
SBI88GGR5360545,82,24,22,2,1
SBI43QRQ5970540,20,35,25,10,1
SBI67FUK2464492,76,28,21,7,1
SBI07SOI7042537,71,30,25,5,1
SBI00RKW4893026,65,24,22,2,1
SBI72IEP2667531,62,20,11,9,1
SBI85QJU6863750,92,24,19,5,1
SBI49BEY6177793,99,28,22,6,1
SBI73FMV2425269,85,22,20,2,1
SBI94QCZ8906942,87,22,16,6,1
SBI60CZU9722513,99,18,11,7,1
SBI57IBS4825170,74,28,26,2,1
SBI39UAH7225100,91,29,15,14,1
SBI82YOK4784618,91,24,19,5,1
SBI93NHN5343624,18,30,26,4,1
SBI38GQV7492715,66,21,12,9,1
SBI98TAP3528129,73,26,22,4,1
SBI07PXZ3554936,22,23,14,9,1
SBI05TJE8536409,73,23,15,8,1
SBI97QUZ2564594,89,22,16,6,1
SBI26JPV0154497,98,23,13,10,1
SBI64TPO4880214,88,29,21,8,1
SBI68YRW8170151,23,21,19,2,1
SBI93JEO7719629,75,29,28,1,1
SBI50BOM1920141,94,42,24,18,1
SBI08ICJ6230917,19,24,18,6,1
SBI68TXI9416110,67,27,22,5,1
SBI94UKQ1491383,78,20,17,3,1
SBI88VZR9004385,85,32,25,7,1
SBI03XPL1986950,25,19,14,5,1
SBI84AQX1351182,25,28,27,1,1
SBI61QGZ1505950,63,24,20,4,1
SBI75OJU3335483,77,16,15,1,1
SBI59XDU8126435,22,32,20,12,1
SBI07PCL0394507,72,22,14,8,1
SBI01TRM5028919,93,22,17,5,1
SBI47XMA5410096,99,27,24,3,1
SBI62SJL5639023,88,25,24,1,1
SBI68VEP2400428,76,24,21,3,1
SBI66QJW4325560,77,26,21,5,1
SBI98HLB8487009,83,29,27,2,1
SBI63HNS0375880,76,26,23,3,1
SBI65ZVA0228388,70,23,15,8,1
SBI30OFR4768529,81,30,29,1,1
SBI87HFT4309886,85,18,12,6,1
SBI30RLP1096006,24,26,22,4,1
SBI78QSP0989737,77,24,16,8,1
SBI25EOD2927942,81,23,13,10,1
SBI23VWD1548232,97,14,8,6,1
SBI38XZM1645566,80,21,12,9,1
SBI26HRA4901482,75,21,11,10,1
SBI47ASN1805878,23,19,11,8,1
SBI46DIR9232548,95,26,21,5,1
SBI09BXC3052957,79,15,9,6,1
SBI69HNB5595640,98,29,24,5,1
SBI58HDK7311792,88,24,18,6,1
SBI29ARS6497488,73,25,21,4,1
SBI65AFR8655033,70,18,12,6,1
SBI34FWE2652588,19,24,19,5,1
SBI64BYV0930945,66,26,22,4,1
SBI34ICJ5976830,65,22,17,5,1
SBI32RTQ9317515,80,22,14,8,1
SBI13HUS7167923,93,21,20,1,1
SBI24EAX7440836,74,25,23,2,1
SBI72LHL9418937,93,26,23,3,1
SBI56XQS9889475,87,29,15,14,1
SBI40FYP1097793,81,30,27,3,1
SBI44YBL5014082,85,15,10,5,1
SBI45ZRR5487565,77,29,15,14,1
SBI68GBZ2210971,96,26,15,11,1
SBI01KDF3299145,69,33,30,3,1
SBI86XWC6796512,61,27,18,9,1
SBI25SPM2567910,65,35,18,17,1
SBI22GJY7649313,80,28,23,5,1
SBI54MRS4177085,22,33,31,2,1
SBI20YSA0714452,94,26,14,12,1
SBI50OCM8589793,76,26,17,9,1
SBI01QIE9538872,60,30,22,8,1
SBI20RME3593391,66,26,14,12,1
SBI43NBQ1511229,22,22,16,6,1
SBI75HKB0399075,18,23,17,6,1
SBI29LDS1289064,84,25,14,11,1
SBI09LQV2927161,21,30,17,13,1
SBI25UVV5732117,61,17,10,7,1
SBI22FRK0162540,97,14,10,4,1
SBI73APX2242558,68,19,13,6,1
SBI92VBW4654986,93,25,16,9,1
SBI24YFI5194862,67,27,16,11,1
SBI96ZGA7859565,98,22,18,4,1
SBI86RCB2615106,71,18,13,5,1
SBI04CQT4849052,82,20,14,6,1
SBI18XLK4519233,66,25,13,12,1
SBI37EWK2936774,75,22,12,10,1
SBI80ZIV7297329,88,31,23,8,1
SBI43PUI1018851,98,23,13,10,1
SBI83DMQ1400252,69,18,13,5,1
SBI20KUM8812768,84,25,18,7,1
SBI99ZET5280234,24,26,25,1,1
SBI23BRP2945332,96,30,19,11,1
SBI40ARU7198707,74,23,12,11,1
SBI05WGF0921231,91,23,22,1,1
SBI98FCB5528488,73,18,15,3,1
SBI64OQP5581651,67,26,24,2,1
SBI61HYW0828348,21,21,18,3,1
SBI65PTO5393845,88,23,18,5,1
SBI06XDS6663188,90,16,9,7,1
SBI22FCJ3621388,83,19,12,7,1
SBI40YPW3996332,62,26,14,12,1
SBI77UAV9607771,72,23,13,10,1
SBI72LZA3276243,72,28,16,12,1
SBI19DSL6293274,90,12,7,5,1
SBI62DUN6665809,87,21,15,6,1
SBI15QSY9666704,93,34,22,12,1
SBI66SBD7667414,69,19,15,4,1
SBI44ECI5658845,63,35,28,7,1
SBI90UZP5790862,96,21,16,5,1
SBI33YNN5877714,84,19,12,7,1
SBI45WDL0709552,77,24,13,11,1
SBI83DOC2079444,87,21,16,5,1
SBI87UMU8630696,95,32,18,14,1
SBI23DUW6842826,20,25,18,7,1
SBI38LKT5750641,79,23,14,9,1
SBI91YKR0997278,93,24,22,2,1
SBI75JDA8532878,20,24,17,7,1
SBI43MJR2286475,24,25,19,6,1
SBI38FBE2283926,87,21,11,10,1
SBI33YZT9012300,22,22,18,4,1
SBI49RMN3432105,94,31,23,8,1
SBI67QKZ8904487,19,24,21,3,1
SBI03DYY2404731,61,25,15,10,1
SBI89LAV6204898,71,15,13,2,1
SBI18DBO6622176,24,26,17,9,1
SBI54MJA5771939,70,25,21,4,1
SBI90QET4580705,72,27,26,1,1
SBI85YZN2156290,20,25,13,12,1
SBI58WSK3466507,86,21,17,4,1
SBI46KMV9419177,95,24,13,11,1
SBI12QFL2361460,83,22,15,7,1
SBI82MUQ3553182,88,23,15,8,1
SBI58MZF0034546,92,32,31,1,1
SBI23YVG2662285,83,25,23,2,1
SBI35JZB8980740,22,27,25,2,1
SBI39OHE3967736,97,22,18,4,1
SBI56KJQ7855685,60,28,19,9,1
SBI79KQP7903922,22,30,18,12,1
SBI17BAE6299570,74,26,20,6,1
SBI79BVO2696139,22,26,21,5,1
SBI70OBZ0427339,83,29,16,13,1
SBI01VZA6313610,65,27,23,4,1
SBI78ESM1206031,19,26,17,9,1
SBI35WBI6098516,68,21,20,1,1
SBI01HAW7538067,82,26,15,11,1
SBI29TTV1689394,97,17,12,5,1
SBI69TAD9762485,20,22,19,3,1
SBI29YVX0623335,69,24,19,5,1
SBI45YNN2115408,20,15,8,7,1
SBI78KKV5693685,64,22,19,3,1
SBI90TEM0404294,71,19,17,2,1
SBI62DGF1226465,83,25,16,9,1
SBI11AYI0022483,72,29,24,5,1
SBI34QMU8462893,63,22,13,9,1
SBI14JWL1845807,94,33,20,13,1
SBI49ZGR1063453,22,9,7,2,1
SBI18FFG3482236,95,25,18,7,1
SBI65XWH4766678,88,24,16,8,1
SBI23TFN2519569,91,23,15,8,1
SBI96GZN9573220,97,26,20,6,1
SBI21XYZ4788606,25,28,16,12,1
SBI33HYH4171093,81,23,14,9,1
SBI68IKQ0323942,18,23,15,8,1
SBI35ANA9877217,63,30,24,6,1
SBI34ZEI4210559,79,28,20,8,1
SBI99RXB8932098,61,20,15,5,1
SBI81DGO7424049,98,22,14,8,1
SBI00XBE1438240,92,28,22,6,1
SBI81MTR3787580,60,23,13,10,1
SBI66TKQ0646161,25,23,19,4,1
SBI50PDD2086185,91,18,14,4,1
SBI49IHL3136232,76,22,15,7,1
SBI69LEY7844195,89,30,19,11,1
SBI87NQQ7000542,83,25,20,5,1
SBI44YAJ4987530,20,30,25,5,1
SBI45CND7120779,21,21,16,5,1
SBI29ZDF7189297,80,21,19,2,1
SBI16OLW7128265,71,29,27,2,1
SBI03SEV3564234,69,24,17,7,1
SBI31XPX9119658,98,22,13,9,1
SBI65VIH6065021,83,29,15,14,1
SBI35HJU9118657,75,37,29,8,1
SBI32UAW9544257,95,29,20,9,1
SBI83IES7124197,71,31,17,14,1
SBI87JYL4871053,90,26,17,9,1
SBI54OFL2468966,60,18,15,3,1
SBI63YDG2008754,95,24,22,2,1
SBI75LIM8158598,66,19,17,2,1
SBI06ANK9586459,25,25,19,6,1
SBI97JDB3700979,90,22,14,8,1
SBI89QEK8078585,67,20,11,9,1
SBI59GVW6729451,70,20,18,2,1
SBI59NME5819196,90,23,20,3,1
SBI60HML3714001,19,21,20,1,1
SBI21QQE4175371,85,25,16,9,1
SBI98KJH7005019,79,22,19,3,1
SBI41ZMM7516084,84,26,24,2,1
SBI05KHJ3649034,78,31,17,14,1
SBI42YMK4448170,97,22,14,8,1
SBI57ZCC5478930,63,28,21,7,1
SBI81XWJ0375434,66,17,9,8,1
SBI93HRY7580275,96,22,18,4,1
SBI36XFY6715077,69,25,24,1,1
SBI17CEL9617988,69,21,13,8,1
SBI90RHS9469564,19,27,18,9,1
SBI71DUB8539886,22,25,21,4,1
SBI83IKA8257299,21,18,12,6,1
SBI99PNF4717216,61,26,22,4,1
SBI17MYE0162115,68,28,17,11,1
SBI68WTI5481357,76,20,18,2,1
SBI47CAV6741774,62,32,19,13,1
SBI51CZT4742177,78,33,28,5,1
SBI08NKS3164492,62,26,25,1,1
SBI84GAS3262887,77,32,23,9,1
SBI53AFV4372796,69,28,25,3,1
SBI74SIZ0695157,98,26,22,4,1
SBI28KJS3427989,84,21,17,4,1
SBI71QZJ6371609,96,31,28,3,1
SBI16DTK4300461,61,25,22,3,1
SBI85DHJ1353915,61,31,23,8,1
SBI62OOV5051218,61,27,18,9,1
SBI76FRZ3311590,90,25,17,8,1
SBI00VLA2832464,88,27,26,1,1
SBI03AQE4836619,86,28,24,4,1
SBI70ROQ5586079,67,13,8,5,1
SBI76EIZ5681555,20,26,23,3,1
SBI57XVL4611614,70,21,14,7,1
SBI40LEP9817421,88,19,15,4,1
SBI31JJN6635462,66,19,17,2,1
SBI49SWV0469868,21,27,16,11,1
SBI78VAG7329233,76,27,24,3,1
SBI15CMC0409443,66,22,18,4,1
SBI29ADC9813726,23,26,14,12,1
SBI17GHH2679868,99,29,24,5,1
SBI06WZU6342165,64,26,21,5,1
SBI36XSM1877103,85,23,21,2,1
SBI31AVT5430841,99,22,21,1,1
SBI90OPF2724899,61,21,12,9,1
SBI57FDK5562235,74,20,11,9,1
SBI75BXP1465303,60,17,15,2,1
SBI04XSU1838097,21,24,13,11,1
SBI51FKZ1694743,66,22,12,10,1
SBI50RRC0717484,89,19,13,6,1
SBI55KJF4293363,91,30,25,5,1
SBI95VOS2114484,71,30,18,12,1
SBI53QZI9810642,60,25,17,8,1
SBI51IUL5424100,78,26,16,10,1
SBI45DBF5118307,82,25,22,3,1
SBI67MDJ9752602,22,21,20,1,1
SBI93SLX2463084,19,22,18,4,1
SBI48BIM4245910,93,23,22,1,1
SBI29ZTU3434984,90,24,16,8,1
SBI29IQH2980647,22,22,21,1,1
SBI37FTK0198769,75,30,25,5,1
SBI27CHA9897314,73,26,20,6,1
SBI86PUM0531023,97,30,26,4,1
SBI72DPU0619680,78,22,14,8,1
SBI39CFW7880248,65,26,23,3,1
SBI77OEI7519870,81,34,21,13,1
SBI53GIL9815056,69,23,18,5,1
SBI50QNH5923639,69,35,27,8,1
SBI91GXU8340772,24,25,23,2,1
SBI59ADR1308006,75,20,14,6,1
SBI34XKA7098853,25,22,19,3,1
SBI21RDR9184846,92,22,17,5,1
SBI05GVV1138693,78,30,26,4,1
SBI39NRS0324270,90,20,16,4,1
SBI53MEJ3040700,68,21,19,2,1
SBI73SCO9259744,64,22,12,10,1
SBI09HIZ0065495,64,24,23,1,1
SBI66REO1774408,90,25,19,6,1
SBI59SRC2233342,62,24,23,1,1
SBI16SWU6347063,78,18,17,1,1
SBI91ZZC1431550,73,17,12,5,1
SBI05PMW4033416,85,22,21,1,1
SBI24ALV3604963,70,22,21,1,1
SBI87EJQ7694045,89,26,18,8,1
SBI81PKT5632873,69,20,17,3,1
SBI10GGJ3148235,61,22,14,8,1
SBI82XZB8643561,69,22,20,2,1
SBI78MAK8211753,91,26,20,6,1
SBI62MNI0330197,82,35,30,5,1
SBI58OAC1565162,97,23,18,5,1
SBI21ZNC8134959,94,22,12,10,1
SBI96HJN0733449,74,29,15,14,1
SBI50NZB7858123,96,16,15,1,1
SBI89WER0957507,84,22,15,7,1
SBI56YRZ4137674,98,33,18,15,1
SBI64ZRY6363020,87,19,17,2,1
SBI12WKB7405125,96,20,11,9,1
SBI69SUV7097261,18,24,13,11,1
SBI72TEF7957647,19,33,17,16,1
SBI02EAY3624812,21,27,14,13,1
SBI12YOR2050253,83,25,19,6,1
SBI98BNP4712164,63,18,11,7,1
SBI21RYB6461707,77,25,20,5,1
SBI85XBC0923908,77,19,11,8,1
SBI18IRR4643897,87,22,20,2,1
SBI17UWK2824295,84,18,12,6,1
SBI84IMB8756439,84,22,18,4,1
SBI65PSC5807076,69,31,18,13,1
SBI04OGE3499986,23,30,25,5,1
SBI86TBX4411368,94,18,15,3,1
SBI23BUR1228313,89,22,14,8,1
SBI78PNE8026694,95,22,16,6,1
SBI37YIU1010956,89,22,16,6,1
SBI91UTU3038728,70,29,26,3,1
SBI01SIA1838943,90,20,13,7,1
SBI91BEL3184532,78,21,20,1,1
SBI39SFP8306938,72,27,24,3,1
SBI99FZA9700499,22,28,25,3,1
SBI92GIO0387848,64,19,18,1,1
SBI38WCU0935429,19,16,11,5,1
SBI36ROP8849508,91,23,12,11,1
SBI11MWA7733645,74,21,11,10,1
SBI99LGE5037554,78,31,23,8,1
SBI73SSE9873750,99,27,22,5,1
SBI28OZV3120749,61,32,31,1,1
SBI22RWD5304583,79,23,16,7,1
SBI24ZFC0488284,19,19,12,7,1
SBI00IIN9653647,89,29,22,7,1
SBI90GDM7314456,22,26,23,3,1
SBI92DKO4726770,75,21,16,5,1
SBI83SCV9667495,62,14,12,2,1
SBI84QUR4019604,96,22,15,7,1
SBI83YHB0710984,73,23,20,3,1
SBI05SQL8263342,68,31,29,2,1
SBI18APH2674828,78,21,20,1,1
SBI86LIG8267404,89,15,13,2,1
SBI97ZDG0490452,73,27,22,5,1
SBI33XCF1011781,99,21,14,7,1
SBI79FJF6262879,86,27,14,13,1
SBI48TVV0196983,79,28,15,13,1
SBI58ZKQ6938020,92,31,19,12,1
SBI82QLJ7682138,82,21,17,4,1
SBI62CNW0861678,22,29,16,13,1
SBI99RZN0552509,63,21,11,10,1
SBI08BNK7347513,99,18,14,4,1
SBI36FOO5706072,61,19,11,8,1
SBI14BCC8573062,62,25,19,6,1
SBI11KFT9921443,69,29,22,7,1
SBI76GTC5226696,21,19,10,9,1
SBI29QHD6729143,75,32,26,6,1
SBI94KSI3358098,93,25,23,2,1
SBI02KIN1411653,93,20,16,4,1
SBI72MAJ0776530,64,25,19,6,1
SBI69EGF5221016,23,22,13,9,1
SBI48AHB5936434,92,26,18,8,1
SBI49TPX4066059,83,23,18,5,1
SBI72JSS6776481,69,29,19,10,1
SBI47PDR2873505,67,14,9,5,1
SBI36JQT9536319,69,27,16,11,1
SBI82QIT4193513,70,32,23,9,1
SBI93RSH5964086,88,23,21,2,1
SBI18JUK9190429,84,27,23,4,1
SBI74WNX0454608,63,18,11,7,1
SBI27CEI5905488,73,21,11,10,1
SBI63LFP9542231,94,22,20,2,1
SBI55TJJ6845123,89,22,20,2,1
SBI63UGH6920079,75,30,17,13,1
SBI78ABN4567379,80,35,25,10,1
SBI01DKX2268366,75,24,22,2,1
SBI67FQL7537956,70,22,13,9,1
SBI77NJI4844915,91,19,12,7,1
SBI15HOH7457375,85,23,17,6,1
SBI04BUG6636039,73,24,21,3,1
SBI95FVZ2861157,22,22,14,8,1
SBI12DCE0369968,67,23,19,4,1
SBI52ROV5246469,72,18,13,5,1
SBI27WGX6930593,77,24,16,8,1
SBI69DPI4468515,93,19,17,2,1
SBI86PUP4727063,68,22,21,1,1
SBI14ZZU1682512,82,15,13,2,1
SBI37VEH0661810,93,17,14,3,1
SBI14PLV7442697,94,22,13,9,1
SBI83QGW2186629,60,31,23,8,1
SBI65AQE5560743,21,28,27,1,1
SBI26PBM9675002,18,27,25,2,1
SBI26DFT8799259,81,27,21,6,1
SBI46INI8710261,97,30,26,4,1
SBI27CUK3678599,84,16,10,6,1
SBI18AMF6227090,98,30,20,10,1
SBI14OOX6805043,20,18,17,1,1
SBI11QVK1256552,23,24,19,5,1
SBI04AKJ3247671,63,28,25,3,1
SBI59KXN2049640,96,23,18,5,1
SBI84YGY8355673,73,23,13,10,1
SBI08AQL6189757,91,22,21,1,1
SBI66XOC2700275,24,29,17,12,1
SBI12TTR4419029,63,31,24,7,1
SBI69DWR6845215,79,20,17,3,1
SBI17MAC8589476,83,30,26,4,1
SBI75GJJ0821443,71,27,16,11,1
SBI37UGY5030559,80,23,16,7,1
SBI32GET4520364,71,21,14,7,1
SBI94RWQ4937799,71,30,23,7,1
SBI99YBK3883352,88,20,18,2,1
SBI16YMU6407492,95,21,18,3,1
SBI47MJS9423039,88,23,16,7,1
SBI94YFO3918320,22,31,18,13,1
SBI66IEB7226642,20,22,21,1,1
SBI15UWW8563593,91,12,10,2,1
SBI22DWG5293412,70,23,22,1,1
SBI22ZTM1723661,22,21,14,7,1
SBI69IPU2016426,94,23,13,10,1
SBI62FLG2541493,66,27,20,7,1
SBI59LPV9891183,76,26,14,12,1
SBI62TGS5091622,60,24,21,3,1
SBI41ENJ0882337,80,23,14,9,1
SBI17FJD6932946,63,29,25,4,1
SBI80DNT5350813,84,29,24,5,1
SBI73WRD0949878,19,24,15,9,1
SBI69LUS7116355,22,26,17,9,1
SBI24IZI6571657,19,23,21,2,1
SBI06RQG3827059,76,27,15,12,1
SBI30CSJ9595786,23,25,23,2,1
SBI28IWQ6923371,96,31,17,14,1
SBI04QBK3502229,79,22,17,5,1
SBI01NLB9625782,97,25,19,6,1
SBI93ZGA3513751,67,27,14,13,1
SBI99OIP4948957,79,34,30,4,1
SBI45JWR5305657,89,28,27,1,1
SBI26GWB1905275,79,24,15,9,1
SBI08GTY4379980,94,25,18,7,1
SBI79ZFO7374480,91,30,23,7,1
SBI12RZM0972214,86,26,20,6,1
SBI74CBL5105338,97,30,18,12,1
SBI13ODM5461595,64,29,18,11,1
SBI59BAU5510498,90,15,8,7,1
SBI87CGF3519781,20,22,20,2,1
SBI15HLS1077678,85,28,26,2,1
SBI87TFN8774186,78,23,20,3,1
SBI46XPW2235665,77,30,19,11,1
SBI75TRL9862448,83,25,17,8,1
SBI35CWD5957052,66,20,11,9,1
SBI19KEW2147746,83,28,26,2,1
SBI80RFH9863342,71,32,26,6,1
SBI26EIN2178514,77,30,26,4,1
SBI14GVV1997765,80,27,16,11,1
SBI59ILK0637948,61,23,22,1,1
SBI74JYH7088029,24,24,19,5,1
SBI97WMA5294502,90,29,21,8,1
SBI05KJA8614471,85,24,14,10,1
SBI97ZQF5147087,87,16,15,1,1
SBI55LXR8017695,93,20,13,7,1
SBI55KUO0617083,75,23,18,5,1
SBI00VEH2734541,81,28,23,5,1
SBI65VWI4387429,61,28,27,1,1
SBI20MNW3534095,82,18,15,3,1
SBI91IHQ8282329,71,20,18,2,1
SBI40YVM1110206,24,19,17,2,1
SBI13KZG1414366,71,21,13,8,1
SBI51DBM9388472,60,20,18,2,1
SBI40ZPJ8957437,90,30,26,4,1
SBI15RUP2125896,96,25,22,3,1
SBI23FMV9904001,70,27,26,1,1
SBI90UJP5889482,83,26,18,8,1
SBI88DAT2220207,61,20,11,9,1
SBI29ECF1728476,76,18,15,3,1
SBI61PRU2800969,19,27,19,8,1
SBI64SJK1083248,72,14,8,6,1
SBI53SQL6361616,81,25,19,6,1
SBI92TJG6025858,88,27,25,2,1
SBI68XLR0897882,79,36,22,14,1
SBI68NIX1711720,97,33,27,6,1
SBI08SSD9347582,96,20,11,9,1
SBI59YSF8016348,20,33,28,5,1
SBI73KFB2830688,92,24,18,6,1
SBI60RFH0932864,63,18,11,7,1
SBI01VUO0359639,88,17,11,6,1
SBI55LPP5526673,95,27,14,13,1
SBI77SNT4176682,21,29,17,12,1
SBI62FYH3207278,82,24,15,9,1
SBI11EZX6702587,23,28,20,8,1
SBI99SOQ7721974,76,26,19,7,1
SBI70HBF6453602,84,26,22,4,1
SBI18VUT4979077,19,17,16,1,1
SBI37EYD4430621,64,18,12,6,1
SBI95CLF2943055,78,27,22,5,1
SBI48DEZ5569162,94,33,31,2,1
SBI22RWW7744530,78,17,16,1,1
SBI14LDL5831835,62,31,26,5,1
SBI01SDP2338176,24,19,17,2,1
SBI64SDZ4592569,88,20,11,9,1
SBI98APA6106302,93,26,18,8,1
SBI02DVA5520854,94,35,24,11,1
SBI07PTM4719383,68,32,18,14,1
SBI27NFS8417705,25,33,18,15,1
SBI53GHZ0378622,75,31,29,2,1
SBI95QPY1998470,93,27,17,10,1
SBI08CWR6840521,64,19,17,2,1
SBI34EXL6251627,78,30,19,11,1
SBI13BGL1879169,82,26,25,1,1
SBI37LLY7215249,67,22,14,8,1
SBI86TML6433899,22,16,15,1,1
SBI18RYO6288797,23,24,19,5,1
SBI20QSG9356120,63,25,17,8,1
SBI28FHR1285600,93,33,20,13,1
SBI60XKV9506630,78,15,8,7,1
SBI31FSH4343677,70,25,16,9,1
SBI12YZS3900980,93,18,12,6,1
SBI26RBT5267800,89,29,16,13,1
SBI33IOI9802443,68,25,16,9,1
SBI48YQC8528137,78,19,18,1,1
SBI83TGX2485761,88,22,20,2,1
SBI55FLQ7302906,62,21,19,2,1
SBI25JLI9824035,99,28,21,7,1
SBI95RBC6459757,77,34,29,5,1
SBI28KEK6137518,91,20,12,8,1
SBI16EHQ9095715,67,22,18,4,1
SBI69ACO9654070,95,27,22,5,1
SBI04STV0187104,23,33,22,11,1
SBI48USP1570813,81,26,24,2,1
SBI80JLR5985261,62,22,17,5,1
SBI24DKU1755039,60,32,27,5,1
SBI27ERX0222337,80,34,28,6,1
SBI74UKJ7586308,76,26,19,7,1
SBI97EAT3769420,80,24,23,1,1
SBI17ZSQ3934453,99,24,22,2,1
SBI32TTN5861197,82,31,23,8,1
SBI02TVL2338611,73,24,16,8,1
SBI40ITX5614681,92,24,21,3,1
SBI53QOI9952225,62,26,15,11,1
SBI76MQJ6604896,25,31,25,6,1
SBI22QQL5996095,21,24,20,4,1
SBI04ICA2038948,73,26,17,9,1
SBI67QRQ4335594,90,26,20,6,1
SBI49ZCY2584596,80,24,14,10,1
SBI62GJP0921358,19,23,16,7,1
SBI19UWE3140437,89,20,19,1,1
SBI86KZT5377049,86,19,18,1,1
SBI05IJP9660039,71,31,27,4,1
SBI74PFA5038433,93,17,16,1,1
SBI44GKR5151676,90,20,12,8,1
SBI74PTL6937196,70,26,22,4,1
SBI31JOO1823387,92,28,20,8,1
SBI74CXH8718527,79,25,17,8,1
SBI39AVZ8009150,21,22,12,10,1
SBI65ITK6271317,86,26,18,8,1
SBI34LOZ4450844,20,27,15,12,1
SBI30TMD0066324,87,30,25,5,1
SBI04LUH4141550,84,18,10,8,1
SBI68RNE1709215,97,25,22,3,1
SBI87IPO6532165,68,33,29,4,1
SBI04WUG3567718,88,13,7,6,1
SBI68ARF2602983,82,25,17,8,1
SBI23ZZP5474981,91,16,9,7,1
SBI77BIA1827611,94,21,16,5,1
SBI58RJF7673500,21,23,17,6,1
SBI12IXH0365407,73,28,15,13,1
SBI12HIA2560767,65,29,20,9,1
SBI78XHS0444894,78,23,18,5,1
SBI61UFM9068674,68,20,17,3,1
SBI75GKG0259564,25,30,26,4,1
SBI73HJV4864369,73,27,22,5,1
SBI11ECU9256679,84,18,14,4,1
SBI68FUS1245361,19,27,18,9,1
SBI04PQK3280100,95,33,29,4,1
SBI80JGY9134219,19,25,22,3,1
SBI36NQX2946184,91,27,14,13,1
SBI73UDF3808006,63,33,18,15,1
SBI63FEH0040067,86,25,18,7,1
SBI21BME2335516,93,32,27,5,1
SBI27UYB9732680,94,22,20,2,1
SBI51HVB0797096,80,20,14,6,1
SBI20WDT0312020,18,23,15,8,1
SBI14ICR5625226,92,30,27,3,1
SBI21VYS3401058,22,34,21,13,1
SBI18QTW1294591,23,19,10,9,1
SBI94EUJ2060302,86,26,14,12,1
SBI72WGR8171122,61,30,29,1,1
SBI43BSW9975099,95,25,17,8,1
SBI10XHW6731645,60,27,18,9,1
SBI74MZW2245160,23,25,17,8,1
SBI19WIR8141075,87,23,16,7,1
SBI59BQF4750602,21,20,16,4,1
SBI34HMF8699640,73,22,18,4,1
SBI52OOG4146033,93,32,25,7,1
SBI97FQT4478886,87,21,17,4,1
SBI49LJN2248320,82,24,20,4,1
SBI30HFD5243893,77,24,23,1,1
SBI97IUH2387003,19,15,12,3,1
SBI63ELP8778248,74,27,18,9,1
SBI73CYM7703779,83,22,14,8,1
SBI30CPQ1093783,86,32,19,13,1
SBI35AQU5942186,19,20,13,7,1
SBI85FBB6039156,20,18,10,8,1
SBI19RYP1002930,68,27,22,5,1
SBI68UED8360289,66,26,20,6,1
SBI63TWG8872188,96,18,13,5,1
SBI31OHV0821425,73,29,24,5,1
SBI90KUF2749842,98,27,18,9,1
SBI73LJK7256654,89,28,17,11,1
SBI54ZDX8356018,96,28,22,6,1
SBI49DBL5563955,80,29,28,1,1
SBI86UCY9919991,18,28,24,4,1
SBI14UUW7857585,71,33,24,9,1
SBI01VTN2522006,24,20,11,9,1
SBI60SFY3490319,82,32,31,1,1
SBI53HBK4322990,78,27,19,8,1
SBI41PZX9939012,25,30,23,7,1
SBI77GYG9681971,18,27,21,6,1
SBI09WAV2482720,63,28,21,7,1
SBI09GCW1786901,19,18,16,2,1
SBI34JUB3361722,88,20,12,8,1
SBI48UUI5895662,94,21,13,8,1
SBI94YSW5634838,97,19,10,9,1
SBI45AEY4581342,73,21,16,5,1
SBI55DOQ2153996,20,26,24,2,1
SBI25UFT1768229,77,25,17,8,1
SBI90PNK3033180,19,29,21,8,1
SBI04TBB2440648,19,23,18,5,1
SBI74PAI4151049,70,22,12,10,1
SBI57LKY6195948,60,27,15,12,1
SBI93SME8394783,75,28,25,3,1
SBI47EHH0429800,77,25,16,9,1
SBI81FOF8082477,23,33,32,1,1
SBI36BRC4945624,82,26,24,2,1
SBI00VVE4316786,20,31,16,15,1
SBI02EHB2118970,90,23,17,6,1
SBI11AAV6983498,91,30,16,14,1
SBI62GBV0131066,65,20,15,5,1
SBI25SIY5244399,60,20,11,9,1
SBI44WWS5618625,24,23,17,6,1
SBI99KNE5829999,91,25,15,10,1
SBI41KQN4614529,95,17,14,3,1
SBI04WTG4946333,78,21,13,8,1
SBI32PJE7202189,95,25,24,1,1
SBI25YUH3674144,69,30,23,7,1
SBI07WGR2351015,25,20,14,6,1
SBI50PUP4786166,22,23,18,5,1
SBI77JPO9816215,83,33,30,3,1
SBI70NRY7629541,90,29,23,6,1
SBI20ZLK7157996,82,23,19,4,1
SBI55SRO4062875,68,32,31,1,1
SBI58JQL0818782,20,23,14,9,1
SBI41NYB5077836,87,18,15,3,1
SBI49TES0693710,67,25,21,4,1
SBI63APG5483770,71,20,16,4,1
SBI61SKM6197411,72,31,29,2,1
SBI34RQC3093183,69,23,18,5,1
SBI84GLM5866128,69,18,10,8,1
SBI19JFF4202122,90,29,25,4,1
SBI34ZZV4184421,18,22,12,10,1
SBI82WEJ1220187,88,22,13,9,1
SBI64NIP8396486,87,25,21,4,1
SBI08GUL7270266,61,20,12,8,1
SBI49YPK0835445,67,29,20,9,1
SBI80CDU9012734,91,27,24,3,1
SBI55NDZ6872641,69,24,15,9,1
SBI15RKU7489569,79,26,20,6,1
SBI24XMR8031218,87,28,18,10,1
SBI69WJN4345100,73,25,14,11,1
SBI10FGC6683692,61,35,33,2,1
SBI31ZFK0823653,74,20,11,9,1
SBI90GDB2956065,73,28,25,3,1
SBI51PWE6717154,80,32,21,11,1
SBI22EVV1061733,87,14,8,6,1
SBI75AMK4961891,20,31,27,4,1
SBI96ANL9253756,19,27,26,1,1
SBI93NHB0588499,71,29,20,9,1
SBI06PCD7504205,92,21,17,4,1
SBI74KST2228569,93,23,22,1,1
SBI53QUU8287555,61,26,20,6,1
SBI60MOE9115385,83,30,22,8,1
SBI42HGQ7391976,25,26,23,3,1
SBI44VAK4229774,22,25,20,5,1
SBI95EUU0201727,95,21,20,1,1
SBI50XMI6717277,64,28,23,5,1
SBI13WGC0926818,60,32,31,1,1
SBI13SGZ8728588,77,32,30,2,1
SBI44IRV4975593,75,33,21,12,1
SBI52ZHF1937241,22,28,24,4,1
SBI64FJW1700474,80,23,20,3,1
SBI11PLQ2795460,81,35,23,12,1
SBI60RIT9524864,97,27,24,3,1
SBI91RTM0827795,72,27,16,11,1
SBI84UZB8089245,67,23,12,11,1
SBI41XXO2388750,68,35,29,6,1
SBI97MFX3148446,83,26,23,3,1
SBI85LHG7453550,73,28,20,8,1
SBI31LAN0845918,81,26,21,5,1
SBI19FHA4474528,81,27,25,2,1
SBI37HZQ3052710,73,35,22,13,1
SBI67QWC4343463,80,27,25,2,1
SBI03OZQ2335319,74,22,20,2,1
SBI62AEK2653488,79,25,17,8,1
SBI01QNH2878700,63,22,14,8,1
SBI67OMC3751490,92,22,13,9,1
SBI12BAT0920191,63,21,13,8,1
SBI90FLN9254273,18,21,16,5,1
SBI82OPK5590438,79,31,22,9,1
SBI78JMN0764481,99,26,21,5,1
SBI47HUN0002832,97,29,26,3,1
SBI62RFZ7595320,86,27,26,1,1
SBI01WPY2066491,87,26,22,4,1
SBI23VDF3055274,60,12,7,5,1
SBI78BMN2913700,86,30,25,5,1
SBI07VEG8191576,72,24,18,6,1
SBI00FLJ1791656,80,32,30,2,1
SBI18NWD9047959,66,26,24,2,1
SBI35CEB8606617,80,24,20,4,1
SBI45KSZ9980443,67,20,19,1,1
SBI54WKV1517302,88,23,20,3,1
SBI90SQY3991851,80,18,12,6,1
SBI44YPB2962040,63,29,22,7,1
SBI16DAQ3669266,66,16,13,3,1
SBI62AUK5315702,65,26,17,9,1
SBI18NFJ8063864,95,24,23,1,1
SBI42OCR0058823,60,34,27,7,1
SBI51CCX1460194,68,24,21,3,1
SBI27SSP6154315,80,21,20,1,1
SBI74TIL7928682,91,28,21,7,1
SBI29KKR6185048,21,26,20,6,1
SBI50HUS5946902,62,31,24,7,1
SBI93NGA1359906,92,20,19,1,1
SBI12DNS6937392,19,17,13,4,1
SBI00SPU7038510,96,19,14,5,1
SBI32TZE7044110,94,31,17,14,1
SBI84NSF4862016,18,24,18,6,1
SBI05OZN1804197,73,19,15,4,1
SBI79PUB5809100,86,28,20,8,1
SBI65GOH3088607,81,19,10,9,1
SBI96PWR3622727,92,29,25,4,1
SBI07KEA3072090,91,24,19,5,1
SBI74XDD3348164,71,23,19,4,1
SBI57DWC2037514,68,19,10,9,1
SBI82CDZ2719625,68,31,16,15,1
SBI13PNE3506451,66,19,10,9,1
SBI16BJU0724830,77,26,23,3,1
SBI96KDD8734932,24,23,20,3,1
SBI50QSS2785324,64,22,18,4,1
SBI35DZW8339733,82,25,18,7,1
SBI84ZNV2644157,80,23,20,3,1
SBI24ZMC5515352,68,32,31,1,1
SBI33NAW5998630,70,24,15,9,1
SBI58GXF6208779,92,33,19,14,1
SBI50EAJ5956726,87,32,19,13,1
SBI08VQG1857976,64,29,24,5,1
SBI63RBU9758018,96,25,23,2,1
SBI68TLH8793751,86,24,21,3,1
SBI14GHT1596573,24,23,20,3,1
SBI19JLX6184147,86,25,23,2,1
SBI45SWB2043166,88,23,13,10,1
SBI86VKV5131453,20,27,17,10,1
SBI46CDJ3849052,92,32,22,10,1
SBI59NDL9556445,24,19,13,6,1
SBI19QKR1065619,77,30,29,1,1
SBI86HYB1717607,64,21,19,2,1
SBI06OFN6252958,69,23,15,8,1
SBI49QZD5689260,74,30,26,4,1
SBI60GJT1069921,64,28,16,12,1
SBI02WHY1645367,87,24,23,1,1
SBI71LUE9408481,93,25,20,5,1
SBI17IJH4722182,83,23,15,8,1
SBI20LBH5776262,81,20,11,9,1
SBI22LPI1626026,75,24,22,2,1
SBI57LUZ4693710,63,34,31,3,1
SBI88DQV6798381,68,25,22,3,1
SBI20JKZ1433268,25,31,16,15,1
SBI02OTO7909423,74,22,19,3,1
SBI76AHN5690131,73,22,14,8,1
SBI23YZH1304072,60,24,14,10,1
SBI01HFD4288067,89,24,16,8,1
SBI23RFV8509743,79,28,24,4,1
SBI48YKK7355773,68,35,27,8,1
SBI59PED0753850,73,31,16,15,1
SBI67OEU6467281,64,19,13,6,1
SBI19XQN3242163,81,25,21,4,1
SBI04ZDZ0362965,92,23,18,5,1
SBI61QNG2531424,65,22,20,2,1
SBI86VIL3877363,98,18,11,7,1
SBI36UVY1976187,87,19,16,3,1
SBI51RFY8715604,96,22,12,10,1
SBI28CFT8770408,68,22,12,10,1
SBI26NIC7719736,90,29,15,14,1
SBI54BGZ3685398,24,28,25,3,1
SBI31PTE8517696,68,29,17,12,1
SBI77YDV2894408,60,26,21,5,1
SBI48BGQ9971923,86,25,15,10,1
SBI18EAV9742369,79,30,18,12,1
SBI59OVV7139255,71,26,14,12,1
SBI62LFX6694840,71,23,15,8,1
SBI32FLJ0012013,96,26,23,3,1
SBI65HXN5775376,61,18,16,2,1
SBI22SIO0903458,96,29,24,5,1
SBI60BNP6661623,98,21,17,4,1
SBI15ROU2252771,97,27,26,1,1
SBI38CFC7834738,75,33,25,8,1
SBI96JID8731365,80,20,14,6,1
SBI11NCS3274020,66,24,20,4,1
SBI11YZJ6835807,82,21,12,9,1
SBI19VVH8994642,75,21,18,3,1
SBI59BUM4504313,74,25,20,5,1
SBI68LHC6047379,71,24,17,7,1
SBI76PIM7667486,86,27,22,5,1
SBI73WWT0977313,80,22,20,2,1
SBI39OKP4444401,68,20,19,1,1
SBI46JXH9475588,90,24,18,6,1
SBI63WLO8499510,96,31,18,13,1
SBI20QIF0323415,73,21,18,3,1
SBI75QJI5985554,22,17,9,8,1
SBI74ZMQ3043750,82,26,21,5,1
SBI94OUM5520363,60,40,31,9,1
SBI38MSZ2682594,80,32,28,4,1
SBI75LUJ1879549,92,26,22,4,1
SBI87VBB5281849,89,28,24,4,1
SBI23DTQ8323377,92,25,18,7,1
SBI83SIW5260190,25,25,23,2,1
SBI48TZQ7636714,87,19,18,1,1
SBI45KPU0001108,88,36,28,8,1
SBI82LGX6693975,23,18,10,8,1
SBI17SCC7935290,67,31,21,10,1
SBI37EED0424484,61,30,20,10,1
SBI91FGS3609827,70,20,15,5,1
SBI37LWD9111656,68,28,23,5,1
SBI84VFN1560670,76,26,23,3,1
SBI98MCY7898929,90,19,15,4,1
SBI48PCP8618451,61,24,16,8,1
SBI89GHP9059073,70,27,15,12,1
SBI32KGM4108346,83,33,21,12,1
SBI25LYC4775919,78,23,12,11,1
SBI55UNE3685785,80,23,16,7,1
SBI69ZWQ6845932,85,23,16,7,1
SBI27DEF1632174,97,15,14,1,1
SBI24NDD7310249,24,26,19,7,1
SBI68AAG0352109,89,21,18,3,1
SBI95FFG5783072,19,21,15,6,1
SBI49DWS8316409,21,36,21,15,1
SBI97QCA1792532,96,19,14,5,1
SBI89HUA6307612,90,35,33,2,1
SBI66LLK5706588,64,21,12,9,1
SBI01WQK8762142,99,26,19,7,1
SBI12AAU0937156,73,33,22,11,1
SBI87ZJY9922637,70,30,23,7,1
SBI10TLZ4169696,65,24,21,3,1
SBI15IGS7366050,18,36,21,15,1
SBI72GUB6841740,94,26,24,2,1
SBI21JZQ8243585,60,26,23,3,1
SBI55TBU9865886,68,26,15,11,1
SBI49GYT2059247,92,18,13,5,1
SBI81DRZ3709312,72,26,21,5,1
SBI35ERB5664675,82,20,15,5,1
SBI84TMU3090983,24,24,17,7,1
SBI76JXJ4673049,25,33,29,4,1
SBI90SRF8677339,94,30,29,1,1
SBI18YFI8292595,66,25,13,12,1
SBI85BXL6279642,25,19,11,8,1
SBI35XBX5464471,79,21,11,10,1
SBI04DVM5822089,70,26,20,6,1
SBI21PGW6806198,71,30,23,7,1
SBI20NFX7016227,85,28,16,12,1
SBI93IZX2238036,75,16,10,6,1
SBI42XMU1812861,77,18,15,3,1
SBI34GRR3836721,69,28,15,13,1
SBI15QHJ1842820,99,26,14,12,1
SBI58WEI7881505,82,20,13,7,1
SBI53FNB8734073,90,27,19,8,1
SBI89AZI2338002,77,23,13,10,1
SBI66ZEC6210941,23,27,16,11,1
SBI99VXN2042019,86,19,15,4,1
SBI47HTJ8050593,80,23,17,6,1
SBI63BAI9540897,85,31,29,2,1
SBI70VAH4813386,82,29,17,12,1
SBI77RUW2226366,95,27,24,3,1
SBI77ZHI0578754,72,21,19,2,1
SBI25ZMF0210481,23,19,17,2,1
SBI90OPT5241543,91,23,21,2,1
SBI71HBG6289070,96,21,12,9,1
SBI23LVN0989317,20,28,23,5,1
SBI26NKA3902938,73,32,31,1,1
SBI97KNU1987065,95,24,19,5,1
SBI03NSB4509541,64,22,21,1,1
SBI63ERT9857712,66,29,20,9,1
SBI90WNI1287584,83,21,14,7,1
SBI88QYA3130637,64,27,24,3,1
SBI65TND8384737,67,24,15,9,1
SBI05SLL1559604,95,28,24,4,1
SBI42GVA4632282,89,19,11,8,1
SBI68JLE0155189,91,27,19,8,1
SBI38LXZ6258948,87,21,17,4,1
SBI31IXT0846855,78,32,25,7,1
SBI39PIT6099521,66,23,16,7,1
SBI62JAN4522350,86,36,21,15,1
SBI36BTP7968620,92,24,18,6,1
SBI08XQY2719342,84,21,19,2,1
SBI27STF2753572,23,17,9,8,1
SBI41XDF4569583,25,34,33,1,1
SBI99SFN0909329,89,28,25,3,1
SBI39PGL9013488,62,23,19,4,1
SBI14EUT6553199,79,23,22,1,1
SBI32QED9912808,22,24,13,11,1
SBI16EVT3372165,74,22,16,6,1
SBI86DXZ2595638,88,28,16,12,1
SBI51DSO0573405,70,22,20,2,1
SBI09PTK6492682,81,26,17,9,1
SBI05MGH4808542,21,22,19,3,1
SBI80TCI2733512,87,25,13,12,1
SBI98VWJ9042712,86,14,9,5,1
SBI79REE1122786,66,25,16,9,1
SBI26XNI9538361,77,17,16,1,1
SBI99HIR4335302,88,39,35,4,1
SBI04RTJ7644547,72,17,11,6,1
SBI54ONO4298760,94,26,20,6,1
SBI86VDU8404381,94,30,21,9,1
SBI09HLD6530614,76,23,13,10,1
SBI20ETA2131251,91,30,19,11,1
SBI76XWE5721279,90,27,17,10,1
SBI46IMT6433579,90,36,23,13,1
SBI08NUK4555309,98,28,27,1,1
SBI30DSY6527450,97,24,19,5,1
SBI99NZB1735730,64,21,15,6,1
SBI37IQR9385314,71,23,16,7,1
SBI66DFW3588176,68,29,28,1,1
SBI48GCD7098069,74,15,11,4,1
SBI88CLX6267834,97,21,11,10,1
SBI09EGT2084396,83,18,15,3,1
SBI39FXW7568631,72,22,14,8,1
SBI63HUB8573452,75,27,15,12,1
SBI79WVX8589503,79,23,14,9,1
SBI39IXY0428833,85,28,27,1,1
SBI63KGS2845380,94,11,7,4,1
SBI19QGZ1411187,82,22,19,3,1
SBI74WWB2814816,80,28,22,6,1
SBI21WNG6484357,84,27,14,13,1
SBI27WDJ1074596,65,25,19,6,1
SBI42XED3765869,85,28,24,4,1
SBI63PLX0323886,83,21,12,9,1
SBI84NDF4502352,21,20,12,8,1
SBI84MPL1506622,74,14,10,4,1
SBI33AYY7885814,70,19,16,3,1
SBI37NUX8544701,82,22,16,6,1
SBI39ONU7503657,89,24,18,6,1
SBI97BKT1375490,91,21,15,6,1
SBI27LDF4272997,73,15,10,5,1
SBI97BIT7461812,24,23,19,4,1
SBI36AEM9499299,85,35,32,3,1
SBI04YGV9137553,25,21,15,6,1
SBI85OEE9846028,75,23,19,4,1
SBI40WXB3129193,86,23,17,6,1
SBI07ARK4215192,71,22,15,7,1
SBI80DGX7630931,76,23,15,8,1
SBI11DHL6668424,71,28,15,13,1
SBI97UBG7464798,92,24,19,5,1
SBI45AJV0072176,75,25,23,2,1
SBI21VNN4927967,78,24,13,11,1
SBI70VZD3929082,21,35,25,10,1
SBI46XBA1444592,92,30,19,11,1
SBI68KOI2314328,65,33,21,12,1
SBI29GRD8347709,91,26,25,1,1
SBI48DNY9621908,75,20,11,9,1
SBI08QJD7164990,22,17,10,7,1
SBI16JKW4271348,70,20,17,3,1
SBI93KJI6779027,72,16,14,2,1
SBI59XVA3720653,24,19,13,6,1
SBI47PDP5880169,18,28,17,11,1
SBI49SOO2666214,69,25,16,9,1
SBI65PBS6692094,87,19,14,5,1
SBI39XQB2937518,99,25,13,12,1
SBI36MDX4609563,22,30,29,1,1
SBI76MBK4313874,71,28,21,7,1
SBI23RMA3266255,87,26,20,6,1
SBI39IGD7713820,74,24,23,1,1
SBI58DUN1191238,69,29,20,9,1
SBI16OHJ8387237,99,27,26,1,1
SBI86FEK6224796,69,31,24,7,1
SBI30HOV0839386,64,31,30,1,1
SBI36CRH2321509,87,19,16,3,1
SBI94KCO4972485,87,25,16,9,1
SBI03QGE5221664,60,18,10,8,1
SBI77WRM0297757,80,23,19,4,1
SBI62SRS5310776,83,32,22,10,1
SBI77HGZ2674661,80,21,20,1,1
SBI67KWA6845050,22,34,18,16,1
SBI38EEH5870999,73,15,8,7,1
SBI36ZTB0592184,79,25,23,2,1
SBI60BZU8464853,61,29,15,14,1
SBI64YJB8436170,85,28,27,1,1
SBI43JIH7391557,66,30,22,8,1
SBI86JPK0302225,21,22,15,7,1
SBI71CTR4392354,62,28,20,8,1
SBI43BDV9657419,70,23,15,8,1
SBI75RNA8962771,77,27,24,3,1
SBI52MSZ3347039,94,23,18,5,1
SBI10RSX3180958,79,20,14,6,1
SBI63JSC7114319,76,26,18,8,1
SBI56NBT2040633,78,21,13,8,1
SBI45JCU5994516,95,22,20,2,1
SBI41OOU5196533,65,19,13,6,1
SBI05DIH5578252,78,17,12,5,1
SBI45UBQ6623640,73,29,27,2,1
SBI29DBL2220986,82,23,12,11,1
SBI57FRH3747197,73,16,11,5,1
SBI48KGL0733917,85,24,22,2,1
SBI21REC5089797,92,20,19,1,1
SBI47MXQ4267926,92,20,18,2,1
SBI11LOI2436164,70,30,25,5,1
SBI53BOM3353563,75,27,20,7,1
SBI55RFG3716482,84,24,21,3,1
SBI88RHC5527263,69,25,22,3,1
SBI82IJO6999461,70,26,18,8,1
SBI20MRY1623077,91,27,15,12,1
SBI18FFG6654728,93,19,11,8,1
SBI14NTM4844166,84,16,15,1,1
SBI04EON9272567,20,34,19,15,1
SBI10TOV2239359,94,21,12,9,1
SBI79MSB4749304,87,28,19,9,1
SBI89KNH4631857,23,27,25,2,1
SBI17CVG4014207,23,22,14,8,1
SBI72IOG4461606,60,23,19,4,1
SBI34SHW5137041,76,26,19,7,1
SBI15SDC0288407,65,29,27,2,1
SBI35MMW1888169,67,22,21,1,1
SBI51JMU3546827,71,20,18,2,1
SBI36GMQ7321754,90,22,16,6,1
SBI98VGH0096518,91,24,13,11,1
SBI65WEO8476394,68,29,23,6,1
SBI84HCP2190887,78,19,10,9,1
SBI10MCG7234008,62,32,25,7,1
SBI59YXP8639923,65,19,11,8,1
SBI64RJD4172919,22,26,25,1,1
SBI48JLW2755190,85,30,25,5,1
SBI63QCU3560033,63,15,8,7,1
SBI54BDG2461350,90,24,18,6,1
SBI21PHC9005581,92,23,13,10,1
SBI62MFJ2603414,73,29,23,6,1
SBI88PAH8191828,74,22,13,9,1
SBI51KDT8000471,24,24,17,7,1
SBI62BXB2043446,83,12,9,3,1
SBI07XSH0144561,79,19,15,4,1
SBI90HEY0292150,71,24,13,11,1
SBI46NNL4537032,89,20,11,9,1
SBI80KFO9518899,65,18,13,5,1
SBI05DMF6584295,71,25,17,8,1
SBI99XZA0074587,90,15,14,1,1
SBI12ANZ3786650,97,28,19,9,1
SBI63MXP0216615,19,28,23,5,1
SBI87QZK5652052,76,28,20,8,1
SBI31GZJ0600929,87,20,16,4,1
SBI30VNB8709160,65,22,21,1,1
SBI12MTD7129471,82,21,15,6,1
SBI90JWZ4017439,72,26,18,8,1
SBI64WGE4140490,91,27,20,7,1
SBI80BHE8484185,85,25,14,11,1
SBI01FBF2683322,71,31,18,13,1
SBI40HSG2292345,81,25,19,6,1
SBI92YUB7596692,64,30,21,9,1
SBI55IVY6652850,85,26,24,2,1
SBI81LRN0316504,79,20,16,4,1
SBI02BXG7429933,68,34,24,10,1
SBI82RWX4738870,69,30,26,4,1
SBI68CVY1447610,62,25,16,9,1
SBI93MVL1304178,19,26,25,1,1
SBI63BZI4311739,66,28,22,6,1
SBI39SQW3609869,62,31,20,11,1
SBI25DPV8579245,95,32,31,1,1
SBI74NJL3164937,98,26,23,3,1
SBI37PDK1297669,65,26,16,10,1
SBI62ADW9572637,69,26,22,4,1
SBI97EKO1245001,96,29,16,13,1
SBI22NCY9638371,99,28,21,7,1
SBI72AMO1261798,66,28,16,12,1
SBI01HRI2488748,90,21,15,6,1
SBI57VOK8510734,64,18,13,5,1
SBI14HGG5100998,91,28,19,9,1
SBI43LPD2029019,20,29,28,1,1
SBI10WRF8482345,18,27,25,2,1
SBI38FQK4426692,92,20,12,8,1
SBI47FOM2021653,82,32,30,2,1
SBI17FBT9925267,86,20,17,3,1
SBI63FTK2481934,74,17,13,4,1
SBI86QEW3384995,81,24,15,9,1
SBI97HYR2405739,68,20,16,4,1
SBI27JIL6572394,90,24,22,2,1
SBI52VLD9851362,77,18,11,7,1
SBI96DGZ8082783,88,29,25,4,1
SBI10DCQ7290244,25,18,10,8,1
SBI13FKF6739743,67,29,27,2,1
SBI29BSU6649172,74,24,23,1,1
SBI52QVZ5588580,19,16,12,4,1
SBI89ACW6333837,19,19,17,2,1
SBI47XTS0410937,84,32,25,7,1
SBI99DER4088929,95,20,15,5,1
SBI84UGR9289273,95,16,11,5,1
SBI69GEE4294985,18,21,17,4,1
SBI79NOG8802682,64,16,15,1,1
SBI44BHQ9062851,87,24,19,5,1
SBI61TSP9355136,63,31,24,7,1
SBI96NNA0573837,23,29,19,10,1
SBI49MHH2299237,85,24,21,3,1
SBI67GTQ4705770,79,23,17,6,1
SBI82PZQ7214113,23,35,19,16,1
SBI60OOM6417129,75,31,20,11,1
SBI68OGX7611670,95,26,14,12,1
SBI22SDM2287713,23,25,19,6,1
SBI75HBX5183764,87,29,19,10,1
SBI46SID4767658,71,22,18,4,1
SBI77ZTE8925124,81,23,18,5,1
SBI72TAY5355595,69,24,23,1,1
SBI86EHL1327158,60,27,16,11,1
SBI77KZT5513449,71,20,16,4,1
SBI76MKV2179205,77,29,15,14,1
SBI25XBE6016344,84,22,14,8,1
SBI34FLI1526620,73,21,11,10,1
SBI43ANH1271546,88,15,10,5,1
SBI22BGY9061662,78,33,17,16,1
SBI74JHS0012353,62,27,18,9,1
SBI02NHS8936589,91,19,16,3,1
SBI07IZQ8738850,25,25,24,1,1
SBI25LQD5638521,23,27,16,11,1
SBI06YGE3775166,91,19,11,8,1
SBI78FQR9856344,96,20,13,7,1
SBI74WWC3834309,83,21,14,7,1
SBI97BCE0741728,95,20,19,1,1
SBI16GJP3275132,69,20,18,2,1
SBI85EFF6736145,66,30,22,8,1
SBI99WWC1604115,87,21,17,4,1
SBI61QOV0561331,25,18,15,3,1
SBI58SKL7962747,72,37,26,11,1
SBI88RSS0678884,75,24,17,7,1
SBI65CZF4570514,81,8,6,2,1
SBI86BUW4093794,67,30,25,5,1
SBI44YUX6340549,67,21,20,1,1
SBI95HZJ5258109,75,24,16,8,1
SBI58FUC0836728,81,25,14,11,1
SBI00XBT1441413,76,26,21,5,1
SBI09ZQW0748573,18,29,23,6,1
SBI61ACQ5709831,75,22,15,7,1
SBI96TQP9838182,61,22,14,8,1
SBI85MZY6132035,84,30,16,14,1
SBI20PEX7916902,89,22,16,6,1
SBI82ODZ4469828,65,22,17,5,1
SBI92QFD4287678,84,30,29,1,1
SBI01FBG5387949,99,24,16,8,1
SBI16OHB4123249,84,15,14,1,1
SBI50SWO6309736,77,23,20,3,1
SBI18WDB1213278,82,29,19,10,1
SBI12IIJ5058522,80,28,16,12,1
SBI67UWM5550756,81,23,20,3,1
SBI21RKG4178710,98,23,14,9,1
SBI20HCD1360598,89,27,18,9,1
SBI30KRP5555770,98,22,15,7,1
SBI69QOO1344231,24,25,19,6,1
SBI61OGG3012146,67,17,15,2,1
SBI97RMT4751983,73,31,20,11,1
SBI94TSH2283731,19,18,17,1,1
SBI15UIN7449955,65,33,19,14,1
SBI49WHT3296347,77,13,7,6,1
SBI77ORT8807929,94,31,18,13,1
SBI40UPW1483938,92,26,17,9,1
SBI91SHK7526303,64,26,17,9,1
SBI00FHT0560254,84,22,14,8,1
SBI44EYQ7870625,90,20,18,2,1
SBI70LBR9536790,75,11,7,4,1
SBI70DYY9230144,24,17,11,6,1
SBI46ZNS3741736,83,25,18,7,1
SBI35QCJ6191102,95,28,26,2,1
SBI67OJX6850757,99,11,10,1,1
SBI64HKA0012588,65,16,12,4,1
SBI65ECC6364577,60,23,16,7,1
SBI52LYE8401190,21,11,9,2,1
SBI10EVP9818786,95,33,25,8,1
SBI04QOQ6654210,92,21,15,6,1
SBI17JSS7447203,99,25,20,5,1
SBI75VAB5533231,97,31,20,11,1
SBI56CQB4753099,85,26,16,10,1
SBI41HVQ3729702,90,34,24,10,1
SBI81CNN2179583,94,17,13,4,1
SBI10HEM3897486,65,28,19,9,1
SBI86PBQ5448405,23,23,16,7,1
SBI01RUH8170502,99,24,14,10,1
SBI30JOL6308078,66,19,13,6,1
SBI29CJF5203090,91,28,18,10,1
SBI60BOQ3400558,69,25,21,4,1
SBI29DBG1959650,76,24,23,1,1
SBI71KEV7744326,98,29,15,14,1
SBI24CZE8968294,83,22,15,7,1
SBI35MOU3018626,61,32,26,6,1
SBI59KST5207629,65,12,10,2,1
SBI72OEV9656102,96,17,11,6,1
SBI28DGT7728046,22,27,21,6,1
SBI15OBT0916524,60,20,14,6,1
SBI29TYF9574590,85,18,16,2,1
SBI22ABN9215329,84,18,14,4,1
SBI76FHH4425746,21,27,26,1,1
SBI18EBT3967241,19,20,12,8,1
SBI68CJI9574689,62,18,13,5,1
SBI47NWV5778558,20,29,23,6,1
SBI83UWL7842948,82,29,19,10,1
SBI29AKN7347742,81,34,26,8,1
SBI79ATS4872736,65,24,22,2,1
SBI07LZG9852193,23,31,18,13,1
SBI05ZDS1280542,72,20,14,6,1
SBI43RVE1234858,72,24,13,11,1
SBI82AYM0570322,74,23,19,4,1
SBI20HPL3019692,18,37,35,2,1
SBI89IQM8141699,90,23,14,9,1
SBI46QPY5696547,60,26,20,6,1
SBI71IDU8141275,20,33,28,5,1
SBI88MQM7696670,98,21,17,4,1
SBI61FCO0523961,62,28,23,5,1
SBI51RNX4222208,85,27,20,7,1
SBI84EXR8300701,66,31,28,3,1
SBI89ULE4730887,92,24,23,1,1
SBI87LQX5291857,82,21,11,10,1
SBI12DQG3388137,23,24,22,2,1
SBI02KXX7616185,70,29,23,6,1
SBI86HMO5168243,62,27,14,13,1
SBI74SCN5606266,72,34,23,11,1
SBI78RWN9828951,62,31,29,2,1
SBI85WAV5315884,71,23,18,5,1
SBI76MAQ9888634,21,22,12,10,1
SBI91SCH2857899,93,20,19,1,1
SBI15KVF9633105,68,27,20,7,1
SBI85FXW9421637,91,22,20,2,1
SBI31TQQ8833349,85,14,8,6,1
SBI75WYG2372778,25,26,17,9,1
SBI30OHS1613330,65,18,12,6,1
SBI79FOW8971418,95,19,12,7,1
SBI38HCQ6931481,87,17,14,3,1
SBI66ARJ3164996,83,17,11,6,1
SBI82KUZ5051109,88,31,16,15,1
SBI21RIL4940731,89,33,22,11,1
SBI73YPW4673782,80,28,24,4,1
SBI04AWR5364225,81,28,19,9,1
SBI64ZEM5648968,70,27,21,6,1
SBI11XRJ6795552,85,29,18,11,1
SBI32CGJ6846566,89,24,21,3,1
SBI64UQE4475042,68,30,26,4,1
SBI01BJJ0150022,84,15,10,5,1
SBI04UNA4175890,72,32,18,14,1
SBI75PFJ6696016,89,28,24,4,1
SBI08BDD4371891,71,35,27,8,1
SBI10AQS2577122,74,20,18,2,1
SBI11UQA2692078,70,21,19,2,1
SBI81QGT2216518,69,32,23,9,1
SBI22TSW3707188,20,21,11,10,1
SBI58LDW5108262,82,21,14,7,1
SBI49YQA9765440,83,23,17,6,1
SBI18GBG9809249,21,23,14,9,1
SBI48CWY3281338,99,25,15,10,1
SBI63EXH2383952,64,19,13,6,1
SBI60YEM4509668,84,19,18,1,1
SBI63LWC1400908,23,21,16,5,1
SBI72UCR1690392,86,29,21,8,1
SBI22HXH8074610,76,29,22,7,1
SBI87QQL9397276,76,26,25,1,1
SBI55HOZ7232504,95,25,14,11,1
SBI61TRL3000768,60,29,28,1,1
SBI00WTI2573632,91,29,18,11,1
SBI05RRU6128603,77,26,21,5,1
SBI71QEW5751170,81,29,22,7,1
SBI86JDY2725824,19,17,12,5,1
SBI48LZS9389499,98,21,14,7,1
SBI61XJT9795780,25,26,17,9,1
SBI44PPQ6583618,73,22,17,5,1
SBI60FWQ2969627,86,20,14,6,1
SBI48CZZ8602844,98,21,20,1,1
SBI14SJQ5770347,97,25,16,9,1
SBI69QWU4895988,25,21,16,5,1
SBI43LFH0230630,91,30,17,13,1
SBI39PNG0800197,97,27,24,3,1
SBI04HMB1687876,72,32,30,2,1
SBI96TVF0110201,87,33,26,7,1
SBI26WNI2968095,62,34,25,9,1
SBI23GWF8422065,71,28,23,5,1
SBI94DDR4497147,78,26,24,2,1
SBI70VIH5270221,99,19,14,5,1
SBI15AYT3438107,95,32,20,12,1
SBI60JVX1771811,73,22,21,1,1
SBI42JMI9907175,61,23,19,4,1
SBI50SDO8560173,96,23,13,10,1
SBI96LYK6473731,74,26,16,10,1
SBI79ANR3658569,78,26,16,10,1
SBI49ZCP4729160,21,16,12,4,1
SBI03NOQ2499134,91,13,7,6,1
SBI08UZA9855915,23,31,22,9,1
SBI70ONX7225313,76,25,14,11,1
SBI30YLH4620370,67,20,17,3,1
SBI44RYL8167592,80,26,21,5,1
SBI50LVZ9972808,86,25,22,3,1
SBI44OYC3175611,85,18,14,4,1
SBI62PKY1325808,70,18,13,5,1
SBI49YYQ0610056,89,21,15,6,1
SBI50XRI0498336,65,25,15,10,1
SBI54VMX6667593,73,19,14,5,1
SBI07QTR1064407,25,24,22,2,1
SBI00WTQ2510880,97,20,18,2,1
SBI57LOO8598326,91,13,8,5,1
SBI68JTE9651523,60,27,22,5,1
SBI86IEJ0294368,76,31,24,7,1
SBI85NTV9753759,86,20,13,7,1
SBI74IIW9686469,90,25,18,7,1
SBI10UJR2293580,60,36,24,12,1
SBI01IQI8581831,98,26,25,1,1
SBI90NPK8700242,60,20,19,1,1
SBI02LDI6821476,87,22,13,9,1
SBI44KXT9086119,88,32,17,15,1
SBI86HDX8699202,89,28,21,7,1
SBI30MWY2872943,78,15,8,7,1
SBI64SSZ8275486,96,22,16,6,1
SBI46FZX6642108,99,19,16,3,1
SBI61OUN5644762,85,29,23,6,1
SBI17GBQ3055917,93,22,13,9,1
SBI79VSR4684397,93,22,15,7,1
SBI26FJZ3557702,19,36,29,7,1
SBI78VYW6042568,76,34,26,8,1
SBI68EII4737571,18,25,20,5,1
SBI89ARG9355594,76,24,17,7,1
SBI15LPJ5384712,93,21,11,10,1
SBI19OVF8781980,81,25,24,1,1
SBI67ECP3215978,75,27,22,5,1
SBI21SSX9275614,87,21,14,7,1
SBI28JMN7923088,96,24,14,10,1
SBI19WJK1582713,22,17,9,8,1
SBI66CBS2544012,77,18,17,1,1
SBI09EMC5614182,61,25,21,4,1
SBI38VDX2206569,90,28,22,6,1
SBI17RHL1556308,81,33,32,1,1
SBI53HAQ3141648,81,22,12,10,1
SBI27GIZ4450140,81,29,24,5,1
SBI16OEU8309337,85,24,21,3,1
SBI30KUC0334808,74,20,15,5,1
SBI36EHV3010224,84,21,13,8,1
SBI78HLI8817950,96,36,23,13,1
SBI04OQI6279202,79,26,25,1,1
SBI28JLT0344967,82,19,14,5,1
SBI07GYS3602426,84,21,13,8,1
SBI75NEN5219362,97,38,32,6,1
SBI63SSF1525922,61,24,19,5,1
SBI94AGD0435339,19,18,15,3,1
SBI89MOL3814671,83,22,17,5,1
SBI68GIL3655570,22,21,16,5,1
SBI07CHF7773574,25,24,23,1,1
SBI08YVT0121261,73,25,19,6,1
SBI15KWI6806213,69,27,23,4,1
SBI05AVM1647914,83,24,20,4,1
SBI92NZX0229156,78,21,11,10,1
SBI65JIA9807315,67,21,12,9,1
SBI69YVU9963924,71,21,14,7,1
SBI33XZC7117197,80,29,24,5,1
SBI71JQX2965063,80,34,19,15,1
SBI14AFU5634311,91,22,18,4,1
SBI39YBR3587315,77,20,16,4,1
SBI26UAM7172011,74,31,22,9,1
SBI38EIG5295092,65,21,18,3,1
SBI64WIR4007435,99,22,15,7,1
SBI90LDT4223950,88,28,20,8,1
SBI13ILK6082045,65,25,18,7,1
SBI60DIC8614581,61,17,15,2,1
SBI76FGR2942233,87,30,24,6,1
SBI46RQB2861993,80,17,12,5,1
SBI74CHR5088762,87,25,16,9,1
SBI43ASK9007784,74,25,15,10,1
SBI18VQH5673313,93,28,24,4,1
SBI66MQK7212922,65,25,18,7,1
SBI90BHL9832093,79,16,12,4,1
SBI87WIB5103495,25,27,20,7,1
SBI09IXS9320439,24,25,19,6,1
SBI50EPP7891529,67,24,16,8,1
SBI11TMK7987187,81,28,27,1,1
SBI91LGH4534769,92,27,18,9,1
SBI78PHV9352783,78,30,25,5,1
SBI10ZHQ4121467,72,20,18,2,1
SBI01VRE0118217,85,19,14,5,1
SBI11ZPW3115876,61,23,13,10,1
SBI37AVB9549131,19,21,11,10,1
SBI67HIL5159503,82,19,18,1,1
SBI39UIH1005934,92,23,19,4,1
SBI68ITE8976160,18,27,23,4,1
SBI71RTO5523568,20,32,28,4,1
SBI19OES0847995,23,31,25,6,1
SBI23CXU6164093,99,20,11,9,1
SBI63EJP7422806,80,29,28,1,1
SBI64MDR7796210,63,22,21,1,1
SBI99TCY1134611,79,20,19,1,1
SBI14YLW1578346,65,30,18,12,1
SBI80NIC7206093,23,18,14,4,1
SBI17TZE3662858,87,28,16,12,1
SBI15TYG2849305,74,22,14,8,1
SBI37CVX0390213,71,24,14,10,1
SBI89OVX0481968,77,21,18,3,1
SBI06TOM4135708,83,21,12,9,1
SBI97MXU1660795,71,32,26,6,1
SBI02FIR0971311,74,20,13,7,1
SBI62GYX4967482,61,29,17,12,1
SBI35FCY0979592,94,31,16,15,1
SBI55LYY4671061,83,16,12,4,1
SBI57KAL7712691,21,29,19,10,1
SBI42HYE2609006,82,20,13,7,1
SBI77PIR2833098,25,24,14,10,1
SBI15TEG3728551,69,26,25,1,1
SBI11YJH5551313,76,16,9,7,1
SBI10OMS9854839,63,22,19,3,1
SBI03NCH2515449,96,26,19,7,1
SBI74UVJ4417282,97,23,18,5,1
SBI88TVB9334072,70,27,23,4,1
SBI11LXV6007333,64,33,19,14,1
SBI50YAP4742431,80,21,19,2,1
SBI96ZMS4674928,83,20,14,6,1
SBI50YMH0330062,79,22,19,3,1
SBI39ZTG0722163,77,16,12,4,1
SBI18AMX5381841,61,30,24,6,1
SBI03GVM5464345,76,15,13,2,1
SBI46WRG8637738,70,18,10,8,1
SBI95XPM2658271,96,26,23,3,1
SBI10IXD8332441,20,24,18,6,1
SBI65YZT8433245,18,23,21,2,1
SBI75DDX8270377,97,34,22,12,1
SBI52AGQ1949990,91,23,19,4,1
SBI49GIM4561848,18,23,13,10,1
SBI30HGV0891227,18,27,25,2,1
SBI60WBT7924736,74,28,20,8,1
SBI80RCD8598506,62,22,17,5,1
SBI56NUG2512817,77,31,25,6,1
SBI52DCD3660708,25,24,15,9,1
SBI83TBY0070125,73,23,20,3,1
SBI71FSE8456858,24,29,28,1,1
SBI65JVA6229506,96,21,19,2,1
SBI03MCQ1785420,70,26,18,8,1
SBI89NXO8552029,73,26,19,7,1
SBI63GBV1947941,88,30,24,6,1
SBI07EKR9104868,98,26,17,9,1
SBI47LQA7641126,79,31,17,14,1
SBI23JYD4055329,99,23,15,8,1
SBI61LNP7315768,73,26,24,2,1
SBI41OUZ8366793,69,26,20,6,1
SBI19ZMR7951930,76,31,27,4,1
SBI14NTB9604915,93,17,13,4,1
SBI82VYA3812026,78,23,17,6,1
SBI99CKE3057630,61,29,23,6,1
SBI09RVY0796086,95,28,23,5,1
SBI84INZ1325973,90,23,22,1,1
SBI90QOJ5955856,77,36,27,9,1
SBI00VNG8025787,81,27,24,3,1
SBI14QSE3925954,67,17,9,8,1
SBI85WRV1994030,98,28,23,5,1
SBI97IET4205604,71,29,19,10,1
SBI67SPF7774647,81,29,19,10,1
SBI86VDG7945239,96,29,24,5,1
SBI67OML8249138,75,33,24,9,1
SBI39SJN0448637,96,24,23,1,1
SBI48FZZ7243017,97,18,13,5,1
SBI59HZM3891992,96,26,17,9,1
SBI26XZM4021292,61,23,16,7,1
SBI70GMW6605456,75,17,14,3,1
SBI99YJF9770590,61,21,13,8,1
SBI81CGP7935630,93,37,20,17,1
SBI04REV3810452,90,28,26,2,1
SBI74HDX7288926,18,21,19,2,1
SBI82AIM2112205,80,24,13,11,1
SBI81OQH8834834,62,35,34,1,1
SBI14KSQ6463756,74,18,13,5,1
SBI52CPF5378456,24,25,24,1,1
SBI24VCU7051739,67,30,29,1,1
SBI06TVK2939281,23,31,27,4,1
SBI70IBT9074725,66,31,17,14,1
SBI61PJC7366470,73,21,11,10,1
SBI94NTZ2297170,68,32,21,11,1
SBI14ZZO1505370,70,26,23,3,1
SBI12GHH6960103,75,18,17,1,1
SBI76CWC5439253,85,12,9,3,1
SBI10ERV6718188,94,25,16,9,1
SBI04QHR2247294,72,29,28,1,1
SBI85BBA9734002,63,23,12,11,1
SBI56NVI8478813,97,31,28,3,1
SBI05TRA4267275,87,29,22,7,1
SBI80KOR0159428,62,25,19,6,1
SBI14ENQ4789942,60,30,27,3,1
SBI95DKN4926180,79,28,20,8,1
SBI36NXM9979886,79,27,25,2,1
SBI41BVG3214930,80,25,20,5,1
SBI88PUH2534301,25,30,29,1,1
SBI94TRR8551606,86,24,16,8,1
SBI15IQM2247652,75,24,13,11,1
SBI66ERU7066126,80,27,15,12,1
SBI61DHL6907784,85,17,15,2,1
SBI95GME9780311,67,22,19,3,1
SBI92GDK8522118,84,17,13,4,1
SBI21LGE7928461,72,23,20,3,1
SBI21EST8088479,21,21,15,6,1
SBI50BFR2528634,18,23,19,4,1
SBI80VQZ4720069,65,27,26,1,1
SBI36UKX0138137,60,22,21,1,1
SBI54CQA4069354,70,25,16,9,1
SBI46HXD3059961,99,28,24,4,1
SBI50ORJ6537825,22,31,27,4,1
SBI40TAO8541304,76,20,16,4,1
SBI52YLD5599004,97,24,23,1,1
SBI23LPZ2988340,24,27,24,3,1
SBI38YDZ5815417,95,18,10,8,1
SBI41OHW6724214,79,30,21,9,1
SBI27ZZP1275436,74,24,18,6,1
SBI69BWO8612540,21,19,18,1,1
SBI36ZMG0915367,85,19,18,1,1
SBI02XAA9723566,83,33,22,11,1
SBI83IHL2536983,24,28,16,12,1
SBI83GQL0815631,89,21,16,5,1
SBI48IVN7251888,19,26,14,12,1
SBI57BPI0217975,85,24,18,6,1
SBI68WBJ8328566,70,19,14,5,1
SBI72FUL8604771,90,24,19,5,1
SBI25MZT6658564,66,23,15,8,1
SBI40GUZ2106066,25,30,16,14,1
SBI55CTS4590245,82,18,17,1,1
SBI16JZO5169059,21,11,9,2,1
SBI20YWX1064417,20,22,21,1,1
SBI50IBI5624314,72,27,23,4,1
SBI35QNM4485009,79,26,17,9,1
SBI60LWA6599428,64,26,22,4,1
SBI56AEY2531346,20,27,25,2,1
SBI68UYU7130622,88,36,31,5,1
SBI96SBP2636539,98,19,13,6,1
SBI14YQC3906741,92,22,17,5,1
SBI40VUG0225580,70,18,10,8,1
SBI13HDY4927193,89,24,23,1,1
SBI11MJO1141548,23,25,13,12,1
SBI39YJG7254753,81,29,22,7,1
SBI94XFC0830831,99,15,8,7,1
SBI40VTA7297245,80,26,24,2,1
SBI20QDQ7922760,60,11,8,3,1
SBI96JCU2943433,86,32,27,5,1
SBI49XED9452026,71,26,18,8,1
SBI28LQB7642705,21,32,29,3,1
SBI30QWH8563690,77,19,15,4,1
SBI31ENF6425576,66,24,19,5,1
SBI83TQF5614814,85,21,19,2,1
SBI76RVH7166742,81,23,22,1,1
SBI05KWB4774286,86,24,23,1,1
SBI40CRP9394217,62,25,13,12,1
SBI03TSO3806300,23,24,21,3,1
SBI02XYH3563650,92,31,17,14,1
SBI34JVH3554815,24,27,19,8,1
SBI82KWI7309098,90,21,15,6,1
SBI79GKS9302230,22,30,23,7,1
SBI52URL7247262,60,25,15,10,1
SBI34UAR5744671,62,20,16,4,1
SBI14GZQ7683069,18,18,10,8,1
SBI63NZR1035998,86,31,19,12,1
SBI49UBK0530743,78,31,19,12,1
SBI79PUN1100592,25,25,17,8,1
SBI56MUU1470287,82,31,24,7,1
SBI27MLA4564912,60,32,25,7,1
SBI16YUX5602644,79,22,15,7,1
SBI65JAC4845341,74,30,18,12,1
SBI97AUL9291672,65,26,20,6,1
SBI06PUC5708711,60,25,18,7,1
SBI94GNT7169861,84,27,24,3,1
SBI48NOW9914203,98,27,18,9,1
SBI51PNA7918451,90,26,19,7,1
SBI56ZDM8078547,74,22,21,1,1
SBI32WAC9233822,86,24,19,5,1
SBI59QIO3404178,86,25,21,4,1
SBI03ZIP2949624,85,26,18,8,1
SBI12WIO2069647,78,32,21,11,1
SBI58GJN0235153,25,23,15,8,1
SBI26EUU1893685,74,24,22,2,1
SBI04MAR4490771,70,25,19,6,1
SBI63XTH7052933,82,27,18,9,1
SBI64ART4444984,19,27,17,10,1
SBI19RVQ0102670,19,19,16,3,1
SBI46SFP1100323,19,23,20,3,1
SBI84TIK0037237,67,26,25,1,1
SBI32AAE5578696,21,29,18,11,1
SBI73JQA7382105,69,19,13,6,1
SBI63HWD6622541,72,27,23,4,1
SBI85GWM5504078,64,27,21,6,1
SBI04EWN2051238,76,18,17,1,1
SBI22XJC4260844,80,27,16,11,1
SBI48AFA9301233,61,20,13,7,1
SBI71FTR9043433,70,26,17,9,1
SBI77YED9945102,21,21,12,9,1
SBI09LHS1440507,80,31,18,13,1
SBI52TID7502679,64,20,16,4,1
SBI27UQQ5522628,98,28,25,3,1
SBI34RHO4709190,77,14,10,4,1
SBI15TND4812853,77,26,22,4,1
SBI76FLZ2102206,83,15,13,2,1
SBI58AFT5333446,21,17,16,1,1
SBI47MZC1290461,80,18,17,1,1
SBI91MAQ9453799,18,26,24,2,1
SBI96OGT7098870,24,29,20,9,1
SBI07UKC0545276,20,16,9,7,1
SBI02EEV3038828,74,29,26,3,1
SBI01TWF4448615,65,26,24,2,1
SBI01VMU7039838,78,31,28,3,1
SBI89IYU6918543,60,27,21,6,1
SBI40WEF9351146,95,30,18,12,1
SBI77PRD7185506,69,20,14,6,1
SBI50NNQ0689629,23,35,33,2,1
SBI74FCB6329878,81,32,19,13,1
SBI25CYE8442334,98,19,10,9,1
SBI15IST7621488,21,23,16,7,1
SBI64KQL8665803,25,28,26,2,1
SBI18HBC9691871,77,23,20,3,1
SBI32EYJ7740097,84,27,19,8,1
SBI97YPZ6221378,77,31,29,2,1
SBI91MSA8646351,20,38,23,15,1
SBI21NWM4122786,97,30,19,11,1
SBI90HJL5459424,84,32,19,13,1
SBI90OQI2889027,89,26,18,8,1
SBI12HJW1326313,92,26,22,4,1
SBI65ACL0811035,95,20,12,8,1
SBI28JKQ8571457,77,18,15,3,1
SBI46RVO9824181,69,29,22,7,1
SBI08PTO6961822,99,24,22,2,1
SBI12URM9401196,20,26,15,11,1
SBI38JUW3766461,65,38,21,17,1
SBI60BRI3561877,84,32,23,9,1
SBI35NBI9111126,92,30,27,3,1
SBI25ALZ7584363,65,18,13,5,1
SBI45KBS1208317,25,17,11,6,1
SBI06HWV3614666,68,29,22,7,1
SBI33TTD0006237,77,29,28,1,1
SBI11ZUR0664257,23,20,18,2,1
SBI83EBZ5605937,69,32,21,11,1
SBI42DUX6390480,79,22,20,2,1
SBI85KZA7551075,63,11,10,1,1
SBI07GIX8884878,90,20,12,8,1
SBI51PYE3447780,24,29,24,5,1
SBI40XFY9194711,98,29,27,2,1
SBI66QLY7269276,65,23,17,6,1
SBI44PLP7105584,83,25,17,8,1
SBI28KTT3172806,95,20,13,7,1
SBI52YAY5593521,20,18,12,6,1
SBI93RUV8937157,79,29,26,3,1
SBI77OJV5857580,81,30,20,10,1
SBI67LUV5634625,60,30,28,2,1
SBI10RBN1872349,76,26,15,11,1
SBI14ASK5340532,79,26,20,6,1
SBI69XBG8558814,66,16,15,1,1
SBI11XGE0211712,61,26,25,1,1
SBI54EYL7083646,82,24,22,2,1
SBI23LIQ6532809,65,29,24,5,1
SBI06EBI1573431,25,18,10,8,1
SBI56EUO4706461,90,26,24,2,1
SBI57GOE5032944,90,19,18,1,1
SBI20YSO5678086,84,25,18,7,1
SBI94HEZ7280227,98,36,27,9,1
SBI85DFV7983079,74,20,19,1,1
SBI79LVN5223408,90,28,18,10,1
SBI80XID5503186,99,19,14,5,1
SBI20BBD3280536,66,19,16,3,1
SBI10OMG1591543,77,33,19,14,1
SBI47WOI2949666,67,25,16,9,1
SBI65MNN6903260,23,19,18,1,1
SBI07URL3223249,83,26,16,10,1
SBI05SKT4123094,88,28,22,6,1
SBI75BEZ1325242,79,10,9,1,1
SBI29HAM8040186,97,18,17,1,1
SBI53KOT1620726,64,31,25,6,1
SBI56IJO0559168,95,21,16,5,1
SBI02CVI1323491,75,28,26,2,1
SBI91HWO8113719,84,23,14,9,1
SBI80BTW0787802,61,27,14,13,1
SBI94GCH5959122,63,30,22,8,1
SBI22HOD7066105,23,21,13,8,1
SBI81DHW6677083,18,22,21,1,1
SBI05WSY2995385,68,23,21,2,1
SBI69PDZ4004414,66,25,20,5,1
SBI25BBQ0313879,76,26,23,3,1
SBI53UHT2452007,78,32,22,10,1
SBI67FTJ1775140,92,22,13,9,1
SBI32NGH5316282,88,34,30,4,1
SBI80QXE7587690,24,26,18,8,1
SBI66BCZ4096348,20,17,10,7,1
SBI64PVS2401805,22,21,16,5,1
SBI27RVB3894065,95,24,15,9,1
SBI01MNE3933542,79,21,12,9,1
SBI27KVY8738025,21,20,19,1,1
SBI95TXO9631266,64,24,15,9,1
SBI85MKT9434820,69,31,27,4,1
SBI70IBD2936481,81,16,12,4,1
SBI76CZI9428543,22,31,30,1,1
SBI74XJD0957960,91,27,18,9,1
SBI28AFM8501185,75,24,18,6,1
SBI43EWR8963772,75,20,15,5,1
SBI85BIR3083235,22,26,22,4,1
SBI57BJX8878663,25,23,22,1,1
SBI77NKW1800119,22,20,14,6,1
SBI25VXO2419342,65,26,18,8,1
SBI26DIH1725024,72,31,23,8,1
SBI77LMK2097717,63,32,24,8,1
SBI08ESI9239451,91,26,22,4,1
SBI81VLV0061258,73,21,14,7,1
SBI51KMF5893688,75,23,17,6,1
SBI34QKO0598759,74,21,14,7,1
SBI57MZK4944792,23,23,22,1,1
SBI76VAZ0066334,21,21,17,4,1
SBI84FEQ6227526,92,23,19,4,1
SBI08BIJ0632359,24,12,9,3,1
SBI46MIP8142402,22,29,16,13,1
SBI14ILZ8009317,62,20,15,5,1
SBI21WNS6299545,64,23,13,10,1
SBI28XCY0607381,98,30,26,4,1
SBI57YDQ2675079,88,33,24,9,1
SBI03OFS5323719,63,27,18,9,1
SBI01CDF7365014,70,23,12,11,1
SBI37YIP2920504,69,22,21,1,1
SBI88VLO8248451,84,31,28,3,1
SBI68CEP8479325,76,24,15,9,1
SBI43TXO5579301,78,22,16,6,1
SBI43MID5857608,92,19,15,4,1
SBI07DRV0924869,18,18,13,5,1
SBI98HYK2641343,91,24,16,8,1
SBI35VXU7279380,76,17,10,7,1
SBI11UZC2283776,90,20,19,1,1
SBI43RIS9930526,92,30,16,14,1
SBI93XZT8235267,67,24,22,2,1
SBI18UNL9972475,97,24,17,7,1
SBI35JXH8690221,69,20,14,6,1
SBI26WJG7910308,25,23,15,8,1
SBI85EWI1492678,99,32,25,7,1
SBI68HHN8976645,62,27,14,13,1
SBI34FNF5897618,97,11,8,3,1
SBI37GCQ4443318,88,29,23,6,1
SBI81TOV4849677,97,25,17,8,1
SBI63FEU2094771,98,23,21,2,1
SBI76RVJ6234368,18,31,20,11,1
SBI18QGS9976459,81,28,19,9,1
SBI59XAC8966050,97,30,21,9,1
SBI27GPH8064029,87,24,20,4,1
SBI78ZZQ5183406,97,27,26,1,1
SBI21QBB3735540,69,20,12,8,1
SBI08IUO7733985,84,24,18,6,1
SBI16XUG9199050,23,21,19,2,1
SBI60JKQ8388627,69,25,22,3,1
SBI94GRF4816372,81,22,15,7,1
SBI53VXJ3534262,68,27,23,4,1
SBI72FAA7833307,64,26,23,3,1
SBI42HOO8357521,74,30,23,7,1
SBI20TKR1590437,81,29,27,2,1
SBI31POJ9864633,82,30,21,9,1
SBI61SWN6190806,22,26,18,8,1
SBI61YLO4658214,96,20,15,5,1
SBI56YUR3038347,91,25,15,10,1
SBI81URW2805977,66,22,12,10,1
SBI06GTS7885755,64,22,15,7,1
SBI24ABE9284170,97,20,14,6,1
SBI24AWV2941720,76,29,23,6,1
SBI56OCZ6836936,64,17,10,7,1
SBI63IBQ6770086,74,30,29,1,1
SBI30HGX7464080,18,22,15,7,1
SBI75HBT2487269,98,18,12,6,1
SBI38FGQ9646254,78,31,25,6,1
SBI51BID1658024,81,30,17,13,1
SBI78RTG0178695,89,32,29,3,1
SBI27SRJ3341703,75,31,28,3,1
SBI67XXD8817199,66,22,12,10,1
SBI45FXC5725190,70,30,18,12,1
SBI49LAH1195337,98,21,14,7,1
SBI61NWB7753911,68,27,16,11,1
SBI04KAM2879046,93,31,17,14,1
SBI67PHJ8552242,22,32,30,2,1
SBI18CCJ8042222,82,25,23,2,1
SBI42YHR0771822,94,20,11,9,1
SBI50RBO7267428,77,23,19,4,1
SBI65JYB2943199,73,27,23,4,1
SBI98BFQ5575620,95,32,29,3,1
SBI51BZZ9423636,69,37,30,7,1
SBI19DQK8543318,93,25,23,2,1
SBI22LKL8189521,99,27,25,2,1
SBI13ATX0485646,62,24,15,9,1
SBI09ONK3446484,24,22,13,9,1
SBI71BQG0190467,74,14,9,5,1
SBI76CNC2191750,25,23,20,3,1
SBI47OUQ8936757,24,32,27,5,1
SBI68YQW2524017,61,28,16,12,1
SBI10PDD1150644,87,30,23,7,1
SBI46GIY6386618,68,22,18,4,1
SBI01AQO5084373,69,27,18,9,1
SBI15XYL5325344,85,21,16,5,1
SBI03DLU4790952,23,19,18,1,1
SBI78KBZ9235065,74,24,22,2,1
SBI49TZU1468832,69,28,19,9,1
SBI52JWB0402387,64,23,14,9,1
SBI13MSC1893363,22,17,11,6,1
SBI91NNV5264861,19,28,23,5,1
SBI43AUK7846191,19,28,26,2,1
SBI77TRG8256285,86,15,10,5,1
SBI46AIW8313722,92,34,27,7,1
SBI87TIQ8236337,69,30,19,11,1
SBI73TTM1672216,22,24,20,4,1
SBI77JPO8353886,89,22,16,6,1
SBI09EFT8599468,21,26,14,12,1
SBI61QAL7023612,92,20,12,8,1
SBI55VMK4265748,98,17,11,6,1
SBI64GGC6602091,24,23,16,7,1
SBI46LDR3763345,90,26,25,1,1
SBI88EEO2199835,23,19,17,2,1
SBI32JQK5599810,87,13,7,6,1
SBI64FOI6235987,18,21,17,4,1
SBI60ZHT1508070,82,29,28,1,1
SBI23KBB8818482,62,18,12,6,1
SBI17RJX1394293,64,27,25,2,1
SBI45DDE2999427,20,21,14,7,1
SBI89RFL1429445,87,24,16,8,1
SBI46EWP1002723,90,15,9,6,1
SBI69CDH0634156,87,27,20,7,1
SBI18VZQ4094082,22,31,29,2,1
SBI19WUA6128579,93,18,12,6,1
SBI88GFT1194787,69,18,14,4,1
SBI76UYY6073356,68,27,20,7,1
SBI63FBW8087971,88,27,19,8,1
SBI27GOE9410647,75,24,13,11,1
SBI69XWK9369303,66,28,19,9,1
SBI96VPY9325305,88,27,22,5,1
SBI84RBV9724281,85,30,27,3,1
SBI50AEJ8428555,81,19,12,7,1
SBI60LLX4492334,99,24,16,8,1
SBI52PKM8050527,85,26,20,6,1
SBI31DPP8262880,87,23,20,3,1
SBI17FJW3377026,19,26,22,4,1
SBI84XJL6918891,87,19,17,2,1
SBI20KNO1474464,60,34,24,10,1
SBI35AUP7646434,22,17,16,1,1
SBI24GDV3080578,67,22,17,5,1
SBI91NAE4759417,20,15,8,7,1
SBI36TUW0542010,21,17,10,7,1
SBI41QNW8216240,72,28,22,6,1
SBI39DZM2398236,68,25,19,6,1
SBI56MFP9970381,68,20,16,4,1
SBI84LXE9497780,98,32,26,6,1
SBI53DFB3872494,76,19,15,4,1
SBI54SEP4696828,75,31,18,13,1
SBI27WGM0016118,98,22,17,5,1
SBI04OKU4027054,92,27,15,12,1
SBI68UXI3445723,65,22,20,2,1
SBI51MYP3513121,75,30,24,6,1
SBI53HCL5687562,93,24,16,8,1
SBI65TPI0786163,96,23,14,9,1
SBI10CDI8325112,74,32,20,12,1
SBI06UXW7839731,61,28,21,7,1
SBI07QQD6057750,67,19,12,7,1
SBI73MWR5503176,68,25,23,2,1
SBI07OHP3623086,18,22,14,8,1
SBI65JZU8380982,78,25,13,12,1
SBI93ZVB6982808,93,27,21,6,1
SBI98PUN2039730,95,30,21,9,1
SBI07RPD8862747,93,30,28,2,1
SBI28CBL4390098,81,17,10,7,1
SBI49OLD1400718,72,29,20,9,1
SBI90HUS2713109,81,19,16,3,1
SBI41ADG4357837,86,26,23,3,1
SBI77TED3054190,96,28,27,1,1
SBI28QUO4365599,60,27,20,7,1
SBI00XNI2799872,21,15,10,5,1
SBI10XCE6735639,77,20,16,4,1
SBI57BMW0538492,97,28,20,8,1
SBI96WFP9215448,71,27,20,7,1
SBI56KGN2734478,24,17,9,8,1
SBI05QMI3505556,62,29,19,10,1
SBI22SJN1600720,70,26,20,6,1
SBI45PZV3610753,89,29,20,9,1
SBI19AET6613384,20,5,4,1,1
SBI40EKV7289757,79,23,13,10,1
SBI17BJY3967437,90,31,20,11,1
SBI93ZXT2668184,93,21,14,7,1
SBI68ABK3853866,73,31,26,5,1
SBI99XIA5891702,60,23,16,7,1
SBI54GTW1165250,75,20,12,8,1
SBI62SWU9015042,88,24,18,6,1
SBI63CMI2754391,78,22,14,8,1
SBI96GFL0344483,18,25,14,11,1
SBI32RPD5610959,22,26,23,3,1
SBI34JIK2716393,76,15,12,3,1
SBI86ZUF0596794,86,25,15,10,1
SBI43MIO3911232,20,30,26,4,1
SBI65BBL8030520,60,27,14,13,1
SBI30YRQ7224315,67,27,16,11,1
SBI20AMS8048796,60,33,23,10,1
SBI03GCV1352940,99,26,25,1,1
SBI75BBJ7196989,22,17,14,3,1
SBI56HFG5434570,19,28,18,10,1
SBI72JOT1561298,67,28,20,8,1
SBI85DTP9787403,77,32,17,15,1
SBI99XFE2279384,79,35,21,14,1
SBI22CDC0701310,80,27,21,6,1
SBI47PQM9290710,88,21,20,1,1
SBI03XMY5086838,20,20,13,7,1
SBI01MJT0163985,70,35,32,3,1
SBI68WDG9613805,77,33,28,5,1
SBI36NXC4408308,73,20,12,8,1
SBI22UOU5492762,24,28,15,13,1
SBI96DHM1661206,76,21,14,7,1
SBI14BYD7905380,74,29,21,8,1
SBI17DIU8244009,70,22,18,4,1
SBI78OAH2892173,93,29,18,11,1
SBI91HVB3111336,23,40,36,4,1
SBI85APH4748970,62,17,12,5,1
SBI79TOK1312525,91,23,13,10,1
SBI33EQJ4435744,92,21,17,4,1
SBI86VLH2879437,71,28,16,12,1
SBI63BNZ3152778,77,31,26,5,1
SBI97MSY5728684,78,28,21,7,1
SBI30CZZ5493482,70,28,17,11,1
SBI31ZIW8696051,77,25,16,9,1
SBI12VHJ6855135,22,29,15,14,1
SBI45UEP1259774,99,26,23,3,1
SBI61HOI4801637,62,27,22,5,1
SBI54ZWA6678057,75,25,17,8,1
SBI31JSS5920085,76,21,14,7,1
SBI75SBO5421281,92,25,13,12,1
SBI15VTN2248549,96,27,22,5,1
SBI97IGA5883997,84,24,21,3,1
SBI61YGM9945740,77,20,12,8,1
SBI34ERG0942171,76,21,20,1,1
SBI67ZIB4575086,85,29,19,10,1
SBI83AOT4313568,97,24,14,10,1
SBI41GIS2488585,83,27,22,5,1
SBI94TZZ3493404,21,27,16,11,1
SBI72DRQ2080494,63,19,12,7,1
SBI72LWV3516246,25,28,20,8,1
SBI17IAF8283894,81,20,12,8,1
SBI49OOL2244217,68,27,20,7,1
SBI96NJL3866430,79,22,12,10,1
SBI54CIA4727786,19,22,20,2,1
SBI95RJC5787758,86,30,28,2,1
SBI91NAM2634308,83,28,24,4,1
SBI26XVE2926221,80,25,15,10,1
SBI44YGR1682246,19,24,23,1,1
SBI68RUA7795444,92,28,17,11,1
SBI29ABM5717828,90,23,20,3,1
SBI74FQB6122465,84,25,19,6,1
SBI10ACG1380409,90,22,20,2,1
SBI57UDT2669601,99,35,20,15,1
SBI23YBY0703301,69,22,13,9,1
SBI08LEA7025148,76,18,10,8,1
SBI61OKZ0526434,80,21,14,7,1
SBI85DTV3921978,91,15,13,2,1
SBI73GDN8424856,84,24,14,10,1
SBI27GVB6863335,25,32,28,4,1
SBI72FHK1797504,94,26,16,10,1
SBI50FCO9847763,97,27,19,8,1
SBI90BDJ2665039,96,19,17,2,1
SBI79FAL8517933,88,21,11,10,1
SBI39AGQ3990160,66,25,15,10,1
SBI51QRL2548046,82,27,25,2,1
SBI08RGS3109670,84,21,12,9,1
SBI63OOB9793344,90,20,17,3,1
SBI39QOR2455079,70,29,23,6,1
SBI13YAS5132233,79,27,21,6,1
SBI73DBU7246204,92,23,13,10,1
SBI55GBZ9116841,84,25,22,3,1
SBI09RLS6826932,19,24,14,10,1
SBI62LBT5196800,88,25,24,1,1
SBI87VNF4720891,22,15,14,1,1
SBI30PFO2472105,62,20,17,3,1
SBI88WAP8551916,80,24,15,9,1
SBI48MCN1014154,89,22,18,4,1
SBI13ABU3043390,99,26,17,9,1
SBI44GBT7307985,77,30,21,9,1
SBI03TFK6567610,98,30,29,1,1
SBI23HQC9296093,87,29,25,4,1
SBI91FND3249645,25,29,15,14,1
SBI58XUC4390757,94,26,22,4,1
SBI61AQF3812447,75,18,16,2,1
SBI09JBF0264693,18,25,17,8,1
SBI95NKJ5420698,20,33,32,1,1
SBI48FOF9120302,25,23,16,7,1
SBI19RBR4299643,76,24,14,10,1
SBI41KJA2734404,73,13,9,4,1
SBI57PXX0319289,25,25,16,9,1
SBI95CET5021760,71,20,13,7,1
SBI17CKO8429427,80,26,19,7,1
SBI96LZL8705765,84,28,17,11,1
SBI97ZYJ2525439,66,27,25,2,1
SBI43UPV4347683,63,22,21,1,1
SBI64GHV5332205,71,30,24,6,1
SBI45VWH2981441,83,23,19,4,1
SBI40KSK4782897,90,22,20,2,1
SBI82AEQ1600928,72,16,15,1,1
SBI13LEK0092670,22,17,10,7,1
SBI97QXC3125918,67,26,19,7,1
SBI01ONO6505405,82,28,19,9,1
SBI27DVF7413752,94,25,16,9,1
SBI50WRN1852009,62,33,23,10,1
SBI08YCZ0745522,83,20,19,1,1
SBI77IRN9871467,79,20,15,5,1
SBI57ZVL0865438,24,17,10,7,1
SBI84LIC4575945,68,16,9,7,1
SBI33UKI5434026,90,26,24,2,1
SBI86OSW7620630,24,22,15,7,1
SBI42HCU9559414,85,28,15,13,1
SBI22ZUI1516854,65,22,20,2,1
SBI71RUA9198251,68,24,23,1,1
SBI94PDW9575450,94,18,12,6,1
SBI09CNC3668588,69,25,21,4,1
SBI75CVB8157970,71,38,27,11,1
SBI93BGL4876584,65,35,18,17,1
SBI41SNY8160987,64,27,17,10,1
SBI31KZB8833668,74,30,17,13,1
SBI92MYJ5712995,89,30,29,1,1
SBI82JKR5615058,74,23,21,2,1
SBI53NOS2459535,85,21,19,2,1
SBI23JZA3139925,97,23,18,5,1
SBI26TRO4881388,65,28,16,12,1
SBI06AVD9612517,24,27,25,2,1
SBI70UMO7786124,91,17,16,1,1
SBI49YJH1426919,19,26,25,1,1
SBI64XKR3852289,90,14,13,1,1
SBI53WED7683005,76,24,22,2,1
SBI79SYW1076276,65,17,13,4,1
SBI20VQZ9562315,72,26,16,10,1
SBI31DMD6724026,83,23,18,5,1
SBI88RER0947859,89,19,13,6,1
SBI70TBA7415517,73,17,14,3,1
SBI83SNQ0924596,63,24,19,5,1
SBI30XUN5694230,90,19,18,1,1
SBI12VMC8089586,61,22,12,10,1
SBI61AGP4688163,91,28,16,12,1
SBI32EOE5894532,19,27,18,9,1
SBI36KRN0481367,86,20,11,9,1
SBI00AGL5114653,70,37,31,6,1
SBI48LOP0503018,91,24,18,6,1
SBI29OIJ2040575,78,29,27,2,1
SBI61RDL1606661,67,33,27,6,1
SBI53IHZ6375075,61,25,14,11,1
SBI03LKW4784878,74,26,24,2,1
SBI19SVF9229327,63,20,17,3,1
SBI87YNL8359464,74,26,25,1,1
SBI21VTI0826568,79,28,22,6,1
SBI43SCS1738308,93,25,24,1,1
SBI71VYH9711740,76,19,12,7,1
SBI13HLG0259696,62,26,20,6,1
SBI58TQN0456012,70,25,23,2,1
SBI84UIZ3882875,19,24,21,3,1
SBI48HVU1660472,90,30,18,12,1
SBI50DFJ8052262,80,22,13,9,1
SBI12FRP9469453,87,33,19,14,1
SBI63XXQ2380689,75,14,10,4,1
SBI36LZZ7227802,74,26,25,1,1
SBI48HGW8077127,66,20,12,8,1
SBI31XVL2544725,21,19,12,7,1
SBI18FEJ1411384,63,30,26,4,1
SBI71GUN3482235,75,23,20,3,1
SBI41JVJ9371624,66,21,16,5,1
SBI02ZPI4677381,67,24,21,3,1
SBI48PFY6880859,84,23,14,9,1
SBI97QOQ7424208,68,20,11,9,1
SBI72JKW5956098,23,27,26,1,1
SBI38QBY8099488,60,16,9,7,1
SBI36RHC4714790,73,25,19,6,1
SBI35QPC6198711,87,25,16,9,1
SBI07UQJ9148638,24,24,18,6,1
SBI07TRL7807511,96,20,17,3,1
SBI12KWV0853054,25,29,20,9,1
SBI20BKI1741491,22,24,20,4,1
SBI29PRE6830848,25,25,16,9,1
SBI24UVY6896801,22,24,16,8,1
SBI73YBG0170932,72,22,21,1,1
SBI64UOU7229850,20,23,19,4,1
SBI97AMV2169344,89,24,18,6,1
SBI48WKE1131156,79,27,26,1,1
SBI44PBI3269969,71,22,16,6,1
SBI87LGX0770438,99,28,18,10,1
SBI07QCK5102507,67,27,16,11,1
SBI33BGU1905914,97,26,15,11,1
SBI13TXT4682186,98,29,18,11,1
SBI21OGR8958358,62,23,15,8,1
SBI94AVF7485395,99,26,23,3,1
SBI43AUU7074741,73,17,12,5,1
SBI17LBX9238982,77,24,20,4,1
SBI68PEE2393725,80,26,18,8,1
SBI90EWV5030663,87,26,19,7,1
SBI69SSY8628870,95,32,25,7,1
SBI48ICJ5757870,60,26,15,11,1
SBI91DFL4957590,98,27,16,11,1
SBI39GUC8346541,62,24,18,6,1
SBI99NGQ3859277,82,36,19,17,1
SBI40FYE3332016,67,24,18,6,1
SBI77MBC1001349,85,24,18,6,1
SBI31SXA2320342,22,23,19,4,1
SBI69MQE5462368,22,30,17,13,1
SBI84YRF6233139,18,31,29,2,1
SBI26RLQ6631846,65,29,21,8,1
SBI07JQN4767820,68,25,21,4,1
SBI50PUQ4262615,75,17,15,2,1
SBI55OCJ1358607,80,25,20,5,1
SBI63ZDM0047970,85,34,18,16,1
SBI13JHK8373775,64,28,26,2,1
SBI62ZXC6800910,92,23,21,2,1
SBI30YBB5983675,87,29,24,5,1
SBI15MNI6104747,89,29,27,2,1
SBI42GIQ1681029,60,28,22,6,1
SBI40TFM3928134,86,20,11,9,1
SBI85ZPQ6793602,94,28,22,6,1
SBI65YSR3065920,86,23,18,5,1
SBI61IUJ3600457,91,28,27,1,1
SBI18WTN6360643,76,27,20,7,1
SBI81YZH3028304,61,32,24,8,1
SBI74IZH1202174,89,30,20,10,1
SBI67ATA6875811,75,23,20,3,1
SBI47FUN5832390,80,24,23,1,1
SBI14SMZ7403992,80,23,17,6,1
SBI89TES2149829,81,23,21,2,1
SBI61OKR2270613,85,26,18,8,1
SBI30TUN8965986,71,16,9,7,1
SBI45MQP2683581,99,27,26,1,1
SBI31SSP7935638,72,20,14,6,1
SBI36XCI5474941,84,33,18,15,1
SBI83TXR4235849,76,18,17,1,1
SBI49RIU1055310,81,20,17,3,1
SBI60WRV4926378,65,22,21,1,1
SBI25TSE0461169,87,33,17,16,1
SBI91FXH3840068,92,32,25,7,1
SBI05WNS2171121,76,30,16,14,1
SBI59YAJ7603213,83,22,18,4,1
SBI79SAS4255937,67,36,32,4,1
SBI77DXT8637061,83,28,17,11,1
SBI15UEP7122503,75,17,10,7,1
SBI24GUJ2612230,94,25,19,6,1
SBI52LWF5067725,97,26,19,7,1
SBI36FJO5244611,62,30,28,2,1
SBI63XNY4437843,72,31,19,12,1
SBI05CYG2151093,89,20,13,7,1
SBI37RTB4874581,66,25,13,12,1
SBI50FSN1735984,84,22,15,7,1
SBI41QUH3018772,91,32,19,13,1
SBI40HTI9391920,23,26,15,11,1
SBI78UEV7181215,21,19,12,7,1
SBI55DSV8583736,23,22,17,5,1
SBI13SEB9768804,79,30,17,13,1
SBI53RYC0708874,21,24,18,6,1
SBI36QFB6679564,97,23,18,5,1
SBI34MAJ3888006,79,26,23,3,1
SBI19ORF0322401,63,27,23,4,1
SBI65LUT5450725,63,23,14,9,1
SBI46IDY9548638,68,27,16,11,1
SBI89VZC8001907,21,27,26,1,1
SBI66EWM3901188,20,20,15,5,1
SBI77WTJ1891823,19,27,16,11,1
SBI55DZR1814697,97,13,12,1,1
SBI02EUB7183698,80,25,23,2,1
SBI05GIN8846565,23,31,21,10,1
SBI77NFO7611935,60,22,17,5,1
SBI81GFB4510588,88,17,11,6,1
SBI71RJB9316691,90,25,20,5,1
SBI33XQK8386909,91,16,11,5,1
SBI35VLJ7380635,23,24,20,4,1
SBI23QQK4479485,60,18,12,6,1
SBI21EAF9702437,72,23,12,11,1
SBI52YTX5374373,75,17,9,8,1
SBI48VMJ1665797,86,22,17,5,1
SBI68PLL3284127,81,24,23,1,1
SBI09WTO6294274,19,26,21,5,1
SBI19FGA4037124,62,20,17,3,1
SBI50ZVC8143382,74,27,17,10,1
SBI51ONV0629169,25,30,17,13,1
SBI44HIJ8032137,79,16,13,3,1
SBI75MNR6605133,97,21,13,8,1
SBI06KNP3499832,94,29,26,3,1
SBI72MRQ3169749,95,27,26,1,1
SBI97BHE6613646,72,26,16,10,1
SBI89YHV3796370,70,21,15,6,1
SBI33MVG0010243,98,26,17,9,1
SBI16KEX8219859,76,25,18,7,1
SBI35AHM4239994,84,13,8,5,1
SBI87FJU1955687,60,30,20,10,1
SBI63SSS2727404,79,38,36,2,1
SBI53SUQ0549748,19,23,18,5,1
SBI67UHY8505091,88,25,23,2,1
SBI57SZR5765093,87,20,11,9,1
SBI82APP7909072,71,24,14,10,1
SBI87LKL0275516,91,22,17,5,1
SBI77TWS6261391,64,29,26,3,1
SBI44XVM8436273,61,18,13,5,1
SBI16UQB4310356,79,25,19,6,1
SBI29UAJ5964296,71,13,12,1,1
SBI83AUP0529322,62,23,20,3,1
SBI45UVZ2118302,90,22,20,2,1
SBI83MAU7574238,75,28,27,1,1
SBI55VCX6723156,98,28,16,12,1
SBI72JYT5596265,97,22,16,6,1
SBI96ERU1770484,95,16,12,4,1
SBI11DDY6686756,63,23,16,7,1
SBI95ZJQ9298576,72,27,21,6,1
SBI55VKP1350435,78,17,12,5,1
SBI81LRC5842850,19,23,14,9,1
SBI58ECP6021884,68,31,18,13,1
SBI83WUU7265936,86,23,21,2,1
SBI16QJO6818927,90,28,19,9,1
SBI35REE2759565,81,27,23,4,1
SBI14ABO0768493,21,29,24,5,1
SBI69TPH1132638,23,22,16,6,1
SBI62PDL1896012,72,19,16,3,1
SBI42IMO4531868,78,31,18,13,1
SBI92BHK2926196,94,17,13,4,1
SBI20BPW1679067,72,32,23,9,1
SBI88RCC1338990,91,33,32,1,1
SBI76ITE6467657,22,16,13,3,1
SBI46AML6253872,76,26,20,6,1
SBI04GDI3867915,65,22,21,1,1
SBI10JPF8809098,81,28,18,10,1
SBI91QLI5637278,89,19,12,7,1
SBI54ZSM5002989,77,21,20,1,1
SBI10IMB7324791,75,34,31,3,1
SBI64ZKC7458536,96,28,15,13,1
SBI65YPD5727497,99,20,18,2,1
SBI91KYL3489636,25,26,19,7,1
SBI03DRF1492508,81,28,19,9,1
SBI44PLL2639106,22,33,25,8,1
SBI61SSY3972064,75,36,27,9,1
SBI78LFD7239054,90,28,18,10,1
SBI38ATQ5625054,96,22,17,5,1
SBI23ZAY3100774,80,27,25,2,1
SBI73TDJ0131663,69,25,19,6,1
SBI54NMJ2171417,75,24,18,6,1
SBI32MDC0150889,67,30,25,5,1
SBI29ZWQ1323812,63,28,25,3,1
SBI13LHE0699813,74,28,26,2,1
SBI79WRC3037817,22,27,15,12,1
SBI93OAK1020124,75,19,16,3,1
SBI04EZO9276137,64,23,15,8,1
SBI65SKL6414231,88,15,10,5,1
SBI24GAX7727758,63,24,21,3,1
SBI07ABE0817636,75,32,21,11,1
SBI45SBY6001123,77,27,16,11,1
SBI06WZK4407329,61,19,10,9,1
SBI31TAN2025948,67,20,17,3,1
SBI33QGZ5355200,63,27,19,8,1
SBI81XAU7718125,90,25,21,4,1
SBI66FOS8302233,85,33,23,10,1
SBI18GXE2462931,75,24,23,1,1
SBI01JBM5694835,83,20,19,1,1
SBI40KCA5358110,74,18,12,6,1
SBI98LJH6278325,94,25,20,5,1
SBI91ORM3674993,82,22,15,7,1
SBI65JLU0517372,25,31,17,14,1
SBI84VLW8530850,99,18,12,6,1
SBI27ECS2360691,89,26,17,9,1
SBI62KJE2565215,94,15,8,7,1
SBI31NJH9704396,22,29,27,2,1
SBI63ZSS6384297,92,22,13,9,1
SBI61XAG1449937,75,27,14,13,1
SBI15PSN5523727,24,19,18,1,1
SBI19YGT0268420,94,19,14,5,1
SBI13MVP0040610,82,24,13,11,1
SBI19NSI6264825,65,14,9,5,1
SBI70MKR6769035,21,24,22,2,1
SBI12ZRR1759356,85,31,24,7,1
SBI85OMU4179118,23,18,12,6,1
SBI41RNG0992264,83,31,17,14,1
SBI02OOR4789406,95,26,25,1,1
SBI24SCT4015733,92,24,21,3,1
SBI17NSD8315126,62,23,15,8,1
SBI81HLA1946449,23,15,9,6,1
SBI32CRQ8393101,71,23,13,10,1
SBI50IGY2255293,86,24,20,4,1
SBI20BPM4177850,20,24,13,11,1
SBI78LWI2504179,60,28,15,13,1
SBI90CLB2721266,76,21,18,3,1
SBI71ISW7262260,66,29,18,11,1
SBI11XFV0675007,92,24,15,9,1
SBI06MGF4192054,89,23,15,8,1
SBI43XBQ1501210,83,26,24,2,1
SBI07AMZ0439887,75,27,23,4,1
SBI92PUX8753235,68,22,12,10,1
SBI37ESC4283175,96,24,15,9,1
SBI01NPN4695299,73,18,16,2,1
SBI64RYJ7000649,64,25,17,8,1
SBI70FSQ1651638,60,23,14,9,1
SBI28CLT1889636,65,25,15,10,1
SBI59OVM7753569,20,26,21,5,1
SBI24AZH3059406,62,17,10,7,1
SBI76CIW6245956,61,24,23,1,1
SBI39SRC9775967,25,26,16,10,1
SBI65IAJ1139380,78,26,22,4,1
SBI76DSE4598673,88,34,28,6,1
SBI55PHQ3004240,85,28,21,7,1
SBI01NKT3958346,63,22,18,4,1
SBI41JSV9735560,63,28,19,9,1
SBI98YAE0948965,75,22,12,10,1
SBI31XKE3395206,67,28,19,9,1
SBI63ZMC3276179,76,20,18,2,1
SBI18CIF6651590,79,17,11,6,1
SBI32TLU5093365,19,26,21,5,1
SBI77YPI7306547,91,29,19,10,1
SBI03ANH7259464,64,33,20,13,1
SBI33WKH6136806,77,21,12,9,1
SBI44EML3305044,90,30,29,1,1
SBI13DSL8769710,88,23,19,4,1
SBI28KYV0241839,75,26,18,8,1
SBI24NQS2115084,89,19,15,4,1
SBI95EXA0584935,79,25,23,2,1
SBI46GPL3249112,69,19,13,6,1
SBI84MWQ6165532,75,27,23,4,1
SBI76RVY9253229,62,27,22,5,1
SBI09TUZ4902465,91,28,26,2,1
SBI29ZKD9412929,93,25,22,3,1
SBI90MGB6886537,21,23,12,11,1
SBI68HJV8930941,88,29,23,6,1
SBI72RCW2641992,70,23,18,5,1
SBI18OEA4894290,20,25,13,12,1
SBI37JZN9727497,87,23,22,1,1
SBI11BTN7965899,75,10,9,1,1
SBI35ADY6668707,18,25,14,11,1
SBI21JRL0286314,61,24,21,3,1
SBI56LBE5268139,79,27,25,2,1
SBI58QUG8472267,76,17,10,7,1
SBI53TJV3408843,97,23,15,8,1
SBI25YOE5493765,85,35,25,10,1
SBI26ZYE8267303,22,25,15,10,1
SBI84CMP2683353,64,24,22,2,1
SBI16MAK5377315,77,35,18,17,1
SBI24BVM2214030,87,26,15,11,1
SBI17PRM3394617,25,21,17,4,1
SBI89TXY4900761,81,20,18,2,1
SBI53LIZ1266923,82,23,15,8,1
SBI35YKP2429396,78,29,22,7,1
SBI74FLE0165023,60,29,26,3,1
SBI78UCF4687440,66,22,21,1,1
SBI69LST6008402,62,29,15,14,1
SBI63WPJ8039453,69,19,16,3,1
SBI71LEB2797003,77,23,12,11,1
SBI14NSE2791761,94,22,21,1,1
SBI79WQN9926265,87,14,12,2,1
SBI57DNF1281501,72,26,15,11,1
SBI90AVO3610746,95,30,17,13,1
SBI59HOR3578566,21,32,29,3,1
SBI94EVM7878610,99,21,13,8,1
SBI51EYP1614523,89,21,17,4,1
SBI90LTU6042522,63,27,22,5,1
SBI39AOA9829196,75,21,17,4,1
SBI33JLG3334990,68,17,16,1,1
SBI10MOP9149210,84,23,16,7,1
SBI46LSL4484325,86,19,11,8,1
SBI41GBD0432514,19,24,17,7,1
SBI60LUH9031071,64,37,22,15,1
SBI37VCR5346972,74,29,20,9,1
SBI58MTC8479771,93,29,26,3,1
SBI23ZNT0191221,66,29,28,1,1
SBI13AUS1202752,73,27,14,13,1
SBI11YXF1988405,20,29,21,8,1
SBI88UIO2605112,68,21,13,8,1
SBI03SNA7261256,62,23,21,2,1
SBI00ZAM6635819,86,18,13,5,1
SBI07CWB0489904,77,19,10,9,1
SBI43XBL9321322,62,20,13,7,1
SBI28MRA1512724,70,20,11,9,1
SBI07PKO7670385,94,25,16,9,1
SBI15GJB5415207,62,26,18,8,1
SBI33TGX8714455,97,21,15,6,1
SBI82DCG4484994,24,32,26,6,1
SBI13EUZ2340096,83,18,14,4,1
SBI97ILH3108967,95,24,15,9,1
SBI53ZRZ1097114,64,24,18,6,1
SBI38LQZ8625344,97,20,19,1,1
SBI98HVY8922784,85,22,12,10,1
SBI06OIQ2689157,93,26,23,3,1
SBI94ZSS2221753,83,15,8,7,1
SBI39VSE7598046,93,22,18,4,1
SBI95GTC0172464,64,28,23,5,1
SBI74CVX6170430,72,26,18,8,1
SBI32HDH1836364,91,25,16,9,1
SBI92DRY2978010,71,20,11,9,1
SBI36FWF9970108,78,22,12,10,1
SBI82QNL7486075,92,25,14,11,1
SBI56EJI6506886,85,26,14,12,1
SBI41TKW6592401,80,20,12,8,1
SBI65CBV8197232,73,24,23,1,1
SBI05ANS5485495,73,26,15,11,1
SBI93YYF8989571,78,31,26,5,1
SBI35PFH3889587,67,16,15,1,1
SBI98PRR1199990,93,27,17,10,1
SBI56IJO8259743,25,19,12,7,1
SBI96JFZ0119848,24,26,24,2,1
SBI08NGB2732723,18,22,15,7,1
SBI22RHB8086395,99,14,9,5,1
SBI24TCB2685232,75,19,18,1,1
SBI41VHN5175678,60,17,15,2,1
SBI35JPH2359795,19,27,20,7,1
SBI68BKM9585208,76,30,27,3,1
SBI90CZL4174267,64,25,13,12,1
SBI26BCG1436896,21,23,15,8,1
SBI32NRY1392203,96,29,24,5,1
SBI61ZIT6393356,80,18,12,6,1
SBI77RFF5675602,61,27,25,2,1
SBI20YSH6254620,76,13,10,3,1
SBI89DRD3758140,63,27,15,12,1
SBI23LCY2431774,66,17,10,7,1
SBI53TGQ8652754,23,27,17,10,1
SBI77WSW3315007,87,35,29,6,1
SBI80FTA7765951,20,26,25,1,1
SBI02CPY6399093,85,28,19,9,1
SBI28TNJ8929146,99,27,17,10,1
SBI87BJK7702322,68,21,20,1,1
SBI41ITE3438766,80,31,18,13,1
SBI77MRZ4316066,25,28,23,5,1
SBI77FJZ7184281,98,21,15,6,1
SBI24FKJ6247509,72,25,24,1,1
SBI57CNT8831150,62,25,20,5,1
SBI26ZKN5594763,83,20,16,4,1
SBI33IKO6990298,81,28,24,4,1
SBI39QXA1354310,67,26,17,9,1
SBI98BSU0050818,70,23,16,7,1
SBI31TEI6573645,85,24,20,4,1
SBI83MAO6783025,75,24,20,4,1
SBI41PCH1812497,94,24,15,9,1
SBI06WEW0786330,63,24,14,10,1
SBI16PVH7959356,62,20,18,2,1
SBI77UBO1598455,95,28,22,6,1
SBI40WJX9712497,92,25,24,1,1
SBI16ZVG6264443,64,24,23,1,1
SBI63NHC0652416,84,21,17,4,1
SBI85NRZ9331823,63,33,30,3,1
SBI16KVD3189362,74,26,20,6,1
SBI51KHZ9579413,19,13,11,2,1
SBI23JKY6054732,22,39,36,3,1
SBI21OOW7315785,69,25,18,7,1
SBI34NQZ2169183,91,28,26,2,1
SBI36VGX7423652,84,26,18,8,1
SBI55NQJ8917834,99,33,25,8,1
SBI74TTD6919600,67,31,29,2,1
SBI17RVU2330818,87,30,21,9,1
SBI47DSY8746178,97,29,23,6,1
SBI24FNR9308218,22,32,17,15,1
SBI56DCZ2134128,65,27,22,5,1
SBI50IJR1388283,92,23,17,6,1
SBI26ARQ0715073,83,26,22,4,1
SBI32SUS9265911,88,31,22,9,1
SBI11YKG9110847,74,26,23,3,1
SBI54XUV9859508,65,35,27,8,1
SBI80CMP4078946,23,32,25,7,1
SBI22NTB6761812,60,16,14,2,1
SBI96VPG7145498,95,17,12,5,1
SBI14DTW6886267,86,22,18,4,1
SBI73YZK0931027,91,19,11,8,1
SBI76WDA1014110,66,15,13,2,1
SBI08ZRD6554323,24,24,14,10,1
SBI07RVI2352407,61,31,26,5,1
SBI85JIF1571081,85,31,24,7,1
SBI68XJE5483799,20,26,16,10,1
SBI29SRN9268902,97,26,25,1,1
SBI55QVB0881410,66,15,8,7,1
SBI10DYU6632436,25,26,16,10,1
SBI11TKR3372181,72,29,18,11,1
SBI27VKE0071234,88,27,14,13,1
SBI76SSR9792872,67,22,20,2,1
SBI58QQX9625446,99,28,18,10,1
SBI06ZPI7817055,68,16,11,5,1
SBI80KYL4863557,68,26,21,5,1
SBI63OWN6798395,80,18,13,5,1
SBI15VHG9505969,25,21,12,9,1
SBI86QKD2876004,64,22,13,9,1
SBI20WUR7503926,73,23,18,5,1
SBI12TOV4486646,74,21,17,4,1
SBI83FKI0031039,74,20,16,4,1
SBI84RCN2813014,82,22,20,2,1
SBI20IVR2338427,89,27,25,2,1
SBI87HUM7045153,96,23,13,10,1
SBI19VPI6452574,25,21,15,6,1
SBI18OQS6617705,64,23,22,1,1
SBI38WJY6896811,18,27,17,10,1
SBI07KVW3105057,20,16,15,1,1
SBI54KCC9262295,98,30,16,14,1
SBI13IKU9335068,63,31,28,3,1
SBI78OXC6902092,73,23,12,11,1
SBI09BYY1143836,22,16,10,6,1
SBI93AWV2833572,61,25,22,3,1
SBI09NZC9698239,24,21,12,9,1
SBI34KIX1325625,24,41,23,18,1
SBI06YLS6755248,21,32,31,1,1
SBI29GOJ2347577,20,27,22,5,1
SBI84VGT1685503,87,25,19,6,1
SBI70NBQ4883350,88,27,18,9,1
SBI95UDL9054981,97,19,12,7,1
SBI09SZD7609609,93,25,20,5,1
SBI73BSJ3872419,66,23,16,7,1
SBI33RQK3251914,73,23,21,2,1
SBI25KAE9094414,72,20,16,4,1
SBI20KTD9207830,97,27,26,1,1
SBI33SXH2943761,62,24,15,9,1
SBI15AEM2955838,25,28,20,8,1
SBI32VXS6798039,65,34,33,1,1
SBI32KRY3582510,85,19,16,3,1
SBI17QWS3975681,70,20,13,7,1
SBI88LUX2475246,89,42,26,16,1
SBI30PFS7646127,69,19,10,9,1
SBI14LAY8839402,97,21,11,10,1
SBI54LVX0627722,67,20,15,5,1
SBI40LUX6168753,93,20,16,4,1
SBI94FET2037032,64,24,20,4,1
SBI99VHM8025695,82,28,21,7,1
SBI20KEU9631288,83,27,20,7,1
SBI96QBD5510010,67,29,19,10,1
SBI42NVT2458827,63,27,20,7,1
SBI64WAC0174676,76,22,13,9,1
SBI73VNM3958697,70,38,31,7,1
SBI21XUI3157746,78,29,21,8,1
SBI78CGY1402044,61,24,22,2,1
SBI35GLA3163812,94,23,19,4,1
SBI36HLR7950550,21,25,22,3,1
SBI51UYD8699346,20,27,18,9,1
SBI24VUT4333574,91,14,8,6,1
SBI86IMK7335303,95,23,19,4,1
SBI22NJX8914148,61,24,19,5,1
SBI20YNP2014106,62,27,19,8,1
SBI32JXO2549043,64,24,18,6,1
SBI32WLD7676398,18,24,21,3,1
SBI77AQI2840068,60,26,14,12,1
SBI48DIU9823536,78,23,21,2,1
SBI89GBH8914930,68,21,20,1,1
SBI04GAK6454914,90,15,14,1,1
SBI61ZSU3313522,77,24,13,11,1
SBI72NFG1558633,18,26,23,3,1
SBI91BOL1882304,20,31,21,10,1
SBI56FIJ8085450,65,23,14,9,1
SBI08YUM8391471,61,26,19,7,1
SBI43UHS9506740,78,28,20,8,1
SBI90IRK7214573,71,25,20,5,1
SBI95ENL9414040,84,29,15,14,1
SBI06IUN9759014,19,27,15,12,1
SBI08JCD8215336,61,23,21,2,1
SBI88GFC0357093,67,28,17,11,1
SBI72ABH0998996,74,32,22,10,1
SBI01LEA4198281,67,26,25,1,1
SBI35TXK8374270,75,28,20,8,1
SBI28MTM6242029,21,22,14,8,1
SBI53CMN4130761,80,35,18,17,1
SBI75MKU7565379,82,31,19,12,1
SBI83RYZ4790318,79,28,15,13,1
SBI96PEW8500855,19,27,24,3,1
SBI81BPC2101747,75,25,24,1,1
SBI45PVX3827993,60,25,18,7,1
SBI46OOK1169525,64,28,22,6,1
SBI71SET0977581,88,15,12,3,1
SBI86NHX7375063,81,31,23,8,1
SBI75SWZ4231636,61,29,28,1,1
SBI17ZAS1002602,21,31,29,2,1
SBI54UXN6040693,67,25,17,8,1
SBI88QRH4905648,70,16,10,6,1
SBI89YOQ5849618,78,22,16,6,1
SBI58MMC3009150,93,16,10,6,1
SBI06NDB4564089,97,23,18,5,1
SBI82BCM9018548,80,23,12,11,1
SBI68WEA7157777,76,20,19,1,1
SBI08OIV7614317,68,31,23,8,1
SBI16PFQ9777257,95,20,13,7,1
SBI83HJF1116673,70,25,23,2,1
SBI68AUF7249504,87,24,20,4,1
SBI58BDG8171263,66,25,14,11,1
SBI90OFT4955839,24,29,18,11,1
SBI31UFP4478450,21,26,23,3,1
SBI43UVQ1086181,65,32,18,14,1
SBI08VQT8635708,98,26,23,3,1
SBI36XVA7114495,83,28,15,13,1
SBI91PDC0967965,66,32,24,8,1
SBI42CJN0558071,95,27,23,4,1
SBI50QBN9295309,93,29,26,3,1
SBI75GXZ1216640,86,33,25,8,1
SBI76AIF5966323,22,15,10,5,1
SBI41QMD6290181,89,20,13,7,1
SBI47CXM3208967,69,31,19,12,1
SBI07XKM7527315,92,24,20,4,1
SBI42JBI6547938,78,26,19,7,1
SBI18TEY4251077,80,31,26,5,1
SBI13KCI6802758,86,24,22,2,1
SBI06DUR4526530,62,34,19,15,1
SBI23GXD2319240,87,24,18,6,1
SBI44YTA1265693,85,27,25,2,1
SBI24WCY8498267,21,21,13,8,1
SBI77GLW8379237,64,23,19,4,1
SBI16OWS9750828,75,26,16,10,1
SBI40TVL6550329,65,28,27,1,1
SBI12OMV6879689,22,29,22,7,1
SBI05HUS1613850,18,20,12,8,1
SBI09NEX7229086,64,24,18,6,1
SBI55KFN3940578,93,26,15,11,1
SBI27HQM9508567,72,17,10,7,1
SBI35KOF0758616,99,27,18,9,1
SBI13WBR1696536,93,30,20,10,1
SBI61LDJ9594402,93,23,13,10,1
SBI26JHH8872039,89,31,22,9,1
SBI39FQO5382335,70,26,15,11,1
SBI23WWR4774643,99,24,17,7,1
SBI53QRV7383929,91,25,17,8,1
SBI30MDP7165361,25,27,17,10,1
SBI85YEV0765939,84,34,32,2,1
SBI46NBP4888393,71,28,15,13,1
SBI18VXS1536218,97,21,16,5,1
SBI12OJM9325878,91,25,21,4,1
SBI30YVK6320215,81,24,19,5,1
SBI10OLT4224425,20,25,18,7,1
SBI32AJI3107894,88,24,14,10,1
SBI73IPO7761967,88,20,15,5,1
SBI87FIG7038414,87,27,22,5,1
SBI10NRA3249347,92,16,13,3,1
SBI18TIZ1703464,67,30,16,14,1
SBI01MSH4518847,87,27,26,1,1
SBI17XDP8796331,70,19,10,9,1
SBI47RJG2859177,72,31,22,9,1
SBI71MMQ2502413,68,22,12,10,1
SBI43EPA4377457,95,21,14,7,1
SBI85IAI9111348,74,22,16,6,1
SBI56AOP2345952,79,25,15,10,1
SBI47YYG5398199,96,28,21,7,1
SBI29ROP1655492,70,27,20,7,1
SBI38YCK8731860,85,23,17,6,1
SBI57JZJ3488732,94,18,16,2,1
SBI40ZNG4468622,86,21,19,2,1
SBI53CUJ4838539,93,25,14,11,1
SBI62PJE8402786,23,24,19,5,1
SBI09SWM5428618,62,31,16,15,1
SBI05PJH2061362,20,23,14,9,1
SBI59CKL4650347,76,25,13,12,1
SBI31PUQ8507223,69,10,7,3,1
SBI55KEI2831144,20,26,22,4,1
SBI23UNR3308918,98,28,19,9,1
SBI50YXM7508299,62,21,19,2,1
SBI30YOS0784671,79,22,13,9,1
SBI70LSS6188306,18,30,19,11,1
SBI70BWU0818598,67,30,22,8,1
SBI64CZQ0027648,19,26,21,5,1
SBI66UMB0106821,81,32,23,9,1
SBI15YBN9999702,69,28,20,8,1
SBI38CYJ7844260,86,30,28,2,1
SBI83RVB6291209,87,29,24,5,1
SBI31OSG8961126,64,21,14,7,1
SBI41BLO3993577,88,34,24,10,1
SBI49SNS5549750,86,34,26,8,1
SBI04EEL5835624,69,24,18,6,1
SBI90PTH7054752,62,29,18,11,1
SBI10DPX7132243,78,24,14,10,1
SBI28YCC7881051,84,36,26,10,1
SBI78PIY3399118,64,27,24,3,1
SBI86NWH5026289,68,27,14,13,1
SBI85YZH3932351,23,22,12,10,1
SBI43CPF6838720,70,24,21,3,1
SBI91OIL8361685,89,17,13,4,1
SBI98UFG2826997,85,33,31,2,1
SBI92YQX2132544,74,19,13,6,1
SBI48EUC7755237,75,22,19,3,1
SBI17TBO6594904,89,24,14,10,1
SBI59GQT3064394,77,31,20,11,1
SBI62VTE4504469,64,31,26,5,1
SBI60IEO8048887,62,31,21,10,1
SBI38HTR3656846,86,25,21,4,1
SBI10LEY7100950,88,26,20,6,1
SBI27JCR7122606,87,31,27,4,1
SBI14XJO5321684,71,33,23,10,1
SBI03ECN0432304,21,24,13,11,1
SBI02QVC4520563,91,19,15,4,1
SBI59GOK2099595,69,18,16,2,1
SBI45VNT0716115,20,27,16,11,1
SBI46AYR4210552,80,29,16,13,1
SBI27ADJ3320539,91,18,15,3,1
SBI96WLS5183159,76,18,12,6,1
SBI49ASX5953489,61,31,21,10,1
SBI33WQY5116770,84,16,12,4,1
SBI72MLW8678471,64,15,10,5,1
SBI20HDE1286024,68,29,23,6,1
SBI96PAS7052800,22,35,18,17,1
SBI50NTB1014684,97,30,21,9,1
SBI09ZNQ0258269,66,28,25,3,1
SBI97PIZ0144142,68,25,17,8,1
SBI01KGT8252717,88,28,20,8,1
SBI92BUG0331399,22,30,23,7,1
SBI08XHP0733703,80,29,18,11,1
SBI43KJW4249305,89,31,26,5,1
SBI49BRR2987871,84,26,23,3,1
SBI75MAQ4113520,82,24,20,4,1
SBI10KWF8232094,80,26,20,6,1
SBI00FST9886353,84,29,25,4,1
SBI59ENT2428300,65,20,17,3,1
SBI64MSC6464185,89,23,17,6,1
SBI66RYX7284049,72,29,26,3,1
SBI86PJN8915078,66,29,17,12,1
SBI50CBZ1343848,95,30,26,4,1
SBI53QFW4899704,20,28,24,4,1
SBI39SBC1397657,94,25,24,1,1
SBI31KYK9298850,61,19,10,9,1
SBI27AJG1910927,70,30,25,5,1
SBI43IIN9571450,78,27,22,5,1
SBI79LMD3940240,92,31,25,6,1
SBI84NJH6460750,76,25,21,4,1
SBI20TMZ3984093,64,25,13,12,1
SBI68KXY0009209,78,25,20,5,1
SBI58VZE1386272,66,29,17,12,1
SBI48XKL1173264,18,24,13,11,1
SBI39BBJ8526406,82,19,11,8,1
SBI69TGL1594702,88,11,8,3,1
SBI37XRF9390318,73,38,24,14,1
SBI99MVE6702036,18,32,25,7,1
SBI71OBF5263853,75,29,19,10,1
SBI83WXN7118384,74,21,16,5,1
SBI45BRG6071532,80,20,13,7,1
SBI62VMI9587285,99,24,20,4,1
SBI69ZQO5025414,78,23,20,3,1
SBI01LCC9320605,65,31,26,5,1
SBI71QLR6855409,18,16,12,4,1
SBI83DON0162309,96,33,26,7,1
SBI61PBE4314635,95,27,22,5,1
SBI94PQA8843949,61,22,19,3,1
SBI22XSP8420523,94,22,15,7,1
SBI13JTH3597190,96,20,15,5,1
SBI85VCH3132373,77,34,25,9,1
SBI50HCB8230417,66,28,25,3,1
SBI71DEY1102970,84,18,15,3,1
SBI45WCD9639427,62,21,12,9,1
SBI17HLG2028829,21,21,15,6,1
SBI70VKY1689761,68,23,12,11,1
SBI33XIG5510997,87,21,16,5,1
SBI86PTM6246042,96,27,26,1,1
SBI19GRL7693544,95,25,21,4,1
SBI23ZYR6510979,20,28,23,5,1
SBI06VRN6198223,67,25,17,8,1
SBI04ESM1716681,95,31,23,8,1
SBI52XMD3284076,71,25,23,2,1
SBI02CBZ0842805,91,22,18,4,1
SBI55HSU9713588,96,23,16,7,1
SBI26QAQ7751767,95,23,19,4,1
SBI25NRV2205488,64,17,15,2,1
SBI59WMT0803742,90,21,12,9,1
SBI60VDO7707110,60,30,29,1,1
SBI40ISQ8983238,90,32,18,14,1
SBI81LCD0618184,77,31,19,12,1
SBI12IMH4264546,87,25,23,2,1
SBI76VZT8185268,64,25,15,10,1
SBI21ENL0900132,84,26,18,8,1
SBI37FLM4818238,84,24,20,4,1
SBI30ONB0593281,98,29,27,2,1
SBI32IHS5586531,24,26,17,9,1
SBI05SNO1898065,91,19,15,4,1
SBI28DNF6093181,74,17,15,2,1
SBI92UYI9081484,23,25,18,7,1
SBI00KKN4215841,23,27,25,2,1
SBI16XHI9072925,98,25,19,6,1
SBI89VIM3378845,25,27,16,11,1
SBI03MTO1024850,79,20,13,7,1
SBI49RGR6789212,80,21,14,7,1
SBI79RDP9576462,81,21,19,2,1
SBI14BZU9442599,92,16,13,3,1
SBI13HHB4065407,83,24,21,3,1
SBI86LFL8866523,93,23,15,8,1
SBI05MVW2997225,81,25,14,11,1
SBI26ZFY2311508,85,25,14,11,1
SBI34GIV3044394,86,25,24,1,1
SBI27UYZ1722165,66,18,14,4,1
SBI00JXE7105034,81,19,13,6,1
SBI53UTI2006792,76,20,15,5,1
SBI12WDW5320563,72,29,27,2,1
SBI87FHW5405468,66,27,21,6,1
SBI52TZL1247788,87,23,21,2,1
SBI02KMR7889771,24,23,21,2,1
SBI93XJH8090265,79,29,24,5,1
SBI13NQZ3320596,94,19,12,7,1
SBI15UUZ0363278,98,23,21,2,1
SBI81QNX0371526,80,24,14,10,1
SBI32GMO9589825,82,20,17,3,1
SBI12BGZ6578176,90,22,17,5,1
SBI38THO6152441,93,35,20,15,1
SBI28LZZ1811907,78,29,22,7,1
SBI02IYH9164422,68,19,10,9,1
SBI47CGA4451474,77,24,23,1,1
SBI00BMA2174488,69,26,14,12,1
SBI40WCS7956882,76,14,10,4,1
SBI21XQA6460980,61,20,14,6,1
SBI23LKD5622478,74,19,18,1,1
SBI66AWE2159162,74,15,13,2,1
SBI59WKC4475349,21,20,15,5,1
SBI70RQH5618875,80,31,20,11,1
SBI67EIP9862578,67,16,11,5,1
SBI28AGI2110610,99,27,21,6,1
SBI69OGK6951477,78,21,17,4,1
SBI35LJI1943598,61,22,16,6,1
SBI34WFK9583898,67,25,21,4,1
SBI85YKZ3109729,66,28,24,4,1
SBI48GPW2537435,81,29,16,13,1
SBI79SHH2140319,83,32,28,4,1
SBI78PMS6369761,21,25,20,5,1
SBI70YQW9189175,95,33,26,7,1
SBI56BMM8941149,72,24,13,11,1
SBI03OFE9962966,90,28,24,4,1
SBI21DXT2739522,20,39,36,3,1
SBI79PQK4396137,91,26,15,11,1
SBI66VHL7471275,99,23,14,9,1
SBI16GLZ8851928,89,18,15,3,1
SBI64UUU9025966,68,26,15,11,1
SBI11RLY6876853,85,20,19,1,1
SBI52HRV4419767,64,22,15,7,1
SBI97EQT4980699,89,30,29,1,1
SBI10ESC3162475,93,24,21,3,1
SBI32LTH0494349,19,25,21,4,1
SBI25ZSB7481968,92,21,14,7,1
SBI44ALN6547703,71,29,15,14,1
SBI36KLQ3611649,72,20,15,5,1
SBI96XDQ7519892,96,22,19,3,1
SBI63EHP0612178,20,31,23,8,1
SBI86VTT5000131,94,28,17,11,1
SBI75JWP2651312,87,23,12,11,1
SBI46RKS2429197,90,24,13,11,1
SBI50REC3181691,61,33,24,9,1
SBI68YXH4511365,94,24,19,5,1
SBI85QRF7816418,60,29,28,1,1
SBI66AJP6367875,21,19,10,9,1
SBI81HQD7728467,21,29,17,12,1
SBI28QHS8771170,61,19,12,7,1
SBI73YBZ5959946,18,25,24,1,1
SBI60TML3368750,78,29,21,8,1
SBI27OEF9725160,20,28,22,6,1
SBI74HCB2056306,67,25,17,8,1
SBI63WAY3256570,21,24,18,6,1
SBI51HUT0663640,60,26,24,2,1
SBI65GYK7006853,61,22,12,10,1
SBI84TXQ4683811,81,18,16,2,1
SBI42VBZ6731658,65,21,15,6,1
SBI42NHK3011284,79,29,25,4,1
SBI10KJS0515053,98,26,14,12,1
SBI57KOT1260758,85,16,15,1,1
SBI38SIV0850470,81,31,21,10,1
SBI68WUF7954094,21,33,18,15,1
SBI95FMC5150993,64,25,13,12,1
SBI56DST8538037,75,23,22,1,1
SBI80VAZ9170214,95,21,11,10,1
SBI11HVP7387026,97,24,17,7,1
SBI19VAI6350162,21,18,13,5,1
SBI56TLQ3914213,63,25,21,4,1
SBI32URR4963378,72,26,23,3,1
SBI38VFL2032408,79,19,17,2,1
SBI88KLD1104310,96,26,17,9,1
SBI42TBC9579775,73,22,12,10,1
SBI86QFZ6759234,25,25,24,1,1
SBI55RNO2336929,80,32,18,14,1
SBI21GGT1696578,19,29,21,8,1
SBI19IRX4962930,25,18,12,6,1
SBI52QUK4820207,80,21,19,2,1
SBI84WKJ8278487,85,26,18,8,1
SBI91LOZ1138302,86,26,21,5,1
SBI57NHI5049551,24,28,27,1,1
SBI31DZQ7653442,64,22,19,3,1
SBI41CUC1535163,71,24,23,1,1
SBI25QFO0958480,83,32,29,3,1
SBI13KRD5446887,98,29,20,9,1
SBI40SLA8700078,19,31,22,9,1
SBI14CHO3270437,22,22,20,2,1
SBI25PNL1138672,78,23,13,10,1
SBI17TJK5540276,65,23,21,2,1
SBI03QNN0489480,73,28,18,10,1
SBI65WNH1167352,76,19,16,3,1
SBI82WJX6632004,80,21,19,2,1
SBI44ZRL6181273,97,24,14,10,1
SBI49BMR1038696,60,32,29,3,1
SBI50JXI0822357,92,15,10,5,1
SBI58DED6423641,74,19,13,6,1
SBI27VFM6451109,96,26,19,7,1
SBI80LIO1947063,70,24,20,4,1
SBI79OBN5054379,18,32,28,4,1
SBI75PMZ5707320,84,28,20,8,1
SBI03RYX2338026,96,30,26,4,1
SBI26CAU9620723,90,15,9,6,1
SBI59WHV9477843,80,19,10,9,1
SBI33BMG2267359,23,30,24,6,1
SBI72PKS2293395,76,32,17,15,1
SBI80DRF4218821,62,14,10,4,1
SBI13IBJ9428881,63,26,24,2,1
SBI40HWV3514758,74,29,21,8,1
SBI85GCX2092704,90,21,17,4,1
SBI09ODP4591058,94,26,21,5,1
SBI05PID0834736,22,23,19,4,1
SBI92OWW4695914,65,27,16,11,1
SBI51MVM6339907,24,22,17,5,1
SBI52FDN9217679,75,27,23,4,1
SBI23AYB4174029,77,28,15,13,1
SBI15UHA5153690,62,22,16,6,1
SBI18LFG2468647,62,22,16,6,1
SBI00INU0379753,88,21,14,7,1
SBI80PEK8780772,82,18,12,6,1
SBI28BSC6508100,84,23,19,4,1
SBI29NBU5059149,62,18,14,4,1
SBI52YBH1131804,84,23,15,8,1
SBI09CJJ0101388,80,31,17,14,1
SBI66ICE0001453,96,26,24,2,1
SBI41UBM1744681,22,21,18,3,1
SBI78EWS1684703,84,29,15,14,1
SBI58YGF3757634,68,19,17,2,1
SBI86XKB6571722,90,19,11,8,1
SBI79RYF3277581,72,23,18,5,1
SBI28UHM4305847,67,17,15,2,1
SBI69CQP7345720,62,30,23,7,1
SBI78XLQ6116677,77,22,16,6,1
SBI36VGH7133357,89,23,16,7,1
SBI28FVR7361224,92,22,15,7,1
SBI40QOE9933594,99,26,18,8,1
SBI07QPE3522741,99,22,14,8,1
SBI71DMH4403129,92,26,14,12,1
SBI71EXQ5372576,94,22,21,1,1
SBI84AYW4581452,90,31,17,14,1
SBI05PMW7531651,76,22,14,8,1
SBI17MJA0027741,22,29,28,1,1
SBI55SSG1653274,25,21,15,6,1
SBI12AKK0130493,76,24,18,6,1
SBI58YRP1394866,78,23,22,1,1
SBI04GKS8143462,78,33,31,2,1
SBI83UCF6217075,18,22,14,8,1
SBI81XLX6571578,67,34,27,7,1
SBI82AYW6012532,88,18,12,6,1
SBI42FPP6343245,98,16,15,1,1
SBI74ASU9968760,82,22,19,3,1
SBI03HQT6591819,82,26,25,1,1
SBI89GDD6154957,90,28,18,10,1
SBI96ZTE0923021,83,25,16,9,1
SBI29YOH8463871,88,27,14,13,1
SBI05VWI2585833,60,21,12,9,1
SBI23VSB1889542,72,35,21,14,1
SBI41AZY1474724,91,35,26,9,1
SBI43PRP0514063,69,14,12,2,1
SBI01IPZ6635423,91,31,28,3,1
SBI82ASP8271189,89,33,26,7,1
SBI86UFW9291143,60,16,13,3,1
SBI14XUS1021784,63,20,17,3,1
SBI82UAK6635396,80,31,26,5,1
SBI20NXD9968261,79,17,16,1,1
SBI11HEO8786609,80,24,15,9,1
SBI18GIZ6426487,68,23,19,4,1
SBI38DRD7950861,89,22,14,8,1
SBI29KFY6584927,70,31,24,7,1
SBI69OWH4081908,95,15,9,6,1
SBI08WXD9381011,23,16,10,6,1
SBI81DTK5742382,23,16,11,5,1
SBI89PMJ4096650,96,12,11,1,1
SBI06UJJ0687216,60,22,15,7,1
SBI19ORL5497718,61,23,12,11,1
SBI01WGN0359028,70,29,16,13,1
SBI67NWF3322332,84,30,20,10,1
SBI75EWF4147340,97,28,21,7,1
SBI23OHC9299368,77,22,19,3,1
SBI86MYP1343983,90,26,21,5,1
SBI95KWU1945985,25,22,19,3,1
SBI06ZIJ6513423,72,23,14,9,1
SBI01VSV4733781,93,16,12,4,1
SBI69FZK4499324,84,23,19,4,1
SBI34XDO1357723,81,24,13,11,1
SBI79MJW6170622,99,27,22,5,1
SBI08REL0885207,64,23,15,8,1
SBI55PGQ3154280,74,31,23,8,1
SBI55PPL6469064,93,27,23,4,1
SBI65BCB8194702,94,24,17,7,1
SBI31PKE4145206,66,23,18,5,1
SBI89JQW9115441,94,24,22,2,1
SBI72WLP8883938,83,31,27,4,1
SBI49MRZ9246116,94,24,21,3,1
SBI87ZEW3187182,77,30,29,1,1
SBI67OCP5653268,25,20,11,9,1
SBI44DTW8125308,81,19,17,2,1
SBI34TYE7354749,76,29,26,3,1
SBI95HIN5390162,66,21,19,2,1
SBI96QSS8655313,96,21,11,10,1
SBI58JVW9989766,85,18,10,8,1
SBI12SZP5091431,76,29,21,8,1
SBI76QBH0493489,69,24,17,7,1
SBI74JDT7003855,73,27,26,1,1
SBI37NVQ8186645,20,19,13,6,1
SBI82YQN5207453,60,18,11,7,1
SBI76PHX3671507,87,25,21,4,1
SBI41ULZ7203727,77,25,13,12,1
SBI32NIS0608121,78,19,12,7,1
SBI43CMA8863653,66,18,14,4,1
SBI85JCE0822334,85,31,19,12,1
SBI13EMP3902854,80,22,17,5,1
SBI09PZZ5141999,88,24,23,1,1
SBI31EAO8963435,18,25,14,11,1
SBI05XRI7691573,77,28,17,11,1
SBI71MMJ9446291,93,17,12,5,1
SBI13EVS3532756,95,18,13,5,1
SBI97HBK6685443,76,24,20,4,1
SBI71PMH9480427,90,22,15,7,1
SBI97ELW6402952,88,24,17,7,1
SBI38XWZ6989504,77,15,13,2,1
SBI83REO1537970,78,31,19,12,1
SBI58JUA8708518,70,21,20,1,1
SBI38UOE2925567,90,20,17,3,1
SBI10RBO2154565,85,23,20,3,1
SBI11HIR3282273,99,11,10,1,1
SBI29MMC0729619,73,38,28,10,1
SBI99HPU5216245,70,25,20,5,1
SBI42LMQ0760819,78,20,14,6,1
SBI62LDT6515608,19,25,16,9,1
SBI88GZD2291664,86,18,10,8,1
SBI83EET8672891,95,11,9,2,1
SBI56ENI2789031,66,28,25,3,1
SBI89MUJ1665171,79,25,13,12,1
SBI44XGP1455210,25,27,25,2,1
SBI55NHV7414658,87,29,25,4,1
SBI92LRU1411499,75,25,19,6,1
SBI20YIQ3538771,25,18,12,6,1
SBI85IUC9630901,98,35,28,7,1
SBI33IFQ1337796,19,24,21,3,1
SBI43XAI6842489,66,24,22,2,1
SBI00ZQU4434041,22,24,16,8,1
SBI87EDD9709916,18,14,13,1,1
SBI26PCH2508090,25,32,18,14,1
SBI67NFD9985574,91,19,16,3,1
SBI80KKP4664588,21,16,9,7,1
SBI11HOL1616675,20,30,16,14,1
SBI42MWM3146034,60,22,19,3,1
SBI88AGT4500461,19,33,28,5,1
SBI30PII0887369,85,19,10,9,1
SBI89ICI5485541,18,35,23,12,1
SBI46VSU7700379,94,21,17,4,1
SBI75ZCS9400766,95,20,17,3,1
SBI91MCN1600830,23,33,18,15,1
SBI70AWV7659737,90,23,20,3,1
SBI13VQT6294030,64,21,18,3,1
SBI31EMD7995266,22,24,19,5,1
SBI19WNX7503926,82,27,21,6,1
SBI49ABZ8119706,74,32,27,5,1
SBI00IAZ0484529,75,25,20,5,1
SBI06HNP8320247,23,25,15,10,1
SBI86MIW9271519,92,25,21,4,1
SBI97GPH5079045,82,25,19,6,1
SBI02VLL7673636,25,21,14,7,1
SBI80TAL4809569,81,18,12,6,1
SBI16LWT0742399,18,26,23,3,1
SBI13WRG5135279,80,24,16,8,1
SBI07NME1728282,61,27,23,4,1
SBI18ZYK1863552,66,26,21,5,1
SBI79VPE6013993,25,26,23,3,1
SBI64WSR8804987,75,20,17,3,1
SBI56OMK4369460,22,29,19,10,1
SBI89HZH8539315,75,42,39,3,1
SBI06HQV5165781,22,24,14,10,1
SBI33DYI0628698,94,23,12,11,1
SBI72RWR0724700,97,25,24,1,1
SBI19WUY7510666,21,28,21,7,1
SBI98KGN8967234,76,20,18,2,1
SBI66PJN3741832,71,27,15,12,1
SBI64LTQ4941077,92,30,25,5,1
SBI45IDH8465631,74,24,21,3,1
SBI48DJP0557564,71,24,21,3,1
SBI00EBJ0845974,67,29,21,8,1
SBI89ALJ7272887,72,26,20,6,1
SBI00VMP0200383,22,20,13,7,1
SBI30DBX9642031,24,21,18,3,1
SBI88KWW9292044,88,27,21,6,1
SBI43NFO8092463,70,18,12,6,1
SBI40SAM6314436,93,28,16,12,1
SBI23SLW8634292,69,30,17,13,1
SBI91SPV5618335,77,33,17,16,1
SBI41JCD7573630,74,17,9,8,1
SBI72VPP5320074,24,23,14,9,1
SBI32FWC4851073,73,17,13,4,1
SBI51FTK8547980,25,24,13,11,1
SBI09IMQ9276156,96,29,19,10,1
SBI80AJD7623810,60,15,10,5,1
SBI84JAS7095237,94,22,15,7,1
SBI25FVH5890279,74,33,30,3,1
SBI65XBY3197114,81,21,17,4,1
SBI54BOQ0106876,74,37,22,15,1
SBI84FUF1605989,71,25,15,10,1
SBI97KQP1554940,99,25,16,9,1
SBI70QLT1837438,61,26,21,5,1
SBI61MHJ6327121,23,28,20,8,1
SBI30BVP2962447,81,24,20,4,1
SBI26IZX4904880,87,33,18,15,1
SBI64XNS7125318,86,26,21,5,1
SBI76BNX9269070,79,30,28,2,1
SBI83DAI3265144,97,18,17,1,1
SBI77XFY4007330,67,35,27,8,1
SBI16MTS0154550,19,38,26,12,1
SBI67ULY0756078,94,18,10,8,1
SBI86XAC5748525,71,22,13,9,1
SBI28VIA8906350,24,23,21,2,1
SBI05MZA1141998,92,14,13,1,1
SBI67MBN2728352,93,24,14,10,1
SBI44QCP2663497,69,23,13,10,1
SBI58KBP5733039,25,24,20,4,1
SBI53WVC8097384,67,27,16,11,1
SBI46CAM9115148,94,23,16,7,1
SBI78SOB9600582,69,24,20,4,1
SBI00HBS8978222,88,33,18,15,1
SBI91IMI5038780,80,32,23,9,1
SBI82HGI3269729,75,29,21,8,1
SBI33MRY3361969,78,22,14,8,1
SBI08CMB2650767,20,27,24,3,1
SBI53UCI4422122,70,19,14,5,1
SBI83XGU2502723,84,28,21,7,1
SBI30JOL2535775,66,30,17,13,1
SBI78ODE0213983,88,23,22,1,1
SBI82OSC8282021,88,25,15,10,1
SBI88QUY6394503,85,38,36,2,1
SBI05FRU3880699,65,28,21,7,1
SBI57VFJ1963314,86,16,10,6,1
SBI18SXZ7356960,82,25,15,10,1
SBI15UGD1725878,23,23,18,5,1
SBI51KYA3415157,85,37,26,11,1
SBI09VOJ6452830,18,24,23,1,1
SBI32ZQL9928369,65,23,15,8,1
SBI11VUV2559593,25,26,22,4,1
SBI72GFX9059203,85,27,14,13,1
SBI55KAQ3761361,86,37,26,11,1
SBI90MHC2139651,65,23,16,7,1
SBI14NRK5061076,18,18,13,5,1
SBI75AEL1163627,21,23,16,7,1
SBI60HNI4629665,97,26,17,9,1
SBI30KMX6927258,62,27,22,5,1
SBI48MQQ6758055,91,39,35,4,1
SBI26IXK1324805,74,33,22,11,1
SBI95WAI6156076,89,27,17,10,1
SBI57RLF1226469,23,23,22,1,1
SBI64TBJ1792891,69,29,23,6,1
SBI46VZG0117767,67,31,17,14,1
SBI76TVM2622948,73,32,27,5,1
SBI11GFL9310730,78,29,15,14,1
SBI32DVG1951227,85,26,20,6,1
SBI51WKX8443697,96,36,25,11,1
SBI63SYB8271833,88,22,13,9,1
SBI57MCZ0655925,79,27,24,3,1
SBI53JMI7196315,23,24,19,5,1
SBI60HAC3781242,63,26,14,12,1
SBI79SJQ9337923,60,23,21,2,1
SBI83ZEQ6644596,64,26,17,9,1
SBI07USR1248109,95,27,22,5,1
SBI40MTP4225546,89,21,11,10,1
SBI77DDE6889043,82,25,20,5,1
SBI27QLJ6408136,61,20,19,1,1
SBI34RTR5328650,66,31,24,7,1
SBI32BBT4062592,88,20,11,9,1
SBI42OXR9697920,22,25,18,7,1
SBI68AQD4761021,18,19,14,5,1
SBI50OBQ7155577,88,18,13,5,1
SBI88IGA3861918,68,22,20,2,1
SBI30FYE8051242,23,24,14,10,1
SBI09NRL4969257,80,20,16,4,1
SBI13BGA1769941,61,28,24,4,1
SBI67JMR5976936,97,31,24,7,1
SBI97KXT1135743,80,25,21,4,1
SBI25JKK9415047,68,24,20,4,1
SBI87NZQ0663999,67,21,20,1,1
SBI05UPY5872587,25,15,12,3,1
SBI61MHN3331865,72,35,31,4,1
SBI14IKI1353075,81,26,14,12,1
SBI08XCK2052584,66,31,29,2,1
SBI69YDT1586936,84,22,18,4,1
SBI70PLA7486818,69,14,10,4,1
SBI23WBL3085189,22,20,18,2,1
SBI92UDZ8763380,96,32,19,13,1
SBI60SAH5009525,66,27,26,1,1
SBI37YTX1696912,75,37,35,2,1
SBI60HTP1537367,72,21,13,8,1
SBI32NOX5169141,99,31,25,6,1
SBI42XXD3878633,73,21,18,3,1
SBI13VFC1419674,61,28,21,7,1
SBI89ISG2723794,64,24,23,1,1
SBI67WGC2569955,67,15,8,7,1
SBI46VFE3540477,75,29,28,1,1
SBI78NRD3944038,89,28,24,4,1
SBI87HJY4422534,19,19,17,2,1
SBI94SGM2663207,79,32,27,5,1
SBI48RUI6898972,62,28,23,5,1
SBI58LWP2950810,75,19,11,8,1
SBI05WZJ9022583,24,15,8,7,1
SBI02IDT8580242,87,21,20,1,1
SBI79YQA6411092,75,27,16,11,1
SBI15DML8245215,86,23,20,3,1
SBI66VFY1301514,97,22,20,2,1
SBI25EJP6464546,60,24,21,3,1
SBI76XLN7882992,78,26,17,9,1
SBI51MYA3904922,84,19,15,4,1
SBI34ZQB6570727,74,31,17,14,1
SBI45NPW4629776,96,23,18,5,1
SBI85FPY5198603,97,24,20,4,1
SBI87HPO5434838,18,23,22,1,1
SBI08LZW7054283,64,17,10,7,1
SBI00FFK1984145,24,24,14,10,1
SBI53JIQ1148813,92,28,25,3,1
SBI58LVW2704453,72,21,18,3,1
SBI48PXQ4517416,18,17,15,2,1
SBI34YXF4259690,79,30,22,8,1
SBI87AUL8212974,88,22,20,2,1
SBI81JCS1660603,63,31,22,9,1
SBI52ZST9466208,80,28,15,13,1
SBI37TGL4167335,76,26,21,5,1
SBI76NEP3597327,60,43,23,20,1
SBI59ITA5534571,76,28,17,11,1
SBI85FUW3046362,25,26,24,2,1
SBI64DMZ6667299,81,26,21,5,1
SBI77WJN2035453,62,35,18,17,1
SBI65QRM7374220,98,17,9,8,1
SBI00ETJ3454098,76,25,18,7,1
SBI16XAM1560582,64,26,16,10,1
SBI05QCL0068420,62,17,13,4,1
SBI60WDI2836145,98,15,11,4,1
SBI27PZI7866774,84,23,12,11,1
SBI71EZV3087869,73,26,14,12,1
SBI96RIQ9799408,25,22,15,7,1
SBI00EUB0722580,79,32,23,9,1
SBI94HIG7059072,88,18,11,7,1
SBI22IIA7088453,81,24,19,5,1
SBI96IPH0153476,88,18,10,8,1
SBI14PAB5922292,61,24,21,3,1
SBI17AHM8562892,21,21,17,4,1
SBI21QSB7563613,72,20,11,9,1
SBI95PLN3607404,23,20,12,8,1
SBI84GNZ1933215,82,22,18,4,1
SBI67BIM9032464,92,21,12,9,1
SBI97QMY2672814,69,21,18,3,1
SBI46HDE3442201,18,25,17,8,1
SBI87VRL8344090,77,22,13,9,1
SBI93PCT8505003,65,32,22,10,1
SBI38CXH0133519,71,25,24,1,1
SBI76RAO6576551,77,20,12,8,1
SBI75JTA6850222,63,16,14,2,1
SBI31RWM0593892,69,28,20,8,1
SBI62SLW2809842,98,18,11,7,1
SBI19TAG8154894,73,24,17,7,1
SBI36ADD0994606,62,28,18,10,1
SBI44NTV6613230,69,26,18,8,1
SBI42KVK2654911,74,22,20,2,1
SBI96MUB7816496,98,21,16,5,1
SBI75OER9433703,25,27,24,3,1
SBI35IPG4759777,67,20,14,6,1
SBI06DOR6864926,24,26,15,11,1
SBI64KFU2548976,73,19,17,2,1
SBI42OXI9944362,92,19,18,1,1
SBI74ABQ7378771,93,18,10,8,1
SBI73JTT8418351,71,27,14,13,1
SBI28ZVG9360731,19,24,13,11,1
SBI00ISI7949704,69,28,26,2,1
SBI44UJJ8895353,62,21,14,7,1
SBI17TWT5621586,93,17,14,3,1
SBI28KST9421334,73,26,17,9,1
SBI25NOL3319136,75,21,13,8,1
SBI80EHX1962627,67,28,26,2,1
SBI90KZZ0768938,90,18,17,1,1
SBI81OKS1407539,20,14,10,4,1
SBI45EMG7375974,81,38,33,5,1
SBI59JDR3890747,71,18,14,4,1
SBI20TLA2860459,87,19,13,6,1
SBI60JVR1208332,71,23,13,10,1
SBI36TCW2741227,76,31,28,3,1
SBI24YLM5007085,24,26,21,5,1
SBI79UHC4703869,89,28,20,8,1
SBI64VRA4538944,81,29,25,4,1
SBI39LPQ0049401,65,28,21,7,1
SBI85AME6567535,86,23,13,10,1
SBI97QLB5869638,23,20,19,1,1
SBI78EZA3109027,22,29,24,5,1
SBI33KWI7044640,75,33,22,11,1
SBI38JGW3184320,85,26,18,8,1
SBI06RXA9487321,98,29,24,5,1
SBI28UIH5668779,63,16,14,2,1
SBI19GEZ0253641,97,27,20,7,1
SBI54QJY8384359,99,17,10,7,1
SBI85SYU2204352,87,23,20,3,1
SBI35WGW5526714,25,32,25,7,1
SBI91WVC6547119,95,25,14,11,1
SBI75TXX6891143,22,36,24,12,1
SBI09IGL2528936,71,20,13,7,1
SBI00NTN0505151,20,31,26,5,1
SBI53ZTE9535371,25,25,15,10,1
SBI01ZWK5567743,78,26,23,3,1
SBI15UKU4432158,25,24,19,5,1
SBI76GGJ8958300,75,19,14,5,1
SBI43FFI7701278,98,19,13,6,1
SBI76GII5186546,77,16,9,7,1
SBI31BVL7183718,69,36,19,17,1
SBI26ZDL2204293,75,32,23,9,1
SBI78KVN3891370,77,31,29,2,1
SBI92UUY1737783,79,26,17,9,1
SBI18GPF6446929,84,22,12,10,1
SBI39VCL9449981,21,26,14,12,1
SBI98OPA4013924,62,27,24,3,1
SBI18LWS0046764,66,25,19,6,1
SBI63DGX4048034,75,24,17,7,1
SBI63XLN6590488,89,32,27,5,1
SBI08OTJ4210702,73,18,14,4,1
SBI90EES7044040,73,35,31,4,1
SBI82HBB9685765,61,19,10,9,1
SBI31ZKI8813007,89,18,16,2,1
SBI87SNY2173849,85,31,20,11,1
SBI50KIE3396446,92,20,11,9,1
SBI28NPA4700230,98,29,26,3,1
SBI39RQZ2853662,18,26,24,2,1
SBI41WYB4634288,95,20,16,4,1
SBI61PBE6787203,91,29,18,11,1
SBI25OBI3413339,95,30,17,13,1
SBI40WQN5280559,65,22,16,6,1
SBI49HTJ4185229,25,25,21,4,1
SBI26KSB4126490,69,27,21,6,1
SBI45HMV8530301,25,19,10,9,1
SBI02VBY2732827,64,25,22,3,1
SBI53CYL3092385,68,18,10,8,1
SBI96REL5979963,97,22,20,2,1
SBI68WYH2949768,23,30,17,13,1
SBI03VAE5446842,99,25,18,7,1
SBI79JOY3467885,21,18,15,3,1
SBI17ULK2299982,67,21,16,5,1
SBI15TUN4681787,62,28,24,4,1
SBI69JNJ7538638,62,29,18,11,1
SBI58LQL3958511,85,22,16,6,1
SBI11LUP9757836,86,17,15,2,1
SBI49DLQ7350207,79,22,14,8,1
SBI90AVX9179581,18,28,18,10,1
SBI31JOC2816272,84,27,17,10,1
SBI98IRR9110680,90,26,23,3,1
SBI21EAW6398973,71,23,22,1,1
SBI23ILH0251598,20,24,20,4,1
SBI71MVZ4985344,98,23,17,6,1
SBI87YUD2052817,75,23,22,1,1
SBI74AOS5110950,68,19,14,5,1
SBI90HGE3192967,65,28,27,1,1
SBI21GQA1116066,76,29,17,12,1
SBI92VMJ3971365,61,35,33,2,1
SBI50XWX8363869,71,27,21,6,1
SBI93QGK5602056,85,24,22,2,1
SBI06YKV9212139,99,25,13,12,1
SBI02III9224969,74,15,9,6,1
SBI77JIR7424096,20,23,12,11,1
SBI19ZHZ7513220,24,36,35,1,1
SBI05UYE6290373,81,24,14,10,1
SBI50SMH5351743,77,22,18,4,1
SBI47EZE7394215,22,31,30,1,1
SBI54WUJ1687086,68,22,14,8,1
SBI33WCZ2228595,65,19,11,8,1
SBI60FUX1853699,99,23,17,6,1
SBI99SWN4238088,92,25,18,7,1
SBI53ZTO3820442,97,17,11,6,1
SBI26INN7085094,79,23,19,4,1
SBI91PNJ3834651,87,27,16,11,1
SBI41MEG1207331,22,23,20,3,1
SBI30FVW9424816,76,26,18,8,1
SBI26FIM4554519,79,24,14,10,1
SBI47OAN4498778,83,28,16,12,1
SBI81FZT4807037,86,35,26,9,1
SBI64FSJ8364384,77,33,17,16,1
SBI85IUX3699851,66,15,8,7,1
SBI51VCS8061857,18,26,25,1,1
SBI35EUD6847145,63,20,18,2,1
SBI20JLJ2923334,79,24,19,5,1
SBI98KLS9539189,94,18,10,8,1
SBI17ZVX2747819,83,32,29,3,1
SBI30PAK0606045,19,26,25,1,1
SBI64ZNB6194795,92,24,19,5,1
SBI87OQJ2905722,76,35,28,7,1
SBI83MKJ4865821,84,21,14,7,1
SBI79XCA2577798,70,22,15,7,1
SBI95MFN8036534,19,30,24,6,1
SBI54TJA7953873,71,19,12,7,1
SBI39NKD3700437,94,15,10,5,1
SBI57XKW7024331,86,34,19,15,1
SBI76FPB6029908,22,27,24,3,1
SBI42ACU1173430,83,24,14,10,1
SBI02USF2749993,18,26,21,5,1
SBI65QJS1209966,18,22,15,7,1
SBI68OHW6508370,21,28,20,8,1
SBI59HSH6208742,64,30,23,7,1
SBI38UYE7619858,18,29,19,10,1
SBI68NLM9181379,88,28,18,10,1
SBI76ZGA3120385,79,24,20,4,1
SBI97MBD9540172,93,21,13,8,1
SBI17SGG3756794,96,24,13,11,1
SBI89QRT1597870,68,24,14,10,1
SBI83GUU8581144,92,26,23,3,1
SBI31FIP2119099,62,21,18,3,1
SBI33MQG5412827,25,31,30,1,1
SBI23CES3193009,62,24,13,11,1
SBI64ODW1181152,95,24,20,4,1
SBI94SBK7278850,90,30,24,6,1
SBI39VIC1660857,87,27,18,9,1
SBI18PVJ4325409,22,28,27,1,1
SBI22IKR4076775,83,25,17,8,1
SBI74MUJ1117737,25,29,18,11,1
SBI36KOO8218954,94,32,26,6,1
SBI01CPI8525760,90,28,27,1,1
SBI30BEU0182664,99,27,24,3,1
SBI11XGZ5159191,88,21,13,8,1
SBI90JHU9151833,21,25,21,4,1
SBI20CBE2659727,80,21,12,9,1
SBI03NQI6109946,75,21,19,2,1
SBI91NVD7833286,61,16,11,5,1
SBI18BOI1629782,90,20,14,6,1
SBI04HRC1818157,91,30,17,13,1
SBI99JGO8451564,23,20,12,8,1
SBI08OLX7388460,75,22,21,1,1
SBI99XSG5840408,84,31,18,13,1
SBI12XPN4248275,66,24,19,5,1
SBI95TSU8808299,83,22,17,5,1
SBI54EIG1189158,97,25,15,10,1
SBI95EMW2426691,75,23,15,8,1
SBI03SLP7221671,71,23,20,3,1
SBI28XQP2448895,95,22,17,5,1
SBI22AQD7161040,68,30,23,7,1
SBI50JBJ7854983,24,24,13,11,1
SBI78VMW6897571,98,35,27,8,1
SBI68WAW4329882,87,28,17,11,1
SBI07FLA9981838,93,42,22,20,1
SBI39JIX5847078,96,17,14,3,1
SBI99RTM6204793,88,24,22,2,1
SBI05KKN3321020,93,23,17,6,1
SBI04MJB7311479,85,39,34,5,1
SBI63OCS2416595,77,21,14,7,1
SBI52CSL5301712,87,35,33,2,1
SBI40XGN7199065,80,19,12,7,1
SBI88HXZ1397338,22,22,13,9,1
SBI59BKO7844634,21,25,13,12,1
SBI40ASX7777955,25,27,21,6,1
SBI81UYW0208235,95,23,13,10,1
SBI51YED8291416,83,32,25,7,1
SBI25BIL4043747,95,19,15,4,1
SBI55FAT5498375,67,22,19,3,1
SBI88GDJ2606897,83,22,20,2,1
SBI24MEJ6817297,85,17,9,8,1
SBI84GGB3016781,62,27,15,12,1
SBI03QFZ6423177,68,27,23,4,1
SBI12FBY7145582,73,31,26,5,1
SBI60YFE7705705,84,30,20,10,1
SBI63ODQ0112878,75,17,11,6,1
SBI73LOA2817709,97,20,16,4,1
SBI70NUS4784591,84,28,16,12,1
SBI71PLI8601309,74,28,15,13,1
SBI53QEC5168709,19,19,10,9,1
SBI23KIF3803551,72,20,14,6,1
SBI38WGB0494171,70,32,27,5,1
SBI62NST4111207,76,15,11,4,1
SBI93SQW9751488,66,27,26,1,1
SBI42TIO4108788,89,24,14,10,1
SBI26ZIX0750072,74,25,22,3,1
SBI93FTY7557477,81,31,20,11,1
SBI72CJE2896958,23,32,26,6,1
SBI89VVV1472027,74,22,17,5,1
SBI05AIZ9226489,67,22,15,7,1
SBI51RQC4842806,65,21,15,6,1
SBI72IMV1153285,83,31,17,14,1
SBI03VWS7169180,86,21,20,1,1
SBI98WNG0528743,66,31,20,11,1
SBI06EXN7382334,92,17,9,8,1
SBI71HFS4770653,98,29,27,2,1
SBI52LVX1732475,23,28,27,1,1
SBI29TZB6978008,25,18,17,1,1
SBI31RRB1032186,68,33,17,16,1
SBI76KIF0089462,21,26,16,10,1
SBI04RZI1099723,64,29,26,3,1
SBI26MJC6209437,23,22,15,7,1
SBI68UUF3229164,99,30,16,14,1
SBI54ESH0075087,60,23,20,3,1
SBI22QFO6582142,60,25,19,6,1
SBI47BEI4369044,83,33,32,1,1
SBI83ZON7149070,18,32,26,6,1
SBI93JQR3738565,70,32,23,9,1
SBI78IVG5351187,78,27,16,11,1
SBI10ORA4371611,74,24,14,10,1
SBI03MDU9038390,24,34,32,2,1
SBI38VPN6244931,96,20,11,9,1
SBI32OQX5300641,89,23,16,7,1
SBI12SXD8374777,71,22,15,7,1
SBI57XJG7671182,18,24,21,3,1
SBI45NWE3697411,72,29,15,14,1
SBI66EZG8634599,94,23,17,6,1
SBI74DKX6990777,23,28,16,12,1
SBI19UKH7256905,71,27,25,2,1
SBI89RSU6645450,93,19,12,7,1
SBI46DMW8750286,72,32,17,15,1
SBI42EJB7568859,74,25,23,2,1
SBI55UUI0661227,18,30,21,9,1
SBI44HUQ9306414,22,22,12,10,1
SBI06RZW9343227,80,28,21,7,1
SBI80MRN9041072,79,17,13,4,1
SBI24GOV9267930,68,12,7,5,1
SBI84GNM8859445,82,24,20,4,1
SBI77WSU7730940,98,26,24,2,1
SBI14JHT8231198,61,24,16,8,1
SBI49AOO8857414,72,19,13,6,1
SBI11KMB6688699,79,28,23,5,1
SBI86SMR7079214,98,27,16,11,1
SBI80ZGJ5226617,65,12,11,1,1
SBI43IXU8928692,65,18,16,2,1
SBI44ALC9828796,87,30,22,8,1
SBI46ZBR1933305,97,22,13,9,1
SBI88AVJ4898770,77,15,12,3,1
SBI84KWB3881042,79,18,12,6,1
SBI96OQB0381608,66,24,17,7,1
SBI60AUM3305883,60,23,16,7,1
SBI79RTB5152986,25,29,23,6,1
SBI38DRL8071753,71,17,12,5,1
SBI93FDX6624624,23,24,21,3,1
SBI09ELU9307722,98,27,15,12,1
SBI10FBQ3371956,71,27,20,7,1
SBI81IBY7768797,88,22,21,1,1
SBI48DMJ4539815,61,27,18,9,1
SBI78AZZ6331944,23,26,24,2,1
SBI91RPO0242533,18,29,22,7,1
SBI82IHS8136632,81,34,27,7,1
SBI57MCV2957948,98,20,15,5,1
SBI49BOM5374989,96,17,16,1,1
SBI78STL3221287,18,25,16,9,1
SBI59HNA8878937,77,24,16,8,1
SBI83BHZ3894342,60,17,11,6,1
SBI42CLT1337228,61,29,26,3,1
SBI90QDA1386813,99,16,9,7,1
SBI53BGY7160992,25,25,15,10,1
SBI90GBK3803578,79,34,29,5,1
SBI11TIA4113204,93,24,21,3,1
SBI71ECC7561590,91,13,8,5,1
SBI45NNX9468410,95,20,15,5,1
SBI48ZGG0646324,64,28,24,4,1
SBI61ESS0442297,24,20,11,9,1
SBI20JNA7758657,69,24,20,4,1
SBI76WZW2557655,98,31,19,12,1
SBI82NYN8319035,75,21,15,6,1
SBI52SFV8302128,84,23,13,10,1
SBI58OLB8629476,19,31,27,4,1
SBI73HZM1632628,21,15,8,7,1
SBI72ZOW2137419,66,23,17,6,1
SBI41FFR3060268,24,31,27,4,1
SBI31DWF1659035,88,19,11,8,1
SBI46MER6967690,91,28,17,11,1
SBI26PWM9632351,72,27,21,6,1
SBI83DVC7000719,69,30,25,5,1
SBI58HZV9045127,93,36,35,1,1
SBI70DBI6425520,88,16,9,7,1
SBI35GAS2876968,70,17,15,2,1
SBI74UNR5067520,80,31,20,11,1
SBI98SJE4794638,91,26,19,7,1
SBI78PYA3083307,88,26,22,4,1
SBI62BLL2142611,68,30,24,6,1
SBI41UBV4665986,24,26,17,9,1
SBI03YUC9938314,74,24,21,3,1
SBI31VAG2811325,80,24,13,11,1
SBI45EGC4255579,63,28,18,10,1
SBI87NBH4814841,69,15,10,5,1
SBI01CPL5263712,93,33,19,14,1
SBI08NZY7855549,76,34,24,10,1
SBI55KIM0318987,97,23,21,2,1
SBI31BPB8094090,65,24,16,8,1
SBI87SQK5627500,64,27,22,5,1
SBI59EYK2845793,99,23,21,2,1
SBI98FIE0468791,60,27,16,11,1
SBI52BAQ3898236,20,35,30,5,1
SBI30CIW7629010,98,24,20,4,1
SBI48NZA1112616,67,22,19,3,1
SBI11XXJ8124792,87,29,16,13,1
SBI22UME4715163,23,30,18,12,1
SBI90GGS4629558,60,20,17,3,1
SBI18AEP5413750,84,30,26,4,1
SBI44NTG3897436,85,28,18,10,1
SBI63ZYK7457995,82,22,19,3,1
SBI22ZKE5537367,20,22,14,8,1
SBI61XKR1548194,66,25,21,4,1
SBI98DRK8394729,75,20,14,6,1
SBI67SKB8063054,88,26,17,9,1
SBI50WFU0542429,92,21,14,7,1
SBI01MXG1122755,22,20,19,1,1
SBI70JNC5004995,96,17,9,8,1
SBI42JGM3157238,79,19,10,9,1
SBI42AUD5865028,23,22,17,5,1
SBI55DOQ5739330,69,31,30,1,1
SBI88YUJ5161833,72,15,12,3,1
SBI60JSE0118322,91,21,13,8,1
SBI36ELT1127791,99,21,11,10,1
SBI97ZHF8438265,68,19,18,1,1
SBI42MSG9362006,22,21,16,5,1
SBI75OJB1381724,18,21,13,8,1
SBI16HVS2235627,90,32,29,3,1
SBI67OBU4083344,84,26,24,2,1
SBI16UYJ7114082,96,23,15,8,1
SBI22ZTV5407984,74,27,21,6,1
SBI53SXE3452850,67,23,20,3,1
SBI51UTO1904636,24,32,31,1,1
SBI93EPV8401841,64,16,13,3,1
SBI60JMX1313920,92,26,19,7,1
SBI76ERC9035483,82,34,27,7,1
SBI75UWW3775701,72,29,22,7,1
SBI82EMJ4636327,71,17,14,3,1
SBI86VSQ9700012,99,23,17,6,1
SBI87JVC5335388,65,29,25,4,1
SBI91IOS6167261,79,21,20,1,1
SBI03PEE5321814,79,25,13,12,1
SBI74OLX7549528,85,22,15,7,1
SBI13KRO4457161,77,26,18,8,1
SBI62PHF0719541,77,23,18,5,1
SBI83DXO6015338,19,26,17,9,1
SBI10DAA0236967,67,16,10,6,1
SBI41ACP2441797,61,24,19,5,1
SBI35JFU2166022,69,24,15,9,1
SBI86ZHO5938071,60,30,27,3,1
SBI39XCC2018321,65,26,17,9,1
SBI30CFD7464295,64,31,16,15,1
SBI47PTP6762803,25,18,14,4,1
SBI72TWX3693768,94,28,20,8,1
SBI35BLY0561029,91,33,21,12,1
SBI39TCV0541431,82,26,16,10,1
SBI38UXZ7929238,81,26,18,8,1
SBI98MCN1199239,74,27,20,7,1
SBI33QRO6646267,95,30,22,8,1
SBI46VIK6960090,80,23,20,3,1
SBI10EIS0604360,85,32,29,3,1
SBI01AAK2860153,95,17,16,1,1
SBI03FWL8623626,82,20,19,1,1
SBI91EWF2643152,84,27,24,3,1
SBI46JBZ1117499,76,26,20,6,1
SBI20QFR1099414,96,22,15,7,1
SBI89TXY9331725,98,25,13,12,1
SBI45OKD7704026,91,17,12,5,1
SBI00XAT3206140,99,29,19,10,1
SBI32GFY9368671,89,26,17,9,1
SBI19LNX4275734,97,29,18,11,1
SBI60PGL9765036,25,18,17,1,1
SBI26QUI6317360,94,26,15,11,1
SBI33TVX5804524,82,26,15,11,1
SBI91PEW8872162,74,27,16,11,1
SBI21EUI7702889,60,18,14,4,1
SBI08NLT2614706,99,28,24,4,1
SBI82VFZ6814259,93,27,26,1,1
SBI45UBL1167970,20,25,19,6,1
SBI83FIP4960543,63,28,22,6,1
SBI02EOT0462772,87,31,21,10,1
SBI23GVW3988942,62,28,24,4,1
SBI42ZTP0119414,78,22,21,1,1
SBI13DVK2209555,84,22,16,6,1
SBI61WRI2462055,99,24,23,1,1
SBI29IXR0660271,92,23,18,5,1
SBI03AMU6569044,85,29,22,7,1
SBI14JUR4992687,61,18,16,2,1
SBI09UQC2420374,67,21,17,4,1
SBI58AXI7813521,72,22,18,4,1
SBI83GPH8158454,61,32,24,8,1
SBI16NIT9435802,88,25,22,3,1
SBI45QEU5971474,89,20,12,8,1
SBI08HBQ2501192,99,29,20,9,1
SBI47HTA4189918,74,28,21,7,1
SBI88WWW9841112,61,25,21,4,1
SBI29GUB6848398,93,20,16,4,1
SBI91UDM0753261,19,25,15,10,1
SBI71XKZ4740927,66,24,14,10,1
SBI35YSJ9359227,23,26,20,6,1
SBI13FJW5082342,96,24,14,10,1
SBI42TRQ1732291,81,22,19,3,1
SBI03UKN8185929,84,25,17,8,1
SBI03KZU4236359,93,15,8,7,1
SBI07FEE1382098,98,19,11,8,1
SBI29UHC5306682,70,27,18,9,1
SBI20NKY5807725,80,20,12,8,1
SBI26RXO3453400,21,39,36,3,1
SBI33PED3684343,98,16,9,7,1
SBI56RUR2048789,22,33,17,16,1
SBI80SOO5723265,79,21,20,1,1
SBI94FOX3307158,75,18,15,3,1
SBI18JMD2242557,89,35,26,9,1
SBI91IAO0402252,99,26,16,10,1
SBI40GKS3560024,24,29,28,1,1
SBI22ZOP4169094,97,30,27,3,1
SBI71EKR5700121,84,27,24,3,1
SBI00JAZ5618239,79,23,18,5,1
SBI94FLQ5153285,25,32,28,4,1
SBI44UYS4612219,21,18,17,1,1
SBI54WCU2360853,91,20,13,7,1
SBI86IBH7856356,87,22,16,6,1
SBI18PCD5107460,77,18,16,2,1
SBI72WIF8214365,74,24,15,9,1
SBI82FJV6893386,81,26,18,8,1
SBI05PBS3810061,20,21,16,5,1
SBI06PIM9560330,68,23,18,5,1
SBI53KVH0227077,69,30,18,12,1
SBI85KAE3644229,83,29,21,8,1
SBI54NSS4447095,62,23,18,5,1
SBI42NIZ1618517,69,18,11,7,1
SBI12AJA3385435,18,24,19,5,1
SBI93BPB3918632,99,22,15,7,1
SBI45UKB4855808,25,17,16,1,1
SBI61POL4041273,60,30,21,9,1
SBI38UNX6248139,25,28,21,7,1
SBI02RUV7425204,67,20,16,4,1
SBI14PYP4466111,80,25,23,2,1
SBI63WRN4172144,20,23,12,11,1
SBI71NGK4644195,20,38,34,4,1
SBI42QZY3787999,82,27,14,13,1
SBI38LZU8240399,74,29,27,2,1
SBI24UPZ6649646,71,31,25,6,1
SBI72PWS2878320,19,20,18,2,1
SBI82YAH1786109,94,26,24,2,1
SBI00JKD0660452,84,26,14,12,1
SBI29WXQ1648340,20,25,22,3,1
SBI05SMN9193363,21,33,22,11,1
SBI14YAA7166884,62,25,19,6,1
SBI78RFQ6156659,71,23,15,8,1
SBI02DBW9119412,93,14,11,3,1
SBI37AHU9834481,68,32,20,12,1
SBI41GYZ6262708,21,25,24,1,1
SBI04LRO3112465,21,20,16,4,1
SBI07PZT8874020,99,24,16,8,1
SBI93XPX5455735,64,22,20,2,1
SBI84KBD2154426,68,26,15,11,1
SBI13HJG4818464,97,22,16,6,1
SBI03WBO3864251,95,28,24,4,1
SBI78EHX0618775,81,27,20,7,1
SBI55YPM9313241,62,26,15,11,1
SBI01UUX9829583,76,20,18,2,1
SBI31JED8341773,83,27,17,10,1
SBI35LXU1474848,20,16,14,2,1
SBI79BAR2208199,97,25,16,9,1
SBI93NAF7337095,21,29,15,14,1
SBI64GKY5032678,98,28,15,13,1
SBI92UJJ5603687,61,22,16,6,1
SBI26FOI4289834,62,29,21,8,1
SBI78UKP7199152,98,18,10,8,1
SBI61EGP4664418,64,29,23,6,1
SBI17PWN4715966,93,20,15,5,1
SBI57RGZ3701769,65,20,11,9,1
SBI15TWE9317023,18,35,29,6,1
SBI73OVQ4103773,19,26,19,7,1
SBI62FXH0848640,88,19,14,5,1
SBI99AXA7368414,64,26,14,12,1
SBI33VZS6706676,18,27,20,7,1
SBI72UFV3960931,89,26,19,7,1
SBI31UEB6956759,19,17,16,1,1
SBI58UJW3946768,72,22,14,8,1
SBI53YIM1682307,83,31,21,10,1
SBI66YJH0522575,65,31,18,13,1
SBI50KNI0141841,25,26,17,9,1
SBI36JBI6467502,84,17,12,5,1
SBI02KZV1485309,92,31,30,1,1
SBI14OOP4098926,60,20,14,6,1
SBI85KSV1908867,87,30,28,2,1
SBI87OEH1822322,24,28,25,3,1
SBI77DYP8175418,99,25,13,12,1
SBI79PVC2164300,62,19,14,5,1
SBI64MYR0090416,70,33,25,8,1
SBI97YVJ7747399,85,25,21,4,1
SBI93IZP8322951,73,29,17,12,1
SBI17NVT4965074,69,29,22,7,1
SBI51ZPH0404648,90,25,17,8,1
SBI20XBK8366987,21,20,15,5,1
SBI23QZI2311347,69,25,16,9,1
SBI33SBM9289776,80,14,13,1,1
SBI99KJM3523476,72,31,18,13,1
SBI04UMQ7705913,89,22,18,4,1
SBI30HQV7089126,99,28,24,4,1
SBI77MKH0963492,73,26,15,11,1
SBI16YAV5814151,23,26,16,10,1
SBI63TYW3957571,69,26,16,10,1
SBI74PTN7601577,93,32,20,12,1
SBI83TXT6739234,83,34,30,4,1
SBI00THT8716694,96,30,21,9,1
SBI80EUA2833863,79,21,17,4,1
SBI59CMM1899127,89,24,18,6,1
SBI57PIW5905214,63,33,22,11,1
SBI90JIC1756786,80,29,26,3,1
SBI30YTG8724522,91,26,22,4,1
SBI16OHE6975009,19,24,17,7,1
SBI54UOS7312035,61,17,16,1,1
SBI62BKL6123396,60,24,13,11,1
SBI77CCO6744217,84,24,14,10,1
SBI67SOW6973108,92,32,28,4,1
SBI32EHL0476581,76,23,21,2,1
SBI56OXL1555076,90,27,20,7,1
SBI65IAH3058761,71,21,19,2,1
SBI00OJP5736015,99,24,16,8,1
SBI00ZPG3511068,76,24,15,9,1
SBI73HWT2804315,20,23,22,1,1
SBI84QAD8493475,85,25,22,3,1
SBI25IXS4499796,72,23,12,11,1
SBI18DTL9797627,25,32,26,6,1
SBI56SQC0304766,74,16,11,5,1
SBI03VMS4225562,88,25,22,3,1
SBI73HNB7672320,74,28,23,5,1
SBI53CGA5327713,85,28,26,2,1
SBI98PPC5387955,94,25,24,1,1
SBI45SGF8961346,71,20,17,3,1
SBI32IEV2480094,71,21,18,3,1
SBI29PAB0539946,96,18,14,4,1
SBI71AFB3881112,65,18,17,1,1
SBI33POG0382227,75,23,16,7,1
SBI84IOS8616479,91,24,16,8,1
SBI81EJG0570361,98,22,14,8,1
SBI65ZLE5088844,21,21,17,4,1
SBI91CPY0566217,66,27,15,12,1
SBI91NNF6229690,65,20,11,9,1
SBI43RDR1338969,68,18,13,5,1
SBI18DUG6718399,63,17,12,5,1
SBI05ZAT6777577,68,21,16,5,1
SBI32LXT8942187,87,34,23,11,1
SBI28IXT7889400,62,28,27,1,1
SBI82VKY9292010,18,19,17,2,1
SBI46EQD2531530,73,31,18,13,1
SBI82OOG6735706,95,26,15,11,1
SBI21AHS2106585,18,24,23,1,1
SBI64ZSZ9348296,68,25,19,6,1
SBI73YOT1960173,74,24,15,9,1
SBI89YXE4382074,72,22,21,1,1
SBI51UHS9530068,23,28,16,12,1
SBI30TCF3242226,90,26,21,5,1
SBI05KSI2496809,91,30,19,11,1
SBI56BAX2203698,23,30,16,14,1
SBI03ESA1272174,65,21,15,6,1
SBI49GGS4196950,93,21,19,2,1
SBI90YCP2888469,84,27,15,12,1
SBI22HON4808174,79,27,22,5,1
SBI10DFG5466593,70,29,27,2,1
SBI60LYY3180775,84,32,31,1,1
SBI77GFT5589737,73,25,18,7,1
SBI28RYM9829912,85,28,22,6,1
SBI50WHW6228734,89,22,15,7,1
SBI55ZGT7751577,18,24,23,1,1
SBI22CLC8854836,80,25,18,7,1
SBI07HUU2600770,18,23,13,10,1
SBI72QGB0811160,18,32,18,14,1
SBI88XNG3292767,21,29,22,7,1
SBI38KIM3393839,85,23,16,7,1
SBI84LEE7092533,90,30,24,6,1
SBI76KTY1208153,81,25,14,11,1
SBI94MYA6495819,63,25,23,2,1
SBI57VFE7812676,91,37,28,9,1
SBI65JWY9432246,71,27,15,12,1
SBI28BHU4735280,70,31,29,2,1
SBI78SEB3118521,61,24,19,5,1
SBI75ZHY3033702,95,25,17,8,1
SBI03HER8924884,75,25,24,1,1
SBI11HAK3701877,95,27,17,10,1
SBI65ZBM0402378,79,18,10,8,1
SBI04QOV9769269,78,31,20,11,1
SBI20BTM3502520,18,29,24,5,1
SBI41BXH1497429,85,26,17,9,1
SBI45ATK4126389,95,23,15,8,1
SBI17XZS7591197,92,18,13,5,1
SBI74FTH6593584,64,31,18,13,1
SBI10AYJ1076809,66,16,12,4,1
SBI70KAE9738704,72,19,18,1,1
SBI36DLN4142888,87,21,14,7,1
SBI76IGK6770442,90,21,12,9,1
SBI42WFF3049933,61,19,17,2,1
SBI94RWY7952585,62,20,13,7,1
SBI16CJG5997174,67,17,12,5,1
SBI16EWS0642699,22,30,21,9,1
SBI30UJE0838815,25,27,21,6,1
SBI55KXQ0485021,71,17,10,7,1
SBI33OHI2040925,67,19,18,1,1
SBI56QNV1511099,23,13,7,6,1
SBI45DJH5011365,68,25,14,11,1
SBI46BBS1176072,62,22,14,8,1
SBI84VXL7783691,96,25,15,10,1
SBI54PFJ8255980,74,25,22,3,1
SBI69GMS4121344,89,24,13,11,1
SBI94DDD7235888,75,22,16,6,1
SBI55DWK0305103,65,19,15,4,1
SBI59WMZ9208507,67,22,12,10,1
SBI68CMA0098040,86,18,14,4,1
SBI49TDF6280706,61,29,22,7,1
SBI48NAC5536465,80,23,20,3,1
SBI10MDF4927565,85,26,14,12,1
SBI60NJX2887195,64,25,24,1,1
SBI60LGM9286886,95,18,15,3,1
SBI01PVO6321080,99,23,19,4,1
SBI14WDV2936533,22,25,24,1,1
SBI78IDU0389190,61,21,17,4,1
SBI03QZT3813460,97,25,21,4,1
SBI02TLV9458928,68,29,27,2,1
SBI42FVW6822753,93,28,19,9,1
SBI78FEF5117991,83,31,19,12,1
SBI00OPO3504849,94,18,16,2,1
SBI51AAQ5292134,95,19,13,6,1
SBI01VAB6501922,61,25,23,2,1
SBI83IAT2944620,76,38,24,14,1
SBI04YEW9106758,83,25,16,9,1
SBI34NCK2912334,86,21,15,6,1
SBI78WJK8678745,60,21,15,6,1
SBI11XBQ1469734,25,31,18,13,1
SBI45OYJ3100432,95,30,27,3,1
SBI99DHU7264667,80,25,20,5,1
SBI55QQA7752413,85,28,25,3,1
SBI49XVZ1283767,76,20,11,9,1
SBI41SHT3562547,63,17,16,1,1
SBI88DPS7748998,86,35,33,2,1
SBI56QNY1567069,87,21,20,1,1
SBI10PTM0873097,94,25,21,4,1
SBI64ESL5495546,94,26,18,8,1
SBI73BIJ9331481,78,30,25,5,1
SBI74CWX3703096,75,24,18,6,1
SBI92ZGU0452055,93,30,24,6,1
SBI55YPY7299675,91,21,19,2,1
SBI41KYM8571295,74,22,13,9,1
SBI44KNH5902531,18,33,26,7,1
SBI47CUS0501225,99,25,13,12,1
SBI73NZP2006476,61,21,19,2,1
SBI97YYB6890750,22,17,13,4,1
SBI99BME5820094,71,29,19,10,1
SBI08KIK7060488,21,28,22,6,1
SBI76TZB1509674,22,19,16,3,1
SBI79MHX0394839,74,31,29,2,1
SBI43RGN2832518,62,26,15,11,1
SBI49NFQ3980563,76,18,11,7,1
SBI26XMT8999818,99,27,17,10,1
SBI89RXC7316557,22,29,26,3,1
SBI57RSD1637182,70,31,29,2,1
SBI49NRA3643760,74,22,13,9,1
SBI32OOA1379121,22,28,20,8,1
SBI42OHG8618845,21,15,14,1,1
SBI15EPS4731759,82,30,23,7,1
SBI46BKA8685841,85,25,13,12,1
SBI97FIA7192572,60,25,17,8,1
SBI67CEH1436730,20,17,16,1,1
SBI27NPP7830517,60,27,25,2,1
SBI16DBI9157524,98,23,13,10,1
SBI15PFY3368092,85,22,14,8,1
SBI97CLS6637807,80,16,13,3,1
SBI07NYE9714997,74,24,21,3,1
SBI63BBK4795661,80,26,18,8,1
SBI24CHL8035590,19,30,24,6,1
SBI17XCO6475556,99,26,22,4,1
SBI25NSI3914887,24,31,22,9,1
SBI69NFW5944969,65,14,11,3,1
SBI10TGT6675923,97,19,16,3,1
SBI58OVZ4179081,98,21,15,6,1
SBI51WNX2199215,20,24,16,8,1
SBI44FEA0683225,60,21,19,2,1
SBI91UXM0658505,72,24,19,5,1
SBI28ZJM7759169,85,30,22,8,1
SBI74POD8982344,62,25,15,10,1
SBI94FQO0498927,19,23,20,3,1
SBI08BMD6234713,89,25,18,7,1
SBI22UJR3275690,91,26,21,5,1
SBI81DLD3029585,97,25,18,7,1
SBI70VTF0619647,74,30,25,5,1
SBI59IER2561647,88,22,19,3,1
SBI41OEO4265387,62,28,23,5,1
SBI00QCS4795536,80,32,20,12,1
SBI66VXP7409313,60,20,19,1,1
SBI38VTS2426209,68,25,16,9,1
SBI84JUE2357991,96,19,18,1,1
SBI94TUB0578808,20,27,14,13,1
SBI68PWA4970465,83,28,18,10,1
SBI45VWZ1406399,86,27,26,1,1
SBI30OGM5435068,96,24,21,3,1
SBI74RZQ7707068,66,27,16,11,1
SBI52CCR3195050,18,26,23,3,1
SBI79OUD9214852,90,22,21,1,1
SBI40QNK0622502,69,16,14,2,1
SBI20LNH3090364,90,28,20,8,1
SBI73HUL6460826,66,27,26,1,1
SBI50QCV4957263,94,17,13,4,1
SBI82LSS5180761,96,24,19,5,1
SBI02SSW5855115,94,32,25,7,1
SBI66KQK5412828,25,28,16,12,1
SBI44BCK6411391,80,21,17,4,1
SBI47RAM6834197,80,22,17,5,1
SBI25EZK8076671,91,12,9,3,1
SBI38JXI7108306,69,21,17,4,1
SBI77RBT9651103,73,16,10,6,1
SBI82BBF5880530,74,32,21,11,1
SBI79DZB1939656,96,24,22,2,1
SBI98VWT6187307,23,25,22,3,1
SBI29RAQ3403386,69,22,13,9,1
SBI56HTG2266858,18,26,25,1,1
SBI61DCB0011652,66,25,24,1,1
SBI70HIT8709106,22,25,23,2,1
SBI79YCG5958215,70,30,22,8,1
SBI25QTE1282757,72,16,11,5,1
SBI59QEL1229716,96,25,13,12,1
SBI77TRG6132502,67,20,13,7,1
SBI48YFC6532091,80,26,22,4,1
SBI05VUA6613203,87,18,16,2,1
SBI50TXH1310620,62,31,30,1,1
SBI58RYK9014038,60,23,12,11,1
SBI90LUD5837057,85,18,16,2,1
SBI59GGM6594089,85,32,21,11,1
SBI53TBM9778668,76,24,13,11,1
SBI94TRG1258182,21,27,18,9,1
SBI74XDD3170523,68,20,12,8,1
SBI80GYN0201413,74,17,14,3,1
SBI73EHA2449023,73,24,15,9,1
SBI98QJT4913932,93,18,17,1,1
SBI87ULC3508744,25,27,15,12,1
SBI51DSW6395427,71,24,15,9,1
SBI69DIT6766302,24,18,10,8,1
SBI85EPL9336764,19,27,26,1,1
SBI41TKB9995259,74,30,29,1,1
SBI31OAI6968140,95,27,21,6,1
SBI49MVZ4139604,63,28,16,12,1
SBI61ISJ3447157,84,31,29,2,1
SBI20CIM6705463,63,28,27,1,1
SBI31PGG4876566,84,30,24,6,1
SBI89IOW3271620,90,26,19,7,1
SBI41RVJ0071626,88,28,26,2,1
SBI64NRO2673185,24,28,17,11,1
SBI71VGO3289191,24,22,13,9,1
SBI80QVY8984165,84,20,11,9,1
SBI46RXR5924244,90,19,14,5,1
SBI26EBX9772286,70,21,11,10,1
SBI71BAJ1781295,69,33,25,8,1
SBI42JIK7199459,78,32,17,15,1
SBI25OYW2093456,78,26,18,8,1
SBI42KRR7962249,73,22,21,1,1
SBI21PLT6106834,98,24,20,4,1
SBI45FPU7301233,80,22,19,3,1
SBI02EHG7525819,74,37,33,4,1
SBI60TOJ6746203,99,31,23,8,1
SBI75GSA5173658,21,28,18,10,1
SBI94ILR3134334,93,26,19,7,1
SBI94IYK0736345,79,15,13,2,1
SBI82NUH3875004,19,16,11,5,1
SBI91ZKD5006834,64,25,23,2,1
SBI23PJO5558063,86,21,15,6,1
SBI70LIC7894877,68,20,15,5,1
SBI34OCW0601379,84,19,16,3,1
SBI72TPH4925487,94,25,23,2,1
SBI95SVI0316001,99,28,15,13,1
SBI19PPH1106567,23,27,16,11,1
SBI50IED3144872,22,18,16,2,1
SBI05YEB6257259,63,33,27,6,1
SBI10ANS2069933,84,22,13,9,1
SBI34VCD3499773,93,27,15,12,1
SBI06JSW5501808,67,25,14,11,1
SBI63YQD9639799,67,17,15,2,1
SBI53WMF7626484,96,31,20,11,1
SBI20HAF7390311,77,22,20,2,1
SBI99LXP7429213,91,26,21,5,1
SBI49TQQ7643237,61,19,16,3,1
SBI56TKB4403605,20,19,14,5,1
SBI85PBG4973197,74,24,19,5,1
SBI61CPL5153307,20,21,13,8,1
SBI41LNR8325859,74,24,23,1,1
SBI53LVK4853482,99,26,18,8,1
SBI55TSZ2109569,69,30,16,14,1
SBI92WUX5730694,18,18,11,7,1
SBI24ZMY8057852,96,21,12,9,1
SBI52YOO3857217,87,24,18,6,1
SBI87GBA2365967,95,20,11,9,1
SBI45ERG2296308,90,22,13,9,1
SBI31LGP3103149,98,26,21,5,1
SBI95VCQ8363612,92,31,29,2,1
SBI51PGV0973063,79,30,18,12,1
SBI05OOL1295040,89,21,13,8,1
SBI33WTR3885688,83,19,14,5,1
SBI38KVH0716859,85,21,18,3,1
SBI35NRF7176251,18,25,15,10,1
SBI37SAY5979314,80,18,13,5,1
SBI81LHT1430970,63,29,16,13,1
SBI52RRJ9382010,66,18,17,1,1
SBI37ZUJ9191671,98,20,15,5,1
SBI10AFC6494941,18,22,15,7,1
SBI87QQW7635793,72,18,13,5,1
SBI19PBW7274244,97,21,19,2,1
SBI67IHM9948556,88,28,20,8,1
SBI41UWT6936073,71,22,20,2,1
SBI52SOO7998700,63,26,15,11,1
SBI29UNW5799760,66,17,15,2,1
SBI96AEY1102294,24,34,20,14,1
SBI35DGE5762162,19,24,18,6,1
SBI42IHK3136501,63,23,17,6,1
SBI52CKS0146299,84,13,9,4,1
SBI68FRK0114475,65,27,20,7,1
SBI91ZAN2825097,97,21,16,5,1
SBI69ONR3791625,75,27,16,11,1
SBI41XUZ5057542,98,30,19,11,1
SBI37CEW1974972,95,23,17,6,1
SBI06KJW3948078,22,24,19,5,1
SBI15GOQ6922952,93,17,15,2,1
SBI30WJF9224730,78,25,18,7,1
SBI68YSO7153954,90,20,11,9,1
SBI87KVW4618499,20,21,20,1,1
SBI19BWT8906103,91,24,14,10,1
SBI21KMV6835898,90,26,19,7,1
SBI95DCI9963715,69,26,24,2,1
SBI12QSW6649910,82,20,16,4,1
SBI76BGK5169707,69,26,17,9,1
SBI43EMO1157580,75,23,17,6,1
SBI53AXX5740079,96,23,15,8,1
SBI99PHQ9890828,87,26,22,4,1
SBI49LLT3413927,64,21,18,3,1
SBI64TAH7987111,87,26,22,4,1
SBI04TDZ4211908,61,23,15,8,1
SBI22ZGT9345606,63,22,16,6,1
SBI70PBA1379440,21,14,8,6,1
SBI12WZA2263361,19,26,17,9,1
SBI57ABR3162130,85,21,12,9,1
SBI22UTP0751665,81,28,16,12,1
SBI10SDJ0218682,25,18,14,4,1
SBI51KQK0533607,77,30,18,12,1
SBI89CDV9133615,95,26,20,6,1
SBI58RFR8835363,68,19,16,3,1
SBI09TTE9787363,67,15,8,7,1
SBI68QQQ2045739,72,23,14,9,1
SBI38IDB4212961,61,32,24,8,1
SBI22TRY5912042,94,25,22,3,1
SBI46CLO2544544,91,27,23,4,1
SBI18COE6406852,67,33,23,10,1
SBI71GCT5741010,62,23,18,5,1
SBI67UPT7947863,23,22,12,10,1
SBI41MHG3888244,73,27,26,1,1
SBI69KRY3836499,97,29,20,9,1
SBI84RJV5525855,71,24,19,5,1
SBI32WUC5588598,72,20,16,4,1
SBI97EKM8938360,91,20,12,8,1
SBI09TII9927625,65,30,25,5,1
SBI34OVU5544290,98,29,21,8,1
SBI54TQR0431732,72,20,14,6,1
SBI29WAC7564106,78,28,27,1,1
SBI82GGO8160894,77,28,21,7,1
SBI57MQJ0063891,93,29,18,11,1
SBI77JFZ3699394,78,24,18,6,1
SBI40CGW0321047,89,15,10,5,1
SBI05PHC6403233,89,21,16,5,1
SBI46CLQ0042233,86,32,26,6,1
SBI20HTR3691929,79,22,15,7,1
SBI13JYA4584503,72,34,23,11,1
SBI77QFU7521317,18,32,27,5,1
SBI10FFX5549157,93,31,19,12,1
SBI99PQY8362875,62,28,25,3,1
SBI17EHI3639507,75,25,15,10,1
SBI31BCT5594200,97,18,12,6,1
SBI32ACM4775585,92,25,18,7,1
SBI99EWN9700151,90,28,23,5,1
SBI19LWH8520316,18,27,22,5,1
SBI17ZVY4323443,83,22,21,1,1
SBI98QYX3710756,20,15,10,5,1
SBI79UQA5648874,67,16,15,1,1
SBI09DYJ9050281,21,30,21,9,1
SBI03AZT4025334,77,17,16,1,1
SBI39XFP8514730,91,19,18,1,1
SBI57TPQ4664938,66,26,15,11,1
SBI29SCZ7535429,22,26,15,11,1
SBI28PEL3634514,79,24,23,1,1
SBI10SMB4639260,80,25,22,3,1
SBI41HQJ7129876,95,25,23,2,1
SBI78KAQ7390116,69,33,23,10,1
SBI42EHY7633636,86,19,18,1,1
SBI11AUC5440747,79,27,24,3,1
SBI06POH0445950,78,28,26,2,1
SBI69CDI3213748,79,22,19,3,1
SBI84YLS2356332,60,27,21,6,1
SBI13SBH7707957,20,26,19,7,1
SBI64PEV4081682,98,29,26,3,1
SBI42JGZ3870863,87,19,18,1,1
SBI33DIW7424193,62,26,17,9,1
SBI06JGA3666961,63,23,20,3,1
SBI55SWQ6127904,69,21,16,5,1
SBI50YTN9427956,86,30,19,11,1
SBI63OYB7282455,60,37,19,18,1
SBI75KEO3468082,24,21,11,10,1
SBI78YFZ1984015,61,21,19,2,1
SBI76CLM7899578,85,27,23,4,1
SBI99SQZ6499682,94,22,17,5,1
SBI20GRD2652746,60,24,14,10,1
SBI08VAW2262972,75,9,8,1,1
SBI16LJC9724847,60,28,18,10,1
SBI04HVK0583631,77,30,27,3,1
SBI12IHU2847483,92,29,16,13,1
SBI88HKY1987433,23,26,17,9,1
SBI28YTN6747115,75,30,23,7,1
SBI04SFG6692752,22,31,24,7,1
SBI62NKQ6333649,68,20,17,3,1
SBI72TBH6833033,96,30,28,2,1
SBI77ZKV7176676,20,19,13,6,1
SBI58LRI6946903,66,28,16,12,1
SBI80YUJ2456397,63,25,16,9,1
SBI08YVZ6982218,21,27,15,12,1
SBI66XTX8317507,21,26,24,2,1
SBI42VUI0559204,90,22,18,4,1
SBI06KTR3206848,96,25,22,3,1
SBI40DXS9477760,61,31,18,13,1
SBI34BCB5179071,20,22,14,8,1
SBI10ARJ7396168,76,21,20,1,1
SBI62MLP9394743,96,23,14,9,1
SBI80IPW6644291,70,24,16,8,1
SBI74QOA0420789,23,24,16,8,1
SBI98SJH8042974,85,25,14,11,1
SBI78OKO5138591,73,22,17,5,1
SBI24WJH6952168,60,20,16,4,1
SBI93YYZ2109898,79,15,12,3,1
SBI11LQO4706969,18,21,12,9,1
SBI67SNM9878902,63,31,25,6,1
SBI76WFN7923847,68,25,20,5,1
SBI52WOR1378385,61,25,17,8,1
SBI84WJB8774339,74,26,15,11,1
SBI12UNU9544809,94,19,18,1,1
SBI90TWJ8770114,68,19,14,5,1
SBI10VUS3553268,94,13,10,3,1
SBI83DUR4200124,76,14,11,3,1
SBI92CLF3610363,94,18,12,6,1
SBI31XKW3342077,80,24,23,1,1
SBI07KPO8335045,19,25,19,6,1
SBI94GGH0681284,78,25,23,2,1
SBI57VGR7535449,21,21,19,2,1
SBI55AHC7109832,63,25,15,10,1
SBI78YEG1207222,71,27,24,3,1
SBI41GKS3474830,76,25,22,3,1
SBI11NDY7470942,64,20,14,6,1
SBI52PCG8188755,98,21,12,9,1
SBI71GQO0930899,19,25,23,2,1
SBI81IKA7018953,60,26,20,6,1
SBI13CHU3304082,61,16,12,4,1
SBI91GNZ9636286,19,23,22,1,1
SBI69TCX3298010,75,18,10,8,1
SBI56AFL9745629,78,16,15,1,1
SBI14JDX2968921,89,18,17,1,1
SBI62DJH2650581,97,21,12,9,1
SBI44MVD1079655,25,20,11,9,1
SBI51BYW6767076,24,22,18,4,1
SBI06ATF3078097,19,25,16,9,1
SBI37MZY0894572,87,29,23,6,1
SBI17RTC1208435,76,23,16,7,1
SBI92BZZ9748802,79,19,18,1,1
SBI03BWX0177999,82,35,27,8,1
SBI11CVI1879286,63,23,17,6,1
SBI10FKK3418188,95,30,24,6,1
SBI58CSQ4864163,98,30,22,8,1
SBI94BKP7180936,72,26,18,8,1
SBI45ZDJ5350995,97,31,22,9,1
SBI92LFF0149849,23,31,16,15,1
SBI08XEY1781473,88,28,17,11,1
SBI80VAX2370408,97,26,18,8,1
SBI31VHF4256236,23,28,25,3,1
SBI14LYK8525705,61,30,22,8,1
SBI83DOH1622360,81,22,17,5,1
SBI36GNS1356938,84,31,23,8,1
SBI73HBP2417766,95,23,18,5,1
SBI05YRE0471473,74,28,24,4,1
SBI67ICP8343002,74,22,16,6,1
SBI79BXS0559547,81,21,14,7,1
SBI94VGA7585151,23,25,17,8,1
SBI67VTD5993423,68,15,11,4,1
SBI97IIA9223781,82,36,34,2,1
SBI80CBQ1787420,88,23,20,3,1
SBI04QBF3371629,63,22,21,1,1
SBI66AOU9173881,76,19,14,5,1
SBI94MJV6741364,82,33,28,5,1
SBI55ZWI1519149,77,33,22,11,1
SBI81IMC0615694,87,22,15,7,1
SBI35STU0796441,80,30,18,12,1
SBI36VTB5996584,98,22,21,1,1
SBI55MTO4705602,96,17,13,4,1
SBI44OCT0143230,72,36,24,12,1
SBI80FAO5538521,89,28,15,13,1
SBI89YVA9313644,24,18,13,5,1
SBI04BVD0665927,86,18,14,4,1
SBI42UCK8733355,25,25,15,10,1
SBI99ESF9896200,96,19,17,2,1
SBI51OEA1474304,22,30,27,3,1
SBI26MTU8377012,73,21,17,4,1
SBI50PII1647356,96,27,19,8,1
SBI14NAB0118602,79,22,12,10,1
SBI73XPW7544138,68,21,17,4,1
SBI95CAU1859226,73,26,14,12,1
SBI61XDR7080734,92,22,17,5,1
SBI11EIH3277507,73,25,18,7,1
SBI08HUY4762266,19,28,19,9,1
SBI76CNL4730995,62,26,25,1,1
SBI96UXX2179766,23,22,15,7,1
SBI59WCI0020896,24,36,30,6,1
SBI89VGU4506272,83,22,13,9,1
SBI88WYF9160242,79,29,16,13,1
SBI75JHQ8722533,93,24,15,9,1
SBI35MFU5329814,67,20,16,4,1
SBI65OUO4978772,20,24,20,4,1
SBI87OVT9240841,21,29,28,1,1
SBI78VTM3649904,69,31,24,7,1
SBI53NOG7773375,88,27,14,13,1
SBI94JEK4677967,96,33,31,2,1
SBI89SFC3051362,25,28,16,12,1
SBI42XSB9112899,63,23,12,11,1
SBI31XQK6479726,20,27,17,10,1
SBI25HBJ5765574,83,28,18,10,1
SBI43FTW5619231,18,34,18,16,1
SBI06XAT5191948,21,29,17,12,1
SBI09WIF4372728,95,21,13,8,1
SBI78RDK9749259,62,21,11,10,1
SBI98DWG6250674,68,31,25,6,1
SBI49NHX3499663,78,26,14,12,1
SBI43LXL8093788,74,26,23,3,1
SBI79OYF1969538,64,26,21,5,1
SBI97VSX8926215,21,25,18,7,1
SBI49UBN7257046,93,25,15,10,1
SBI79GUA2181272,71,15,10,5,1
SBI41TCB7646684,78,34,33,1,1
SBI02CQN1581913,71,26,22,4,1
SBI15OGC6834287,62,12,7,5,1
SBI08YQK1325728,65,24,15,9,1
SBI33GER5624251,99,31,25,6,1
SBI60HET1188543,20,19,18,1,1
SBI96CAS3872570,93,22,17,5,1
SBI65LXN9500697,95,20,18,2,1
SBI56FPA6546516,19,33,25,8,1
SBI26QFS2827806,84,26,24,2,1
SBI84KPE4769393,86,25,23,2,1
SBI83VNB5271092,91,17,13,4,1
SBI07FIE4491889,87,27,14,13,1
SBI95ALE1724837,98,29,19,10,1
SBI89ZSS2420973,83,19,18,1,1
SBI42ZPB9734128,67,25,23,2,1
SBI71LXC3049566,22,17,16,1,1
SBI09WKR4517022,86,24,16,8,1
SBI95EHH6051776,85,29,16,13,1
SBI44EEP0717863,60,24,14,10,1
SBI39LGK0329596,83,23,15,8,1
SBI27FIA0987996,68,28,23,5,1
SBI83LPD1539661,93,28,21,7,1
SBI92BCH0113687,23,24,20,4,1
SBI32PQW7421165,86,27,24,3,1
SBI17XLW3491965,80,17,16,1,1
SBI36TNU1666668,90,23,21,2,1
SBI20UBL2823444,72,23,21,2,1
SBI36AHU6683678,99,18,11,7,1
SBI04BVB8709977,84,26,14,12,1
SBI83LIT8085162,92,25,21,4,1
SBI37HUS8813982,22,30,28,2,1
SBI86GNM0154125,60,18,10,8,1
SBI03WNS1854076,19,33,29,4,1
SBI33CDJ1570157,80,22,18,4,1
SBI20MBX3654908,60,14,11,3,1
SBI73MJS5971703,65,22,18,4,1
SBI31LTV2876615,83,31,20,11,1
SBI34CQW8333782,99,25,15,10,1
SBI01PLQ7272501,62,27,18,9,1
SBI60LIQ7388680,62,23,17,6,1
SBI50CWP0783816,25,22,19,3,1
SBI52VSK9633312,81,22,17,5,1
SBI31JMC5508924,90,23,14,9,1
SBI04KRX6202200,92,21,15,6,1
SBI20UQA7258356,23,24,16,8,1
SBI52MAS2618973,64,22,18,4,1
SBI70KGJ7623310,66,28,16,12,1
SBI15IOY5633141,93,24,13,11,1
SBI33WHX9474944,71,30,25,5,1
SBI85CGM3936209,97,27,24,3,1
SBI93NFZ2009475,75,24,16,8,1
SBI29MSA1317349,61,18,14,4,1
SBI29SFV0061471,85,29,28,1,1
SBI22DET5675691,68,14,10,4,1
SBI73MYO6357409,90,30,27,3,1
SBI46GQE8934404,73,25,14,11,1
SBI60IFF5609529,61,20,18,2,1
SBI09HLM1211545,23,29,21,8,1
SBI88WWK2673584,98,26,17,9,1
SBI47MBQ2752589,64,22,15,7,1
SBI30RMW4356790,79,17,12,5,1
SBI75KSF2363979,98,19,17,2,1
SBI81CWX8813957,74,27,25,2,1
SBI06ALP0781988,87,20,17,3,1
SBI70MUO4023376,85,25,22,3,1
SBI09KJB0046052,92,34,20,14,1
SBI88IRU0127239,24,27,23,4,1
SBI77ZEZ5218916,19,26,24,2,1
SBI36DCE9653143,93,16,14,2,1
SBI65IOJ6255452,98,30,26,4,1
SBI36UJT0341308,63,16,14,2,1
SBI96BLE2325287,22,27,15,12,1
SBI16WLE6807597,68,22,17,5,1
SBI98IZL9926280,96,22,21,1,1
SBI59AYM7638719,76,27,25,2,1
SBI12XKR0480457,98,17,13,4,1
SBI96OCH0213937,22,29,17,12,1
SBI32ZFS1989864,18,39,33,6,1
SBI32PXG7109133,91,17,15,2,1
SBI58HBF7631625,81,22,19,3,1
SBI47BGG0724589,81,24,18,6,1
SBI70PFJ6040315,78,20,16,4,1
SBI72RUC4833977,66,14,8,6,1
SBI51EBV2672060,89,36,19,17,1
SBI04LJK1992466,76,21,15,6,1
SBI49MXR2482790,96,23,22,1,1
SBI03QZK2548513,77,26,18,8,1
SBI57QKL3148382,87,25,24,1,1
SBI38PYW5948035,19,27,23,4,1
SBI91SEV5636853,73,28,23,5,1
SBI32YAS0017295,80,20,11,9,1
SBI68JXW0972620,79,20,14,6,1
SBI62IXU3785916,99,20,11,9,1
SBI08PCF7600324,66,21,13,8,1
SBI84ZXX7478777,80,19,17,2,1
SBI99FGD2618681,99,31,16,15,1
SBI70LCM5600038,70,31,19,12,1
SBI00ZTN9866138,81,26,14,12,1
SBI40TGX6974831,96,31,19,12,1
SBI14SZC1157094,75,26,23,3,1
SBI10SEZ3923969,90,21,20,1,1
SBI56SMD4742890,23,25,14,11,1
SBI68QGL2628375,90,30,17,13,1
SBI56MTK0105332,24,20,18,2,1
SBI16ENO9018017,19,14,13,1,1
SBI46QHG3266935,79,27,19,8,1
SBI38JRG4193058,69,24,22,2,1
SBI72BSF8755002,91,35,27,8,1
SBI74KBU8322615,80,15,10,5,1
SBI70PMI3795001,67,29,18,11,1
SBI41UJW5232827,25,24,20,4,1
SBI13BFS1496347,23,20,11,9,1
SBI78UDC2775621,86,20,11,9,1
SBI03ETQ7167289,71,35,28,7,1
SBI92QKH3759420,81,15,14,1,1
SBI63STW6865254,64,20,13,7,1
SBI51YPH4636839,82,22,14,8,1
SBI08NYG0563863,77,28,20,8,1
SBI34ZYY5237294,64,12,9,3,1
SBI03GFV6538970,62,26,17,9,1
SBI87JEQ5350531,82,24,21,3,1
SBI17KEH4763025,94,24,18,6,1
SBI37BUL2580657,88,16,12,4,1
SBI55ZWM5767080,90,20,13,7,1
SBI46AAU3210099,91,26,24,2,1
SBI02WTE5366747,88,20,17,3,1
SBI93MBV1192954,61,23,22,1,1
SBI13RFJ9712671,23,28,19,9,1
SBI36ZQF8018231,72,28,26,2,1
SBI47CXQ0327837,20,31,20,11,1
SBI87OPE5505794,21,23,17,6,1
SBI14YEO6988523,99,23,22,1,1
SBI77BIA0755453,83,15,12,3,1
SBI59QGJ4122485,66,31,20,11,1
SBI35PWQ2217991,90,19,12,7,1
SBI07VBT9082944,82,21,13,8,1
SBI58DOH6311831,89,24,19,5,1
SBI51IGQ2786815,21,28,19,9,1
SBI53QNE8752078,71,30,25,5,1
SBI77NVV6737823,83,24,13,11,1
SBI00GOJ7093672,88,28,27,1,1
SBI63PFH5788674,90,33,32,1,1
SBI83KBP4155693,97,18,17,1,1
SBI77YCN8090459,60,26,23,3,1
SBI05GEA6676768,88,26,20,6,1
SBI76FPW1013325,63,24,18,6,1
SBI66BMI8714204,88,20,19,1,1
SBI56ZPJ3323419,92,32,20,12,1
SBI62WXC2017773,62,18,16,2,1
SBI48NDM6418046,22,32,29,3,1
SBI45FSL9860107,99,26,15,11,1
SBI03NAN7511836,20,11,8,3,1
SBI49EZM9091714,89,25,13,12,1
SBI50DBF7546185,88,22,15,7,1
SBI74SPS1655790,87,31,27,4,1
SBI96EFG2061234,87,19,16,3,1
SBI12XXG7973308,80,26,18,8,1
SBI18GGF6422161,20,33,18,15,1
SBI75PII5055909,74,31,19,12,1
SBI85ABT8339668,24,25,22,3,1
SBI50ZGB9406935,75,24,17,7,1
SBI57GQD6265293,75,13,10,3,1
SBI43DKX9777117,67,22,17,5,1
SBI56DVR4683729,73,26,22,4,1
SBI46XAC3352734,72,25,17,8,1
SBI33WVK8305164,21,29,16,13,1
SBI39PIA0500711,74,31,25,6,1
SBI55MGY1053627,82,20,13,7,1
SBI19VWW8730712,69,30,20,10,1
SBI53TOD0713897,20,19,17,2,1
SBI61FIK0361524,24,27,26,1,1
SBI33EUH0700580,23,27,26,1,1
SBI91JYH2950543,96,30,19,11,1
SBI75MSJ8940005,62,22,12,10,1
SBI71XTA4195710,95,21,15,6,1
SBI09NGH7927625,62,18,12,6,1
SBI89DJJ4639750,71,26,19,7,1
SBI33FKM0287527,83,30,20,10,1
SBI37MAU5128784,99,31,30,1,1
SBI37VGA4950053,91,20,13,7,1
SBI29KRI7364511,88,21,13,8,1
SBI12WPZ0490223,22,23,17,6,1
SBI33ATN2364009,65,31,27,4,1
SBI43MKS3793769,68,25,16,9,1
SBI61UFA5085154,83,13,9,4,1
SBI41MRS0363607,84,18,13,5,1
SBI93OVC2897126,64,18,10,8,1
SBI98LXL4994910,96,28,27,1,1
SBI91NIV9983981,19,24,21,3,1
SBI09ZHU5430395,98,22,16,6,1
SBI51JHK7116208,81,23,17,6,1
SBI21SMO2929843,75,25,21,4,1
SBI11COG3639272,18,18,11,7,1
SBI87RPJ1031899,22,19,13,6,1
SBI06PEP4879059,19,24,16,8,1
SBI61YZU0109624,73,29,25,4,1
SBI66YAK7292609,64,25,21,4,1
SBI14AQA1593023,88,20,17,3,1
SBI86IRU7901626,65,25,23,2,1
SBI10LDL2041289,19,28,16,12,1
SBI17LFN8577336,86,24,23,1,1
SBI54DXV1122429,78,23,13,10,1
SBI10FPN2862434,84,31,17,14,1
SBI60KNO7114026,68,31,20,11,1
SBI99DTG1903892,69,27,26,1,1
SBI41QRZ8016435,75,33,30,3,1
SBI57KBJ6371416,87,24,21,3,1
SBI01KVQ8231283,93,18,12,6,1
SBI27EEN1067732,95,28,25,3,1
SBI88OHS4445944,19,24,15,9,1
SBI48XMC3608654,75,30,28,2,1
SBI08FLA4456768,66,22,18,4,1
SBI61APD8574364,75,23,13,10,1
SBI91QAG3311454,86,23,20,3,1
SBI20XCA6326905,84,20,18,2,1
SBI73ZPW9586781,73,28,27,1,1
SBI85CYQ8246478,64,36,23,13,1
SBI36AKF7520037,91,26,16,10,1
SBI50PID2359715,83,29,15,14,1
SBI17XZT8660974,82,27,16,11,1
SBI02FGC3721295,81,25,18,7,1
SBI78CNO0774414,64,21,19,2,1
SBI41QXT7998329,97,25,22,3,1
SBI09ZJH6260810,86,21,12,9,1
SBI21VTV5707305,70,26,23,3,1
SBI32KHV6751338,71,24,15,9,1
SBI18PFE0395606,61,31,23,8,1
SBI70PRB2700629,70,23,22,1,1
SBI43FIZ3644223,19,14,8,6,1
SBI82SWH3436406,23,16,15,1,1
SBI94YDB6972365,71,15,11,4,1
SBI81RFN2090771,68,32,27,5,1
SBI08TRR3758536,73,26,18,8,1
SBI98XJQ4337260,61,36,24,12,1
SBI94CVY4480102,25,27,26,1,1
SBI62FFK0864011,62,25,14,11,1
SBI39XSE2950983,72,19,10,9,1
SBI39GZK6254586,96,19,13,6,1
SBI38WBZ6413427,70,30,21,9,1
SBI21HQR8610626,95,28,18,10,1
SBI39LDL8483665,88,33,27,6,1
SBI80OPA6228921,24,22,13,9,1
SBI09CFT1603469,89,29,22,7,1
SBI79BNB3955682,99,16,10,6,1
SBI37MMO6740188,94,19,11,8,1
SBI61LIF4887372,24,30,16,14,1
SBI40KJV6017679,22,26,14,12,1
SBI14AAJ9970314,89,30,25,5,1
SBI34RTH2038409,73,34,28,6,1
SBI59BME3317642,85,22,15,7,1
SBI14BJB2556604,78,22,17,5,1
SBI43PFL8364953,95,26,22,4,1
SBI72NOF8411622,91,27,23,4,1
SBI73DPK7979416,95,34,18,16,1
SBI18XBO3881157,90,23,19,4,1
SBI44AZX3402686,96,27,23,4,1
SBI10MFO6016751,72,25,22,3,1
SBI55JVJ4654211,63,21,13,8,1
SBI93GRH1578498,61,25,21,4,1
SBI13IBG8115007,78,18,17,1,1
SBI82BSN2785297,86,24,16,8,1
SBI03JRH0942655,67,33,26,7,1
SBI20QVH0095356,86,23,19,4,1
SBI41WLX9243331,65,31,17,14,1
SBI84JFM2917687,86,25,23,2,1
SBI95MLK3632247,67,32,25,7,1
SBI69OIS2483403,25,34,31,3,1
SBI72UND1076617,98,25,24,1,1
SBI26CYE1770950,74,20,19,1,1
SBI59LYW9393621,68,21,17,4,1
SBI04SOM1757605,68,35,34,1,1
SBI30JYM8910962,67,30,24,6,1
SBI28CWQ1562603,66,27,24,3,1
SBI24VCB6519090,85,30,23,7,1
SBI59DXP2705738,98,32,18,14,1
SBI11JPS2767693,62,22,13,9,1
SBI30AQM7357760,66,14,11,3,1
SBI13EZP8473586,72,23,13,10,1
SBI99CZI1627311,87,20,17,3,1
SBI81XOQ3894912,62,23,15,8,1
SBI05CET5825674,96,24,23,1,1
SBI64JZO5274670,66,13,11,2,1
SBI74EEK3805126,84,26,21,5,1
SBI74JNJ1298240,90,27,18,9,1
SBI23HJZ5273065,82,23,14,9,1
SBI68BUV4816809,68,29,20,9,1
SBI86DPJ7119294,74,18,10,8,1
SBI66PWC6709933,89,20,17,3,1
SBI82UJF2413441,69,33,24,9,1
SBI06GGZ5371048,18,35,29,6,1
SBI61HSM2280899,80,21,18,3,1
SBI08SNO8175732,65,24,13,11,1
SBI94BCK1386610,68,25,13,12,1
SBI15UZC9267838,79,21,19,2,1
SBI31GWW7332693,80,30,18,12,1
SBI48VOO2761760,76,29,27,2,1
SBI36ECI0423108,20,19,17,2,1
SBI77TDD7131745,76,26,21,5,1
SBI54TAJ1267136,78,19,14,5,1
SBI29YKU0850043,69,23,14,9,1
SBI23KRO6947042,83,17,14,3,1
SBI22YRY3376243,87,28,22,6,1
SBI72GTS2814321,72,29,24,5,1
SBI45SLF8921890,98,23,15,8,1
SBI59NMC4174603,96,29,28,1,1
SBI93ZEH7043412,77,29,25,4,1
SBI60VGQ7934719,60,27,20,7,1
SBI92WLP6900763,85,15,9,6,1
SBI17AQP1208221,72,17,13,4,1
SBI24DHV1457285,64,24,20,4,1
SBI89UMX3505055,99,21,14,7,1
SBI62BDF8024020,76,20,11,9,1
SBI05JYL0336155,92,16,15,1,1
SBI56WBK3017504,75,23,16,7,1
SBI03IZL4856619,23,34,28,6,1
SBI54QTU0433358,60,19,15,4,1
SBI73VAV3783946,87,24,17,7,1
SBI54FQA1681431,89,27,18,9,1
SBI61QBL1956108,18,22,19,3,1
SBI63GUT7439307,98,18,13,5,1
SBI37JTZ3169006,68,28,17,11,1
SBI83YVC9279021,83,26,20,6,1
SBI46IUD4533637,99,15,13,2,1
SBI85AHD6759998,99,34,21,13,1
SBI48ZCD1542500,63,23,22,1,1
SBI77XOZ9975794,76,25,16,9,1
SBI32UMM9509299,79,27,23,4,1
SBI24ZHP2812070,25,22,17,5,1
SBI81HFL5349149,60,30,20,10,1
SBI04LHK8827522,62,30,27,3,1
SBI26HPR2518621,87,26,22,4,1
SBI96POE6003049,24,26,17,9,1
SBI16XQM0747313,23,25,18,7,1
SBI08UOE6587725,67,21,16,5,1
SBI25SLW3311722,67,23,16,7,1
SBI74DAH7491864,73,24,23,1,1
SBI38JHC9373837,68,27,23,4,1
SBI33IVQ1855475,18,18,16,2,1
SBI52VZJ4186836,66,25,16,9,1
SBI76KNK0067389,86,21,11,10,1
SBI90JQO4374424,75,21,19,2,1
SBI46PNS6724693,65,16,12,4,1
SBI33SLS4672442,76,28,25,3,1
SBI55IBH2210403,61,34,19,15,1
SBI00WZR0612384,63,14,13,1,1
SBI62CJG0281078,85,24,13,11,1
SBI97YMN8561600,71,19,14,5,1
SBI71MOI2558441,84,20,18,2,1
SBI85ZRM9696378,88,22,16,6,1
SBI24BOS5001638,22,29,16,13,1
SBI73FZT2329779,18,19,15,4,1
SBI45GBI3678958,74,33,29,4,1
SBI94AXO2985075,18,19,13,6,1
SBI31YUW7921816,18,25,16,9,1
SBI13SZP8586638,69,17,13,4,1
SBI99JVJ3105779,67,27,18,9,1
SBI37ELH7101432,79,26,21,5,1
SBI66SOD0524936,83,23,22,1,1
SBI22REH3870594,88,19,17,2,1
SBI61IMN2554971,83,24,23,1,1
SBI94TPW5611819,96,15,13,2,1
SBI64MDB8999575,68,24,21,3,1
SBI94FOB6588978,23,24,16,8,1
SBI60DJJ1758784,18,24,23,1,1
SBI58UKK4582556,62,24,22,2,1
SBI15OOS5495581,88,22,15,7,1
SBI16VXL1212337,25,23,17,6,1
SBI41IOW8382493,61,31,22,9,1
SBI95MUZ8014879,87,28,22,6,1
SBI22ZBY1154138,65,28,17,11,1
SBI44FXF6509181,18,18,14,4,1
SBI36IGW3585770,84,33,24,9,1
SBI24EVI4076580,70,26,14,12,1
SBI85GNJ7069930,24,19,17,2,1
SBI22DVM4035495,64,21,14,7,1
SBI80RQK8989815,25,20,12,8,1
SBI25VWH9045449,22,29,21,8,1
SBI59GWV7710627,83,22,18,4,1
SBI52QCL4390643,88,17,15,2,1
SBI34ERN0370707,71,22,14,8,1
SBI29FGQ4479082,98,25,14,11,1
SBI25XZD0316243,91,24,15,9,1
SBI23EUH1942772,97,21,19,2,1
SBI31HJU7907211,68,21,16,5,1
SBI53XSP4315046,72,27,26,1,1
SBI44SDX6844428,74,24,21,3,1
SBI31BHS6379108,62,28,27,1,1
SBI21MWE0333096,97,27,26,1,1
SBI16LNR3134626,96,29,27,2,1
SBI58RGJ3573436,81,17,16,1,1
SBI32TNH2575458,75,31,20,11,1
SBI04MAI7819798,76,25,16,9,1
SBI92EJQ5310263,86,17,16,1,1
SBI29SST2232721,24,17,10,7,1
SBI14DOW8471352,70,28,20,8,1
SBI43XXF7833040,95,28,17,11,1
SBI80TYY0049992,20,21,15,6,1
SBI41NDE2048064,95,21,12,9,1
SBI14GVF3456761,68,18,11,7,1
SBI08DST7231606,92,21,18,3,1
SBI81WTI2548993,72,36,25,11,1
SBI33MPX1540197,19,25,13,12,1
SBI47NVQ8485604,19,28,26,2,1
SBI10MLW8748813,19,24,14,10,1
SBI87APC6157027,21,26,14,12,1
SBI71DIH3181983,94,20,19,1,1
SBI63IIG6029351,91,27,16,11,1
SBI59HTC4276912,72,31,19,12,1
SBI07SBQ2242566,90,30,24,6,1
SBI07LJX7092730,70,25,14,11,1
SBI84CNI1195836,95,25,21,4,1
SBI61YNE4604831,77,20,12,8,1
SBI67OQP4621572,20,28,20,8,1
SBI00QEF5723469,68,29,20,9,1
SBI65YCZ1127644,23,29,18,11,1
SBI75RGQ7516954,61,24,15,9,1
SBI42NDY3881311,18,31,21,10,1
SBI20JIY6066048,64,27,19,8,1
SBI89YOG2077902,87,32,21,11,1
SBI88ZKT8459252,64,26,21,5,1
SBI09CEF4029806,95,19,11,8,1
SBI92KKF5008671,22,22,17,5,1
SBI75RET4851505,81,26,18,8,1
SBI61HDL9667957,81,22,14,8,1
SBI29LWX7018420,62,21,15,6,1
SBI54QCJ6824547,69,15,8,7,1
SBI76AXQ2795370,81,28,22,6,1
SBI72KBM2317450,21,25,17,8,1
SBI92XFZ2365285,66,28,23,5,1
SBI08GQQ6385724,64,29,23,6,1
SBI33AEV0975855,89,31,22,9,1
SBI42UAG8876418,89,23,16,7,1
SBI64ZTW8356860,97,33,30,3,1
SBI99ITJ4030728,69,25,23,2,1
SBI77NQG6964651,85,28,24,4,1
SBI86FVG3544901,71,17,9,8,1
SBI13CWF3903798,18,28,26,2,1
SBI58BPK0216783,85,32,30,2,1
SBI24TGI1076491,62,26,19,7,1
SBI45SJH6650309,94,23,12,11,1
SBI84YST9251165,86,22,20,2,1
SBI51EUC9701665,95,30,21,9,1
SBI04ARD4061885,71,23,19,4,1
SBI02GZS2047774,65,24,16,8,1
SBI84UOP1796065,23,22,18,4,1
SBI83UZL2997031,74,27,14,13,1
SBI99OOP4762550,64,25,23,2,1
SBI03VWV3558297,80,23,21,2,1
SBI51JZM5565581,76,28,23,5,1
SBI99DJM2332488,60,18,10,8,1
SBI87JKH5459677,23,21,20,1,1
SBI63GAC3528092,78,19,10,9,1
SBI06LSX6940736,22,26,18,8,1
SBI88CDO3854237,77,29,22,7,1
SBI97RDK2627980,73,23,16,7,1
SBI54DBP9317294,76,11,10,1,1
SBI08MYQ2463554,24,21,13,8,1
SBI29OPE9109179,68,17,14,3,1
SBI48HPZ8547573,79,26,15,11,1
SBI20RZT9587361,68,28,27,1,1
SBI63NOU5792627,71,29,23,6,1
SBI30ZHI0029607,21,24,19,5,1
SBI27JPO8532992,78,27,23,4,1
SBI68VYE1422984,70,25,15,10,1
SBI81AZZ6869288,74,23,16,7,1
SBI61ATJ5841382,96,26,24,2,1
SBI71OQL7022848,93,28,18,10,1
SBI30VMO8345910,64,27,22,5,1
SBI66HFO0522123,67,26,18,8,1
SBI51QOD3913234,85,19,16,3,1
SBI52HPV6471920,60,24,21,3,1
SBI57VNJ8040096,60,17,13,4,1
SBI90KRS0497401,18,27,23,4,1
SBI85NUK0017803,81,24,17,7,1
SBI97ZZI4786080,60,22,12,10,1
SBI04EIS8519759,79,24,14,10,1
SBI55EOZ5392481,68,24,20,4,1
SBI43WAQ5263594,88,32,26,6,1
SBI04QYV5826202,89,22,15,7,1
SBI00ZPA9131529,23,25,16,9,1
SBI31JOZ5847188,88,24,17,7,1
SBI52NAL7637089,82,21,13,8,1
SBI53FOO7437886,60,24,23,1,1
SBI93MMS3279997,60,20,14,6,1
SBI43LXF2059073,66,25,21,4,1
SBI23GNP7377933,67,33,23,10,1
SBI70SUR5411736,67,23,12,11,1
SBI60FBW1160236,18,26,14,12,1
SBI56XBO7269346,71,24,22,2,1
SBI82EZO2305698,71,32,20,12,1
SBI88DWY9333968,81,19,16,3,1
SBI79DSG4497802,75,27,18,9,1
SBI11WEL3749376,74,30,16,14,1
SBI27AGD7102701,23,22,13,9,1
SBI07FJN8417370,95,31,17,14,1
SBI54YOK4633023,95,23,14,9,1
SBI40AXL2358614,99,23,13,10,1
SBI26MVB3941620,73,20,15,5,1
SBI63JPV1577352,60,24,23,1,1
SBI64KVI5681806,20,27,19,8,1
SBI56TEV6897062,77,21,15,6,1
SBI48KOG3008920,63,32,26,6,1
SBI52PDR0962399,24,16,9,7,1
SBI37DXY8202942,75,20,13,7,1
SBI57YFR9865540,88,21,18,3,1
SBI22WLR0925155,96,26,25,1,1
SBI39NRB3479489,69,21,18,3,1
SBI65QFS5247780,77,23,14,9,1
SBI10GUF5898623,67,24,13,11,1
SBI92CGQ4091130,75,25,21,4,1
SBI51XRH8866968,72,24,14,10,1
SBI40WBF9102253,22,27,14,13,1
SBI21OQP7414433,82,21,15,6,1
SBI58QBE1047707,76,26,21,5,1
SBI30VHP9993373,68,27,19,8,1
SBI99EOD2579263,66,31,16,15,1
SBI75KND1224961,20,37,24,13,1
SBI03BPD7181089,98,29,18,11,1
SBI61WKS2428272,62,30,18,12,1
SBI62MCH3031662,77,23,14,9,1
SBI83MKV1460860,73,28,24,4,1
SBI45VWQ3955568,63,19,17,2,1
SBI62OQD8964289,69,16,11,5,1
SBI58XZB7106082,83,22,15,7,1
SBI97YVL7295270,65,24,15,9,1
SBI69DHR5987832,81,23,12,11,1
SBI56CSA1403141,22,18,15,3,1
SBI75CBI0351955,92,23,19,4,1
SBI40TFJ8236536,82,15,8,7,1
SBI53QOH6775452,92,18,15,3,1
SBI14AAO7542144,76,28,19,9,1
SBI54NJG9036780,20,19,14,5,1
SBI50GKC3370425,24,23,20,3,1
SBI22DTO8587378,75,27,22,5,1
SBI15CIE1262468,96,23,12,11,1
SBI56YZS3113029,23,22,13,9,1
SBI25GIT6457874,95,19,18,1,1
SBI50DLZ4307897,96,24,17,7,1
SBI62AOG7012608,25,26,22,4,1
SBI35IGC5070359,77,24,13,11,1
SBI55KKM8739387,60,24,17,7,1
SBI24INR0274759,60,27,26,1,1
SBI52UZT2962513,94,23,22,1,1
SBI07RRI8579675,82,28,15,13,1
SBI60GQX9519996,70,23,13,10,1
SBI58FAH7756463,18,23,21,2,1
SBI34KDC9916587,72,30,20,10,1
SBI03EUT2586789,83,24,18,6,1
SBI62RXG7314064,79,37,20,17,1
SBI20WCC5797743,75,22,13,9,1
SBI63PLP2524690,87,29,28,1,1
SBI94RKX9933745,64,24,14,10,1
SBI69QYR0459368,98,30,27,3,1
SBI54QZQ5890738,24,16,14,2,1
SBI30PIU1135379,95,21,17,4,1
SBI38ZPL7441784,98,21,16,5,1
SBI63QYP9269212,91,24,21,3,1
SBI75YFH3200259,99,22,17,5,1
SBI92MNW4932359,21,25,14,11,1
SBI47DUF3016294,83,19,15,4,1
SBI18BCQ4500114,72,14,11,3,1
SBI17KNN3837504,20,21,17,4,1
SBI48ENB7241415,69,23,13,10,1
SBI66QBO2970952,60,29,28,1,1
SBI11YZO2356876,85,30,24,6,1
SBI34FOJ4469121,97,19,17,2,1
SBI85MPR1089398,61,21,11,10,1
SBI59QNK9637195,97,27,17,10,1
SBI06KAZ1500670,99,18,17,1,1
SBI23PDZ5733012,76,36,25,11,1
SBI03GWW2284920,99,29,20,9,1
SBI03KXC1647933,70,35,32,3,1
SBI03FCN5285330,82,29,25,4,1
SBI80BEK9661878,63,21,16,5,1
SBI13WRE5036682,24,26,18,8,1
SBI29FMB0590182,62,35,18,17,1
SBI06MLG4225287,24,24,21,3,1
SBI38RWJ7498459,69,22,14,8,1
SBI58YBN8222381,87,13,7,6,1
SBI61FCI9160241,84,18,16,2,1
SBI72ZBK0077154,20,19,18,1,1
SBI61CAY6007859,75,16,11,5,1
SBI39DII0207765,84,21,11,10,1
SBI20RUO0619562,71,28,17,11,1
SBI37XJB4186065,97,31,28,3,1
SBI06NTE5112472,20,21,16,5,1
SBI47ULR7686072,22,28,21,7,1
SBI92MKW2836159,64,30,18,12,1
SBI94AMV6438696,75,23,22,1,1
SBI58GOH6737442,79,27,17,10,1
SBI66OZA3890231,84,23,12,11,1
SBI09XIX1099215,23,23,20,3,1
SBI58ITT4906730,83,22,14,8,1
SBI07KPE7026188,22,25,15,10,1
SBI68ZEV9541697,95,20,14,6,1
SBI78DVX5518457,79,29,18,11,1
SBI58OUB1180230,94,30,16,14,1
SBI47SYL6709223,93,21,13,8,1
SBI91VWV5395956,85,23,12,11,1
SBI27VOC7338417,80,25,22,3,1
SBI93ORJ8028281,77,25,23,2,1
SBI11JNK7741328,68,32,19,13,1
SBI24VPH1026732,91,29,20,9,1
SBI65HDJ4833587,76,27,25,2,1
SBI69OBL6707397,72,32,31,1,1
SBI94NXR9935236,20,20,17,3,1
SBI44NAH0532485,69,22,17,5,1
SBI65KOZ3800389,72,18,13,5,1
SBI56NEV5835659,93,21,14,7,1
SBI22FRF1322159,98,19,15,4,1
SBI33DUT8688803,99,26,21,5,1
SBI65VKD0030348,74,29,23,6,1
SBI03TNX3193879,80,18,14,4,1
SBI65WXP0748992,23,25,23,2,1
SBI40SFJ0625043,94,20,15,5,1
SBI53KPG3864812,60,29,17,12,1
SBI67LUV2593972,82,31,20,11,1
SBI93LAA7760475,67,21,11,10,1
SBI23VIR9163254,68,20,16,4,1
SBI29NYY3327872,60,21,11,10,1
SBI56IMJ9080689,81,28,27,1,1
SBI26OHI1524500,99,30,27,3,1
SBI46ZEC1362483,83,27,25,2,1
SBI90XXR4728601,23,23,16,7,1
SBI40MOH8620453,95,33,30,3,1
SBI12GKA7917675,72,28,25,3,1
SBI25TRX6059942,98,25,18,7,1
SBI61AYP3173559,61,20,12,8,1
SBI41DFF3872296,92,26,19,7,1
SBI61QHX5568269,94,19,15,4,1
SBI67WLM2665054,93,21,16,5,1
SBI57AJW6419784,22,22,12,10,1
SBI81LRD8601114,95,18,14,4,1
SBI64WAC8538739,76,27,19,8,1
SBI05FPS0369626,93,21,19,2,1
SBI63JEP1901691,21,23,20,3,1
SBI66VKA1782167,92,26,19,7,1
SBI43BSF6315981,65,12,7,5,1
SBI84CHX1488012,83,16,13,3,1
SBI29QSY4481958,97,24,17,7,1
SBI39KDI8279396,18,22,15,7,1
SBI68QOL7871592,18,22,18,4,1
SBI85AFP6525606,83,21,13,8,1
SBI98CJV7444933,21,24,13,11,1
SBI60XXF0581827,75,22,13,9,1
SBI74QQP8874141,93,27,14,13,1
SBI76YAO9657190,19,15,13,2,1
SBI41ZRV4603924,71,31,16,15,1
SBI60FMW1992565,75,25,20,5,1
SBI39JQC5462224,64,30,24,6,1
SBI98GAX3050192,91,28,21,7,1
SBI86DXT0961031,86,31,26,5,1
SBI32HFM6112165,86,23,16,7,1
SBI33LKP8566451,19,8,7,1,1
SBI84IRM6584565,24,25,23,2,1
SBI83HUI3095947,97,29,25,4,1
SBI44PHX6468924,75,20,15,5,1
SBI37MIR7240720,99,17,12,5,1
SBI30KAM2385054,18,22,19,3,1
SBI35MQE7814730,24,26,21,5,1
SBI90QOA1011614,90,17,9,8,1
SBI04NRB1828005,67,17,11,6,1
SBI44GCD1459991,69,14,12,2,1
SBI02MRG8214012,85,20,15,5,1
SBI69UBZ9302823,95,28,18,10,1
SBI08QGN2285435,77,27,20,7,1
SBI65YLN3578418,25,29,22,7,1
SBI80MFE1415867,92,21,11,10,1
SBI88SPA7555346,86,26,20,6,1
SBI03EDS7852922,74,32,18,14,1
SBI47ZWE3621747,62,29,20,9,1
SBI64KDN6207373,66,28,24,4,1
SBI54UDC9436790,79,24,16,8,1
SBI99XYW0370895,62,23,20,3,1
SBI30QED6977826,70,23,13,10,1
SBI67TCP7955992,78,30,21,9,1
SBI08TBC1310352,98,32,27,5,1
SBI65XYT5849832,87,28,23,5,1
SBI22CFE0589161,82,20,13,7,1
SBI59DRC6551704,62,22,15,7,1
SBI95SZV0554872,67,21,12,9,1
SBI57SAO6386544,65,21,17,4,1
SBI51JVS2312753,66,24,22,2,1
SBI96HBY2369866,80,23,19,4,1
SBI28ROC5369720,19,23,20,3,1
SBI15APH1532280,85,24,15,9,1
SBI86HCV9697571,77,25,16,9,1
SBI87DTU6534231,66,23,18,5,1
SBI82KFA1938477,97,22,20,2,1
SBI37UCY7002704,70,24,23,1,1
SBI89CYT6176259,75,28,27,1,1
SBI58LRV0283837,67,22,18,4,1
SBI13THJ7101679,81,28,15,13,1
SBI87XOJ1607495,20,23,21,2,1
SBI85INB6362737,78,24,14,10,1
SBI97LAF7959566,68,27,21,6,1
SBI92GAH9305848,60,26,19,7,1
SBI18EGA6744606,81,34,28,6,1
SBI73LVK6589279,81,31,30,1,1
SBI01WBW2879726,77,20,15,5,1
SBI94MAM0111636,91,31,22,9,1
SBI66TLW9298905,68,31,27,4,1
SBI19ORB1698961,96,31,25,6,1
SBI77EIJ3781582,64,24,18,6,1
SBI83YEL7194235,97,34,26,8,1
SBI05VTS1035201,86,28,24,4,1
SBI25PDU8197217,19,25,23,2,1
SBI21GSO7484023,86,23,16,7,1
SBI95NSE0233848,24,24,21,3,1
SBI63SUR6753009,92,30,27,3,1
SBI61JUJ7456154,63,20,17,3,1
SBI71UTF4780944,97,33,28,5,1
SBI16QOR5993825,80,33,30,3,1
SBI04BCA6699906,98,26,24,2,1
SBI84KXC9843623,89,31,25,6,1
SBI04DZZ9373921,71,14,11,3,1
SBI38ELM0582183,22,28,26,2,1
SBI43NKN1686045,99,27,14,13,1
SBI77PCB1570732,99,29,16,13,1
SBI26SET2304676,66,24,13,11,1
SBI39VMM0746609,61,30,16,14,1
SBI34EHS0333956,84,38,20,18,1
SBI84MPD4507656,95,21,13,8,1
SBI31WAV5453171,19,33,23,10,1
SBI27PNB2154679,86,20,12,8,1
SBI47MYZ9625565,92,36,24,12,1
SBI91BGM8083323,94,25,15,10,1
SBI89DKF5595878,80,30,22,8,1
SBI00XHE9471768,67,29,26,3,1
SBI76EJY4502209,23,14,10,4,1
SBI02IBU6422759,85,14,13,1,1
SBI59WIF6287061,21,17,12,5,1
SBI37ZSO4136947,94,29,26,3,1
SBI62SOO0473272,77,19,12,7,1
SBI81NEW6247110,96,24,13,11,1
SBI79JVZ2657079,67,26,17,9,1
SBI60OCW0333541,64,26,20,6,1
SBI33IEH4230814,87,28,15,13,1
SBI11NXX0504556,90,25,15,10,1
SBI90CRS3111836,68,21,20,1,1
SBI63FSO2884266,65,23,20,3,1
SBI01KBU0405906,62,28,24,4,1
SBI68FXD1245928,99,34,21,13,1
SBI50FNK6527226,83,25,22,3,1
SBI37GGO0239065,83,34,23,11,1
SBI74XCG0161653,98,28,19,9,1
SBI35LAK6617551,74,31,28,3,1
SBI05QDI4549478,71,21,18,3,1
SBI69JJY7279084,61,17,16,1,1
SBI82NKY3559691,63,29,15,14,1
SBI31IDP9218486,65,26,16,10,1
SBI87QEB2651794,83,24,21,3,1
SBI76VNM1919747,60,33,30,3,1
SBI63LUG6120052,22,25,19,6,1
SBI50QPS6260099,21,27,16,11,1
SBI48UPS0244004,85,25,14,11,1
SBI95QMA0257379,82,17,16,1,1
SBI06JMK5184414,80,20,13,7,1
SBI35OFG5204215,24,23,13,10,1
SBI79PZQ3807589,71,26,17,9,1
SBI85LQT1869630,77,18,16,2,1
SBI01ORS9320098,92,15,8,7,1
SBI03DIR5610291,67,30,28,2,1
SBI35JKZ9897883,76,22,20,2,1
SBI82ZVW8541781,95,21,14,7,1
SBI23JKC5834073,96,23,12,11,1
SBI86HCE1115640,91,27,14,13,1
SBI75KMU9727121,72,19,10,9,1
SBI46WLT3707115,19,18,15,3,1
SBI78DLL9974805,93,29,27,2,1
SBI49MOG1763421,82,22,17,5,1
SBI29HDU8462509,83,21,17,4,1
SBI83ZDV1138602,61,22,19,3,1
SBI62WTJ2643338,90,15,10,5,1
SBI64INV8629361,95,22,21,1,1
SBI53NJG2316799,80,27,18,9,1
SBI92SEK1633974,86,24,21,3,1
SBI61CNN3444460,71,19,18,1,1
SBI74XZZ1723413,78,31,16,15,1
SBI79AVS8441887,63,22,13,9,1
SBI49HZU3961699,78,26,18,8,1
SBI36UPK9638191,99,18,10,8,1
SBI57AZG9160001,24,19,17,2,1
SBI25QWN5641150,66,29,15,14,1
SBI06XHG8258276,97,31,27,4,1
SBI15YIY5143674,24,29,22,7,1
SBI29AXI0961867,81,23,16,7,1
SBI15KSW5856654,88,28,18,10,1
SBI21ULD0431076,73,24,17,7,1
SBI11KHY9870463,71,26,22,4,1
SBI98GKC9397428,87,21,18,3,1
SBI46IOA0321393,96,23,17,6,1
SBI44TDT2609728,87,35,23,12,1
SBI29YYO5526088,97,25,18,7,1
SBI04VOZ6818262,82,30,16,14,1
SBI15HQU1181774,87,27,26,1,1
SBI09FYJ7474227,71,30,20,10,1
SBI38MXG4394485,21,27,19,8,1
SBI73OYZ0727263,62,32,28,4,1
SBI33FSA0186376,65,25,15,10,1
SBI96FYA7510924,82,23,20,3,1
SBI53QYT9501953,18,21,16,5,1
SBI05GHH6608072,79,28,23,5,1
SBI78UPR6690634,20,20,15,5,1
SBI28OUG5840796,90,23,13,10,1
SBI77UMB3627593,74,31,20,11,1
SBI87HSN0620618,79,22,21,1,1
SBI63CPP2515998,63,25,20,5,1
SBI35MNY2914995,90,29,21,8,1
SBI05HGQ4917999,92,20,15,5,1
SBI04XES5618414,94,20,13,7,1
SBI91FWD5142197,63,21,11,10,1
SBI53ZGO5057316,71,17,12,5,1
SBI87HZB7687973,85,25,20,5,1
SBI99NOO2202963,70,22,20,2,1
SBI71NTF7127280,25,33,17,16,1
SBI62PGH1363504,22,19,12,7,1
SBI07SEY6426616,92,28,15,13,1
SBI36MDE5907533,99,21,15,6,1
SBI16PSW8183028,22,23,21,2,1
SBI34HTL2606337,70,18,10,8,1
SBI27OVB0702438,66,24,21,3,1
SBI25IGL1545742,25,30,21,9,1
SBI54IKB2697993,66,27,23,4,1
SBI74NBA0056274,20,27,22,5,1
SBI43IQJ8119222,62,20,16,4,1
SBI40LSF1519461,20,21,12,9,1
SBI67ZNE0518075,91,19,12,7,1
SBI85AKE6777413,82,22,14,8,1
SBI40BYK9952871,83,29,21,8,1
SBI31LSS6435499,68,30,27,3,1
SBI45ANI6101085,61,19,11,8,1
SBI61LIR6349837,91,16,9,7,1
SBI22SPI6462155,80,21,13,8,1
SBI86KBR8260967,81,13,10,3,1
SBI43YZL4401777,77,28,22,6,1
SBI95YYE5384002,75,28,25,3,1
SBI18QCW8577811,90,27,26,1,1
SBI96XQK8416323,20,18,14,4,1
SBI47YLJ6765683,97,28,26,2,1
SBI83QCD6530218,85,17,11,6,1
SBI39CVD4765322,93,20,14,6,1
SBI07QCI2939667,98,37,25,12,1
SBI47UPR9759832,62,22,17,5,1
SBI82ZGR4313884,18,15,12,3,1
SBI63IXW8576766,60,23,16,7,1
SBI76OTB1981724,81,23,13,10,1
SBI12YYC9146250,93,31,30,1,1
SBI65BVC6042864,68,27,20,7,1
SBI48RZJ0353023,67,37,27,10,1
SBI31VJC5018021,63,18,14,4,1
SBI70KTW2751964,68,26,17,9,1
SBI85VHA9768979,23,34,29,5,1
SBI20IEW9672373,70,28,27,1,1
SBI64PRL7789070,81,27,23,4,1
SBI93QZX1116856,69,34,19,15,1
SBI89IGR6497526,77,36,20,16,1
SBI88QMD3857749,86,30,26,4,1
SBI74ZMR2857855,61,34,21,13,1
SBI53PMG0006167,20,29,18,11,1
SBI20JSP4868553,68,25,24,1,1
SBI62TPH8417864,99,24,14,10,1
SBI10FIN2480113,21,22,12,10,1
SBI41VBM5422326,74,29,16,13,1
SBI68MWH4452710,97,21,15,6,1
SBI43CKX0548482,91,31,19,12,1
SBI87PTH3712068,87,26,20,6,1
SBI92BVD7186900,91,26,23,3,1
SBI71HIP0025699,98,19,14,5,1
SBI39MLY9406448,18,21,13,8,1
SBI42SOU1029930,80,24,22,2,1
SBI17ABC6975703,61,25,18,7,1
SBI34AOR5964448,63,28,17,11,1
SBI03GXL4137722,92,30,20,10,1
SBI67OMP9986526,62,36,23,13,1
SBI52HFF9399084,76,28,25,3,1
SBI52JZE9109780,64,26,17,9,1
SBI43PGB6444810,71,28,26,2,1
SBI00KNU7145134,90,27,24,3,1
SBI15BOW8034551,98,24,13,11,1
SBI42SMH6962270,82,21,16,5,1
SBI43RVX3015833,61,26,16,10,1
SBI85VFH5303889,82,28,17,11,1
SBI61LMO3601605,67,31,16,15,1
SBI85QAQ6565776,71,17,14,3,1
SBI48HBQ0364904,20,29,19,10,1
SBI87GBI2549010,86,18,16,2,1
SBI11ORL3322018,65,26,15,11,1
SBI09NMY7844844,84,19,15,4,1
SBI08ISE8965594,70,32,24,8,1
SBI55OAL0290427,89,28,26,2,1
SBI21FHY7044668,76,14,9,5,1
SBI84ZIM6017942,25,18,16,2,1
SBI04LMV7733035,81,25,15,10,1
SBI83TML4508466,71,20,19,1,1
SBI54KIY5784986,69,21,16,5,1
SBI88PWH3982969,21,21,16,5,1
SBI56DJA0293387,73,19,17,2,1
SBI28VHF6860048,92,28,26,2,1
SBI63RFI9394453,93,31,21,10,1
SBI42MDG1993589,81,17,15,2,1
SBI95EMK2405331,72,22,12,10,1
SBI57TQQ3709678,69,27,26,1,1
SBI67ASX2412551,62,25,22,3,1
SBI33YMN0761843,98,22,21,1,1
SBI74HBX4860847,70,30,18,12,1
SBI30CNT4765983,65,33,30,3,1
SBI41ZRO2712271,24,28,17,11,1
SBI93WRL6823140,20,24,15,9,1
SBI64ROD8701849,74,28,17,11,1
SBI14HQP2341762,22,19,16,3,1
SBI30AOC9444216,93,32,29,3,1
SBI57VGM4318843,21,30,29,1,1
SBI78KHO6820052,97,20,15,5,1
SBI93QQV1983787,92,24,20,4,1
SBI03CDK5869970,98,23,15,8,1
SBI30VCH1802987,92,23,22,1,1
SBI52TOS3470226,91,30,17,13,1
SBI71URB2416959,77,27,18,9,1
SBI46GSV6768851,83,33,21,12,1
SBI25XZB2872376,76,27,18,9,1
SBI73LLC3189387,63,23,18,5,1
SBI03SAX3520919,79,28,17,11,1
SBI80EWK2728754,80,24,21,3,1
SBI11GYW7001808,87,26,19,7,1
SBI86CZY2684551,21,23,15,8,1
SBI55UMN0254384,19,28,25,3,1
SBI79MNI9663104,84,19,11,8,1
SBI93OKJ0518273,62,30,19,11,1
SBI95SVS8873711,64,16,9,7,1
SBI33LWH9712979,87,34,31,3,1
SBI44GVX5795467,75,27,21,6,1
SBI17NOH4125553,20,25,22,3,1
SBI79FTH2820509,83,25,13,12,1
SBI59WGY1640641,80,22,15,7,1
SBI94YZP4879948,64,22,16,6,1
SBI73AEG1943049,61,22,17,5,1
SBI30OJQ7387772,66,23,14,9,1
SBI94MCE0644939,96,23,13,10,1
SBI82IYU0860955,79,32,25,7,1
SBI91RIF5056618,95,26,24,2,1
SBI93RWL2952780,92,26,15,11,1
SBI81QTB5257730,60,28,26,2,1
SBI13IAO3564856,25,27,20,7,1
SBI49IMH4193814,25,20,16,4,1
SBI50VGZ8648854,60,24,21,3,1
SBI61VES6879266,82,24,20,4,1
SBI05XEO3913045,66,32,24,8,1
SBI09UPT1914574,66,21,16,5,1
SBI91KNX8076075,75,12,8,4,1
SBI15QIC9571208,87,21,14,7,1
SBI88YHU6643141,20,18,10,8,1
SBI89DEU3759074,25,25,20,5,1
SBI54VYR1366346,92,23,16,7,1
SBI02STL1590432,78,18,14,4,1
SBI86PVV3890963,94,25,15,10,1
SBI16PVZ2052522,91,23,14,9,1
SBI73HMB5649286,89,29,24,5,1
SBI18UVZ1123026,24,26,24,2,1
SBI78NWG8636126,77,28,22,6,1
SBI87ELW8624186,76,19,11,8,1
SBI07BEP6364807,72,18,12,6,1
SBI27WXC8146207,80,22,19,3,1
SBI86VAZ3011535,96,29,24,5,1
SBI48IYO7400917,18,17,12,5,1
SBI45RVN3891407,76,32,27,5,1
SBI65YGE5948064,66,14,9,5,1
SBI82UDG4402148,62,31,23,8,1
SBI53XMG8518274,62,25,19,6,1
SBI41XYK1841831,25,26,20,6,1
SBI77UFZ1520587,82,17,9,8,1
SBI69HRK2032360,68,22,12,10,1
SBI60FPG9076759,80,24,18,6,1
SBI25RLM2498268,85,25,13,12,1
SBI33CCV4681281,73,23,12,11,1
SBI95BDC3789345,79,16,9,7,1
SBI22VAV2041353,69,32,31,1,1
SBI49KEN9460012,85,24,13,11,1
SBI72WVZ3620344,71,32,25,7,1
SBI74JBH5993739,85,22,16,6,1
SBI68KIZ6223623,89,29,27,2,1
SBI68ASZ4944875,75,29,15,14,1
SBI67CWC6435576,22,28,25,3,1
SBI20VRK4608377,99,27,26,1,1
SBI89KPI0268677,72,26,20,6,1
SBI16ODB8788353,62,32,29,3,1
SBI52EAC1536071,92,24,16,8,1
SBI98KGB3372097,87,24,22,2,1
SBI35ZNZ3162204,77,26,15,11,1
SBI85ISD9445278,18,21,16,5,1
SBI66KSP1291260,62,19,14,5,1
SBI31IRL7751790,97,17,12,5,1
SBI63TCC6606502,72,20,12,8,1
SBI03ROG7524281,75,17,16,1,1
SBI25KAB6602895,92,22,18,4,1
SBI17ZRB0219857,61,31,17,14,1
SBI36DOK3773598,23,28,21,7,1
SBI29CSD7102620,84,11,6,5,1
SBI08ZNY2083572,19,27,15,12,1
SBI74UWI5634953,88,34,25,9,1
SBI73RAB9498171,62,22,21,1,1
SBI46WMS0006188,64,22,20,2,1
SBI54FWL5526911,18,25,13,12,1
SBI70SEA1737559,92,28,26,2,1
SBI71OPM9721829,91,22,18,4,1
SBI13MPS2469040,81,12,10,2,1
SBI12KAG1449821,81,21,16,5,1
SBI94NWE6672983,22,21,18,3,1
SBI17BWF9064709,74,23,13,10,1
SBI09AZY1220118,24,20,18,2,1
SBI33JCN6423809,87,14,9,5,1
SBI66QUC4411508,76,26,23,3,1
SBI69VPY9403744,75,20,11,9,1
SBI54MDA3041278,61,24,17,7,1
SBI05JBA0904995,23,26,25,1,1
SBI79PDI5401749,18,24,21,3,1
SBI91DKW3645738,92,25,24,1,1
SBI26KIC8963599,25,23,14,9,1
SBI02GFN9041069,69,32,31,1,1
SBI39WUM4467506,79,23,15,8,1
SBI02RHE9506185,81,33,20,13,1
SBI81GQE9674782,60,27,21,6,1
SBI35QNY3512532,99,41,36,5,1
SBI96MEX4169523,90,28,15,13,1
SBI32JNS8178729,22,25,20,5,1
SBI64SZK4347848,22,24,17,7,1
SBI84BYT6692143,81,13,11,2,1
SBI04YTA2872786,60,29,15,14,1
SBI14VWC1467661,90,17,16,1,1
SBI93DMM2798938,86,29,22,7,1
SBI78NWZ7418661,24,21,14,7,1
SBI26FAN2224848,95,27,15,12,1
SBI37TPE3797575,25,26,21,5,1
SBI18CHA5092024,70,23,16,7,1
SBI61WUY9868317,89,29,21,8,1
SBI24YFS9453853,88,27,20,7,1
SBI43ZPF7371245,64,21,16,5,1
SBI84IIK6070896,98,38,26,12,1
SBI34OZW8571575,74,24,19,5,1
SBI56FWM0198093,24,21,16,5,1
SBI33SXJ5304396,75,28,24,4,1
SBI32XQJ6460160,25,13,11,2,1
SBI19LCR0220310,63,23,20,3,1
SBI33ZAR5904554,86,28,26,2,1
SBI66TLD8766333,98,23,19,4,1
SBI35KKP5023893,69,28,26,2,1
SBI89NAS9692833,62,30,19,11,1
SBI21HKW4474900,86,29,15,14,1
SBI32JJL7161954,84,22,19,3,1
SBI07FNI4376277,75,24,17,7,1
SBI39UYG6364855,78,22,15,7,1
SBI57BPC7628416,75,18,17,1,1
SBI94THS9744906,79,24,17,7,1
SBI24QMC3814491,89,25,16,9,1
SBI90JRK3182474,91,24,16,8,1
SBI92LMN2000634,24,25,19,6,1
SBI67RTU5844902,99,19,16,3,1
SBI53LEB8393152,60,24,23,1,1
SBI65IYJ4254809,19,32,26,6,1
SBI37XPW0614450,83,21,15,6,1
SBI89FBM2112383,61,31,30,1,1
SBI28GBC5243971,95,24,18,6,1
SBI50VYM3940046,22,21,18,3,1
SBI60OSC8315347,98,30,28,2,1
SBI92WPY9135078,74,23,22,1,1
SBI86CPK7418610,81,23,13,10,1
SBI91MWS7507383,93,35,33,2,1
SBI82JMH1236246,83,21,17,4,1
SBI73HHO0842147,94,29,22,7,1
SBI49PNQ7483755,81,23,15,8,1
SBI70VKP3296352,71,25,17,8,1
SBI02OML6195112,62,28,17,11,1
SBI21MPD8178522,65,24,23,1,1
SBI04MVV6049477,72,25,19,6,1
SBI94YHX2228809,61,21,11,10,1
SBI57IDU8390679,79,34,19,15,1
SBI17QRA3037689,81,29,27,2,1
SBI25GNH2452632,66,13,9,4,1
SBI11URY1437310,86,32,20,12,1
SBI19KYJ7046463,64,26,25,1,1
SBI03DYH3689178,98,25,23,2,1
SBI37KPZ6157037,73,22,17,5,1
SBI11VXR9506383,88,31,21,10,1
SBI91JSW6807127,86,29,18,11,1
SBI09NGA5261694,79,28,24,4,1
SBI32MWI5989350,77,15,13,2,1
SBI36ZLE1273519,21,24,19,5,1
SBI69VFE5282263,80,20,13,7,1
SBI73PEZ5085600,63,18,15,3,1
SBI77WZZ9822410,18,20,11,9,1
SBI33ACM5408553,76,25,24,1,1
SBI88HJU0659272,97,28,20,8,1
SBI57MZD6082182,78,28,17,11,1
SBI09HNA8353055,22,11,6,5,1
SBI18QDF8876071,67,17,16,1,1
SBI14FTQ5712472,60,25,19,6,1
SBI48JFT0078898,25,29,28,1,1
SBI34EPT4069079,24,26,15,11,1
SBI20NED3452823,86,22,21,1,1
SBI15PYX9620719,69,25,22,3,1
SBI30DGB3385171,19,20,18,2,1
SBI59FTN3650073,95,25,13,12,1
SBI69HVT8368867,96,20,16,4,1
SBI43RHQ3228042,63,17,12,5,1
SBI18ACE9733655,97,15,13,2,1
SBI64OIF6319963,60,28,15,13,1
SBI05UGC9385276,18,18,16,2,1
SBI65SJR9938374,21,23,21,2,1
SBI43BLY2341720,97,28,20,8,1
SBI96UYV9484877,83,31,28,3,1
SBI05GBX8556477,21,28,22,6,1
SBI07ACN9865015,68,34,32,2,1
SBI18TSI9520443,94,30,18,12,1
SBI59BSA6776286,92,17,11,6,1
SBI14VPT2950484,84,32,17,15,1
SBI28VXF0299820,94,32,28,4,1
SBI25SRP5722528,70,20,16,4,1
SBI57DJS6559234,68,24,15,9,1
SBI72AOE0074482,63,23,17,6,1
SBI70EGR4587067,61,28,20,8,1
SBI94BGP9421229,83,23,12,11,1
SBI00KPP8090038,84,18,13,5,1
SBI65EJU3015985,67,29,27,2,1
SBI11WIK2833934,20,27,15,12,1
SBI77ISI5484330,83,32,20,12,1
SBI60ZOK0271341,95,25,20,5,1
SBI66FRN0512061,70,21,19,2,1
SBI82PLY4322882,23,29,19,10,1
SBI38BXP2889010,73,18,16,2,1
SBI45SGR5296474,66,29,22,7,1
SBI21ODQ4072658,20,32,20,12,1
SBI47PJO9469019,82,18,11,7,1
SBI38FDS4789772,22,19,16,3,1
SBI33MFI4234520,78,23,19,4,1
SBI45TUF5783123,77,23,22,1,1
SBI50RZP5646032,65,23,19,4,1
SBI00TYN1371284,22,28,22,6,1
SBI51ZKA9562447,92,21,13,8,1
SBI82ZCW3306666,71,23,19,4,1
SBI22UBE4311006,97,25,16,9,1
SBI75CBR3769706,66,24,14,10,1
SBI94RZN1592790,74,24,22,2,1
SBI30EZQ9798321,90,23,21,2,1
SBI52CLO2551314,76,30,23,7,1
SBI85QZZ1308336,89,22,20,2,1
SBI11ELQ4816842,80,32,23,9,1
SBI78RXJ5373142,64,18,10,8,1
SBI33HKJ6117793,86,18,15,3,1
SBI58FKT4874639,19,28,19,9,1
SBI31IRR5999415,93,22,20,2,1
SBI27STJ3902055,62,28,27,1,1
SBI71ZDQ7958741,77,23,12,11,1
SBI11JCH9312740,89,29,26,3,1
SBI32EEA5337487,90,26,20,6,1
SBI30QRO2404499,81,23,14,9,1
SBI51RDG0909034,99,27,15,12,1
SBI27YDI1793487,61,24,14,10,1
SBI28IYR1178457,93,15,10,5,1
SBI53GMF3033404,67,24,17,7,1
SBI52LMH9672313,95,28,19,9,1
SBI96WIW2471370,64,23,14,9,1
SBI54JXJ0527341,92,21,15,6,1
SBI55GJO0618104,86,26,14,12,1
SBI32BSD8389906,64,24,14,10,1
SBI24SFM9974729,97,10,9,1,1
SBI85IJV2125924,62,24,23,1,1
SBI63KKO2559711,20,33,29,4,1
SBI72DYJ1329025,83,20,14,6,1
SBI94ACH8671015,73,29,23,6,1
SBI99FTV0373695,96,27,14,13,1
SBI93EBX6494256,89,27,22,5,1
SBI93IWG7554546,69,21,14,7,1
SBI04RLH2251927,73,20,15,5,1
SBI91WQL5529274,22,30,27,3,1
SBI29RTS7677788,95,24,17,7,1
SBI54OPT0723937,92,20,16,4,1
SBI80DAO6227253,85,30,25,5,1
SBI35SZO8304635,86,21,13,8,1
SBI96GKY9991721,19,24,21,3,1
SBI02YYW6841188,97,29,22,7,1
SBI93HMV1426946,88,25,23,2,1
SBI50SMS2358831,63,22,13,9,1
SBI59ODN4457196,72,23,16,7,1
SBI82ISV7755405,96,28,22,6,1
SBI06NGM7219582,19,29,21,8,1
SBI04NNH9523047,21,32,21,11,1
SBI00YEQ1866869,64,15,12,3,1
SBI73LIN3697736,62,30,27,3,1
SBI63JGY3284236,82,20,18,2,1
SBI01PVO6222633,24,30,25,5,1
SBI67IZR8082928,68,19,15,4,1
SBI06UHV7124048,86,25,13,12,1
SBI49UEC3044706,70,23,16,7,1
SBI81YQA7268966,73,20,12,8,1
SBI35XZZ8809623,98,28,23,5,1
SBI98KND4089515,80,27,23,4,1
SBI82OHI1452906,99,24,19,5,1
SBI76TRT5644212,64,28,27,1,1
SBI63INI1752008,95,24,18,6,1
SBI21QZV1365122,91,33,22,11,1
SBI00ZAT7159668,83,29,19,10,1
SBI03ZYP3377680,18,27,25,2,1
SBI02ODO6567065,65,37,22,15,1
SBI80VCM6427085,88,29,21,8,1
SBI25AYZ7003220,70,20,16,4,1
SBI08LTU7452413,68,29,26,3,1
SBI36IQR5192499,74,25,16,9,1
SBI03IPQ9224914,99,23,18,5,1
SBI93IBG1429473,72,24,18,6,1
SBI93HID0681384,63,24,16,8,1
SBI82CJR3105717,62,31,20,11,1
SBI54SVQ5838284,64,28,26,2,1
SBI25ORN4106034,76,27,18,9,1
SBI82CHM2600589,96,24,14,10,1
SBI07CDQ1524976,96,34,20,14,1
SBI52SFU1267823,78,26,21,5,1
SBI77EFV5163711,76,32,28,4,1
SBI81JOI7616761,25,18,17,1,1
SBI31QZR2931186,66,32,24,8,1
SBI27LGF2911171,87,20,14,6,1
SBI84OYM3027180,97,26,15,11,1
SBI18BSL1101689,89,23,14,9,1
SBI12SRK5291884,78,23,20,3,1
SBI46IQF5792676,87,22,13,9,1
SBI67FIE4583825,61,15,9,6,1
SBI03UOL7179829,86,32,25,7,1
SBI53IBD0503373,94,27,17,10,1
SBI25DUA1952221,73,20,13,7,1
SBI84OPF9991860,74,19,11,8,1
SBI37CRB9560411,98,17,14,3,1
SBI03XZR9514178,91,18,15,3,1
SBI20UCL2316394,82,25,19,6,1
SBI93JCE4106576,70,22,13,9,1
SBI00LNO8011720,84,37,22,15,1
SBI83GIP0093945,87,17,9,8,1
SBI02PKA4873491,92,23,21,2,1
SBI23BWQ9782887,65,17,11,6,1
SBI28CEL6405688,85,26,25,1,1
SBI55TKU6366832,21,29,15,14,1
SBI74MWR4688384,78,24,13,11,1
SBI11PIG3101569,94,22,13,9,1
SBI21CBN0440858,75,24,14,10,1
SBI01UBB0008712,22,27,14,13,1
SBI46KHH0457556,19,25,13,12,1
SBI34ZRV6054703,90,28,19,9,1
SBI57HND5302224,98,25,17,8,1
SBI38KKD2961315,24,22,21,1,1
SBI61CZX3534532,22,20,17,3,1
SBI73XZS9589472,83,23,22,1,1
SBI77AJG5178189,95,23,21,2,1
SBI71VUK9553362,98,26,23,3,1
SBI65AHB5359657,60,26,20,6,1
SBI37TOU6745835,81,25,14,11,1
SBI18GHY2205120,81,26,16,10,1
SBI91XOF2337686,61,19,12,7,1
SBI25TVW9764083,77,25,16,9,1
SBI01OYV0924713,76,26,20,6,1
SBI60EFB8470953,21,29,15,14,1
SBI56SXK9872150,84,33,26,7,1
SBI32DJE0504388,73,34,30,4,1
SBI79KMU6188491,81,23,22,1,1
SBI87CKF1545166,93,24,16,8,1
SBI80RUO8952061,78,21,20,1,1
SBI56FXZ4177537,74,29,27,2,1
SBI23BNN1212995,67,17,9,8,1
SBI36EIJ3045008,81,32,21,11,1
SBI13JCI5430150,89,24,14,10,1
SBI16BHI8705243,65,19,11,8,1
SBI89FGK2313850,97,27,21,6,1
SBI92ISL7466059,95,23,19,4,1
SBI61KNE0729769,92,22,17,5,1
SBI33LAF1064077,71,14,13,1,1
SBI97DSJ0460006,88,29,18,11,1
SBI90LZC6075053,76,23,15,8,1
SBI06UBK1027422,23,25,14,11,1
SBI17LZA0136254,80,29,28,1,1
SBI48ULC4347440,94,21,20,1,1
SBI05XDR7533982,91,19,12,7,1
SBI72BXS2151020,71,23,12,11,1
SBI12WSK4331357,88,26,16,10,1
SBI16ITE3111372,96,28,22,6,1
SBI14WDI4609261,70,30,20,10,1
SBI46MKE5016974,67,23,13,10,1
SBI90RPO2736844,88,26,20,6,1
SBI93CXP4174634,72,23,15,8,1
SBI49VRD3940157,19,30,20,10,1
SBI74TME5552419,79,23,13,10,1
SBI69NST2469575,77,28,27,1,1
SBI66ADI4996439,92,25,18,7,1
SBI98GJL9122858,82,18,11,7,1
SBI90VET7638601,67,29,28,1,1
SBI21GYI6281537,91,25,15,10,1
SBI01ANO9368454,69,26,16,10,1
SBI12PVV2976039,75,19,16,3,1
SBI62OBM1393761,99,26,23,3,1
SBI64OZQ3983568,18,25,14,11,1
SBI43BFB3967861,72,28,19,9,1
SBI98WOA9756120,72,20,17,3,1
SBI89XDB6906569,65,28,20,8,1
SBI16JVZ9914645,98,27,17,10,1
SBI52WPK2104584,98,21,18,3,1
SBI57GQT1155015,75,22,18,4,1
SBI63BQW4773449,74,22,16,6,1
SBI78NNI4850807,75,23,21,2,1
SBI68DFQ9699523,61,19,12,7,1
SBI96KCR1509249,24,18,13,5,1
SBI29YMY2445670,76,25,14,11,1
SBI14TEE3651885,79,20,16,4,1
SBI75WZW8357178,91,21,13,8,1
SBI61ZMP2719790,92,19,16,3,1
SBI73WLV9638620,60,26,17,9,1
SBI89ENP2452302,73,25,15,10,1
SBI92QYL8304248,62,24,14,10,1
SBI30EMM2807697,90,29,27,2,1
SBI04LJQ2446258,60,18,10,8,1
SBI05PZG5733385,83,21,18,3,1
SBI15MQN2191363,22,23,18,5,1
SBI02VKL8074131,77,27,15,12,1
SBI93NZX1741421,95,19,14,5,1
SBI11PTS4058344,61,24,21,3,1
SBI41TNQ8604578,75,27,25,2,1
SBI66PZK4339765,72,24,18,6,1
SBI86MDN5078954,92,37,34,3,1
SBI61EKD4469312,74,17,15,2,1
SBI85TVK1490272,90,23,21,2,1
SBI54KRF2818653,18,31,17,14,1
SBI66UPQ8930570,85,17,13,4,1
SBI80NQX2039468,78,32,17,15,1
SBI74ZHT1725910,85,27,22,5,1
SBI21TZE6004397,87,21,16,5,1
SBI78MOF3786190,24,24,21,3,1
SBI93XVM2674374,94,32,18,14,1
SBI94VYJ0350273,90,31,23,8,1
SBI61KPB5713332,23,21,13,8,1
SBI84WDK0816526,92,13,12,1,1
SBI27AYT4408911,65,24,20,4,1
SBI52WPJ5318157,72,24,22,2,1
SBI43SZJ7538825,19,31,30,1,1
SBI14ZOU3356900,19,24,16,8,1
SBI41EQC9417688,84,24,18,6,1
SBI58IAL5139601,90,26,19,7,1
SBI53LNK8169011,82,21,11,10,1
SBI85NSK2933932,83,17,16,1,1
SBI48MYL4074488,99,10,6,4,1
SBI82UOV7236587,60,23,22,1,1
SBI11XLJ8207989,74,20,15,5,1
SBI17RCS6577553,74,23,12,11,1
SBI21UMK9069674,78,28,23,5,1
SBI43BUB2216138,79,23,18,5,1
SBI12YZP4698957,98,31,23,8,1
SBI43MSM7544436,93,30,19,11,1
SBI13ZEP3287568,86,21,18,3,1
SBI65UPX6107791,84,27,26,1,1
SBI18OXE4567047,22,29,28,1,1
SBI86WQR6074835,79,28,15,13,1
SBI11DHO0985753,83,22,18,4,1
SBI99KZW8241020,84,22,13,9,1
SBI57TDM1518402,23,28,26,2,1
SBI80CYB3000960,87,24,22,2,1
SBI22ISA4636608,60,28,19,9,1
SBI39BKQ8170511,80,29,24,5,1
SBI96SYB6456651,82,24,19,5,1
SBI86XCV5122433,94,37,27,10,1
SBI94ILF4525504,92,27,21,6,1
SBI82ZXX8423819,81,24,14,10,1
SBI18LED3511572,63,19,11,8,1
SBI56OLY9286816,65,29,23,6,1
SBI53ENV4991700,22,28,22,6,1
SBI09KGZ8739593,84,10,7,3,1
SBI85KHU9760221,24,25,19,6,1
SBI61OGR3610200,76,17,15,2,1
SBI59KLA2511746,95,24,21,3,1
SBI94GIL4505734,81,29,28,1,1
SBI11UKG7140066,66,33,26,7,1
SBI97CHJ6435807,90,28,19,9,1
SBI70YQR1643727,84,22,19,3,1
SBI31LIB8421894,23,23,17,6,1
SBI74AYR2663623,71,25,14,11,1
SBI86XBN8662217,76,19,13,6,1
SBI74EGS7528945,63,30,26,4,1
SBI11SGL4719681,65,26,22,4,1
SBI75JRI4881340,88,19,16,3,1
SBI33TVF3327586,80,30,27,3,1
SBI52EXQ4835372,65,20,18,2,1
SBI91CJZ0905310,60,29,17,12,1
SBI82DTS6598894,89,24,14,10,1
SBI85MLV3140083,71,19,10,9,1
SBI52GVL9263450,18,18,11,7,1
SBI22PZG4506724,65,24,18,6,1
SBI31KSS3708497,83,21,12,9,1
SBI69FMB9791162,81,31,29,2,1
SBI80BJR4632309,64,22,15,7,1
SBI53SWC3581247,22,15,13,2,1
SBI68RDO7230120,23,41,26,15,1
SBI15JDP6460870,22,19,15,4,1
SBI03MDZ0907225,63,30,22,8,1
SBI31RMR0607537,77,23,19,4,1
SBI61FMX1592703,87,29,25,4,1
SBI79LFV5472575,93,19,11,8,1
SBI09DZI7625391,62,16,11,5,1
SBI56TYS6312973,88,31,28,3,1
SBI34NEB5489074,70,18,14,4,1
SBI29GZB6149263,70,26,17,9,1
SBI37RXN7070312,96,21,16,5,1
SBI61HFF0945776,23,28,25,3,1
SBI55BZB8942364,97,22,15,7,1
SBI32NNP9526005,99,16,10,6,1
SBI23EPA6742859,63,29,22,7,1
SBI74YOW1893728,21,21,19,2,1
SBI11VTX5179061,68,27,26,1,1
SBI92GEE1973184,82,20,18,2,1
SBI65VDK6770704,74,19,14,5,1
SBI06ALM5862115,72,27,22,5,1
SBI45WJQ9970133,89,23,16,7,1
SBI62EPS9408331,82,29,23,6,1
SBI36FXC4070811,61,22,18,4,1
SBI27VGE7187404,67,13,9,4,1
SBI71HZT5306387,97,23,19,4,1
SBI45BMI7319644,94,25,18,7,1
SBI87LVA3686834,81,20,16,4,1
SBI50JQC8056237,84,34,22,12,1
SBI86IBK2253593,65,25,20,5,1
SBI33MBW5486226,77,27,21,6,1
SBI66LKE8021397,85,21,18,3,1
SBI30TQA5735194,89,22,12,10,1
SBI50BKL7256946,88,30,29,1,1
SBI70LYU4397281,19,29,21,8,1
SBI41DIL7319188,99,21,16,5,1
SBI01VIT4545860,19,27,19,8,1
SBI97YOO8662765,98,36,35,1,1
SBI51TUU8211817,23,23,15,8,1
SBI09BGL5051855,64,22,20,2,1
SBI70RMZ1278324,65,28,16,12,1
SBI20ASM2421190,63,24,22,2,1
SBI65CHF8870876,89,28,20,8,1
SBI72QTM0788547,88,26,23,3,1
SBI84RJR9842862,84,32,19,13,1
SBI40UUV8094375,84,19,12,7,1
SBI25RKZ9465516,66,29,16,13,1
SBI86AZK1099834,63,33,26,7,1
SBI55KEO8176789,95,26,15,11,1
SBI37UDE0197407,63,22,18,4,1
SBI32CDQ8775866,97,20,18,2,1
SBI59NKI6448621,90,27,25,2,1
SBI71SDE1174317,19,32,22,10,1
SBI96OXM0835166,88,25,18,7,1
SBI92QPT9528422,60,26,22,4,1
SBI27DWA2018923,24,26,15,11,1
SBI98ELS1370991,86,28,26,2,1
SBI73NIZ3893892,88,12,10,2,1
SBI30NHP4483706,18,22,20,2,1
SBI66AGL9324073,82,24,17,7,1
SBI60ZRW3443338,96,25,14,11,1
SBI30DCZ9973108,20,24,17,7,1
SBI08IJF2100930,22,21,12,9,1
SBI75MKF4483704,83,24,22,2,1
SBI62RLT3944009,97,26,19,7,1
SBI14YNE9266232,61,17,13,4,1
SBI52IWX5630479,98,25,19,6,1
SBI57YNL8001060,93,24,20,4,1
SBI34UGY4141069,76,31,21,10,1
SBI36HSL0624152,99,29,21,8,1
SBI01BDK9755088,65,25,19,6,1
SBI51KCG1747687,96,28,17,11,1
SBI98OBG2725300,65,32,17,15,1
SBI75WWZ1804475,21,19,15,4,1
SBI63OJR4326933,91,26,25,1,1
SBI32SAE7177498,23,24,18,6,1
SBI16EHO6136570,79,19,14,5,1
SBI69IBG7579654,18,22,13,9,1
SBI10FMB1787813,69,24,20,4,1
SBI65DMV7104341,24,20,14,6,1
SBI84ZMM5697291,95,26,17,9,1
SBI36QBU7941159,95,34,28,6,1
SBI36KIN6078538,75,27,24,3,1
SBI99XRV0924524,84,13,10,3,1
SBI38IEC2735627,89,27,24,3,1
SBI74SBY5636314,66,23,18,5,1
SBI61XSN1542095,84,24,21,3,1
SBI74EDP5011758,93,26,14,12,1
SBI44NKA3173924,79,29,21,8,1
SBI94HGC1915651,98,24,18,6,1
SBI38UHS2080132,62,22,14,8,1
SBI42GIU5973698,66,26,16,10,1
SBI50KGO0213013,81,24,23,1,1
SBI85ZCE6841118,22,31,19,12,1
SBI48GJP4934429,65,24,19,5,1
SBI81LHO6441085,22,27,23,4,1
SBI63MIW3434157,84,28,18,10,1
SBI62UWF8331818,83,23,13,10,1
SBI50CTF6631231,21,30,16,14,1
SBI69WFF1757656,22,23,18,5,1
SBI02ODJ9576356,61,22,16,6,1
SBI67SZT1528488,72,27,15,12,1
SBI12KMG7607662,98,32,27,5,1
SBI16LEI0182141,66,26,14,12,1
SBI46FOQ0669699,99,18,15,3,1
SBI75FFL1300387,85,32,26,6,1
SBI44ROJ1041226,92,20,18,2,1
SBI49OKS2953894,92,23,17,6,1
SBI07FBO9072271,80,26,17,9,1
SBI04ITY6909070,19,27,19,8,1
SBI11PCE7811935,69,25,24,1,1
SBI10DAT6071104,72,27,17,10,1
SBI15LGW5096712,67,25,14,11,1
SBI26ATQ3701232,89,33,31,2,1
SBI77ULG8643673,96,29,19,10,1
SBI05FVS9125956,90,26,18,8,1
SBI42AKW4055024,73,20,19,1,1
SBI18KYE7189845,68,24,20,4,1
SBI23NZN1665719,89,27,20,7,1
SBI77FDM0439074,19,21,16,5,1
SBI53IAX4216239,62,22,21,1,1
SBI62PGI7861312,97,21,16,5,1
SBI27JHR6849399,19,31,24,7,1
SBI59RFS0010917,18,21,11,10,1
SBI58OJG4395866,21,34,28,6,1
SBI91FET7398780,83,19,11,8,1
SBI05MGO9063353,73,34,24,10,1
SBI30PNB6171319,67,19,12,7,1
SBI86NGI4364102,84,26,23,3,1
SBI06ZNJ2538362,18,27,19,8,1
SBI94AYO9214772,69,23,16,7,1
SBI00SMD6426331,78,25,17,8,1
SBI34CKQ8789034,97,23,12,11,1
SBI12USY2042682,89,28,20,8,1
SBI72FIM4337453,99,26,16,10,1
SBI79AZH3643440,98,26,21,5,1
SBI64JKX7926341,66,27,26,1,1
SBI00UDF1124408,82,16,15,1,1
SBI72ERS6704491,80,12,11,1,1
SBI07GOO8177574,92,21,16,5,1
SBI24FUY0004724,66,24,14,10,1
SBI30FMW6658247,71,19,14,5,1
SBI25XKW0525134,74,30,25,5,1
SBI29LFS3406782,94,28,25,3,1
SBI90DZX8119381,93,21,12,9,1
SBI58MGS9112055,75,25,21,4,1
SBI98EBA2869055,78,19,12,7,1
SBI68DKH2531959,97,31,29,2,1
SBI22EZG9276105,94,20,14,6,1
SBI19OJY7333383,91,24,22,2,1
SBI08ODT8655615,98,27,19,8,1
SBI32GCU9502760,71,30,27,3,1
SBI18MWO0500730,87,17,15,2,1
SBI25XKQ6665252,84,26,25,1,1
SBI84DBI8941243,19,24,21,3,1
SBI93OVP4303124,83,11,7,4,1
SBI85BUF5472135,93,16,14,2,1
SBI58DGQ6821223,83,25,15,10,1
SBI78GAL1528693,73,19,13,6,1
SBI27ROE6261487,61,27,21,6,1
SBI34XTB6270479,75,19,12,7,1
SBI57TFV8141675,65,20,19,1,1
SBI42SNV9188520,79,18,13,5,1
SBI08VST0998610,87,22,20,2,1
SBI18WBY3363276,75,27,20,7,1
SBI42HEE0492841,22,16,12,4,1
SBI11LGK9960690,77,34,22,12,1
SBI66RLN9603003,70,27,20,7,1
SBI86LBY0236158,90,21,14,7,1
SBI35FOM7813760,22,28,22,6,1
SBI04RRE7310471,94,27,14,13,1
SBI87MZU8481185,71,26,25,1,1
SBI81JLH1430953,62,28,20,8,1
SBI19WQB2480333,24,22,20,2,1
SBI89XHB3372588,97,23,15,8,1
SBI14BZX3322443,88,24,15,9,1
SBI13UPY1997359,25,20,12,8,1
SBI15BYJ3763287,24,23,19,4,1
SBI95PCQ6165056,22,27,18,9,1
SBI18VRP9153604,78,24,21,3,1
SBI46VKC1913720,75,25,13,12,1
SBI27MDG5012475,74,31,18,13,1
SBI12QMY7151517,97,33,17,16,1
SBI99RSB7043448,20,24,15,9,1
SBI15CBS1404228,94,18,12,6,1
SBI63UWL9743023,90,21,19,2,1
SBI77LUH2803525,68,24,15,9,1
SBI73NYF6349886,89,25,17,8,1
SBI07APF9667869,84,25,16,9,1
SBI06RMJ7068328,69,22,13,9,1
SBI35JDU7778372,77,23,22,1,1
SBI69DJQ9795538,86,22,19,3,1
SBI92PUT1960338,86,24,20,4,1
SBI95TQI0637709,91,27,23,4,1
SBI88EEY9487180,23,22,12,10,1
SBI77XMJ2159410,19,20,17,3,1
SBI66SNX2406638,22,28,21,7,1
SBI17LZZ3528142,91,19,12,7,1
SBI26BCA4581723,84,26,23,3,1
SBI41PCV3009469,86,29,21,8,1
SBI53YQQ0782255,85,25,22,3,1
SBI84QKF9232881,88,24,14,10,1
SBI43HKU8533626,62,24,14,10,1
SBI42UBJ7307642,90,34,26,8,1
SBI57XTR7606761,75,29,20,9,1
SBI69AAY4422938,82,29,24,5,1
SBI31GIM8235004,82,20,15,5,1
SBI52EMM9034054,85,22,15,7,1
SBI09GIK4153172,89,31,24,7,1
SBI17XZM1602665,81,22,14,8,1
SBI08EXF8088305,86,28,17,11,1
SBI21EHM0820204,69,33,27,6,1
SBI27NLS2302966,21,25,23,2,1
SBI65CSL9094679,24,18,10,8,1
SBI71DQA2182009,74,32,19,13,1
SBI78ICY7072722,92,29,28,1,1
SBI29TST9344686,21,34,23,11,1
SBI68OPD8199210,99,26,14,12,1
SBI77ROI3307554,66,29,25,4,1
SBI56JWJ7439011,22,25,15,10,1
SBI70VHF4994992,62,24,17,7,1
SBI62PHS7818622,73,29,21,8,1
SBI38CAS2286205,95,23,22,1,1
SBI31CTY6082952,19,25,20,5,1
SBI75XVB0904447,67,30,24,6,1
SBI00TCI5481780,81,29,15,14,1
SBI09ONK4772416,82,17,16,1,1
SBI36BNE5591856,60,23,14,9,1
SBI63PSZ6985958,80,26,16,10,1
SBI63IFL4586783,60,15,14,1,1
SBI59IVJ3977702,63,22,18,4,1
SBI57AOL4271205,91,28,26,2,1
SBI09OXD1866986,18,33,24,9,1
SBI70FNI2018884,75,18,10,8,1
SBI61SNB7280247,84,26,16,10,1
SBI58HCW2231049,69,25,15,10,1
SBI61LNK8090106,79,34,31,3,1
SBI70MXC6979319,94,23,12,11,1
SBI41SEW1025789,73,26,21,5,1
SBI71WDT1663289,97,24,14,10,1
SBI73DPF6149305,84,19,16,3,1
SBI07BZO2715622,79,31,19,12,1
SBI10OKY0537290,73,24,18,6,1
SBI00WLS6126885,73,22,14,8,1
SBI36UZX3458066,95,24,20,4,1
SBI85PDG1026225,88,37,29,8,1
SBI00DDL8263203,89,27,21,6,1
SBI05GWC5197537,23,27,15,12,1
SBI70WCE5839216,88,29,20,9,1
SBI05AZY2744970,70,19,11,8,1
SBI78EYR0312450,75,24,22,2,1
SBI97VWP0910204,60,24,15,9,1
SBI00GMJ7619565,90,21,14,7,1
SBI59YPR1141276,62,24,17,7,1
SBI19LYJ0300656,73,30,21,9,1
SBI30RHC3975949,86,29,18,11,1
SBI96KDD2713103,62,22,18,4,1
SBI65PNS6755375,79,27,26,1,1
SBI32UNC5264243,94,12,10,2,1
SBI80TQI2300583,99,26,18,8,1
SBI83NEI3628162,87,19,13,6,1
SBI35UKR7472166,25,33,28,5,1
SBI71VGX2578499,79,27,19,8,1
SBI05COV8688320,73,19,15,4,1
SBI55VOW2122685,22,26,15,11,1
SBI34NBP5279713,88,20,11,9,1
SBI91BCF0459396,76,20,11,9,1
SBI10MAE6269932,93,22,15,7,1
SBI78TCO6755624,68,28,23,5,1
SBI58KVG9984054,68,22,13,9,1
SBI55IBT9656005,89,20,12,8,1
SBI21IZE2698707,80,27,17,10,1
SBI36TQE4106611,23,28,24,4,1
SBI66UNT4291431,83,24,16,8,1
SBI43VIZ1848815,95,21,15,6,1
SBI99NXH0900104,80,32,21,11,1
SBI79WAB0655093,88,25,24,1,1
SBI23ZBU3769514,92,22,18,4,1
SBI68BIS8079519,94,34,31,3,1
SBI39MWF2484909,81,27,20,7,1
SBI43OOC2913139,80,34,26,8,1
SBI16AJA7311385,91,23,22,1,1
SBI53LFF4569055,64,24,14,10,1
SBI65FIK2380053,67,26,17,9,1
SBI03TKH6510235,65,30,21,9,1
SBI36DPG8527140,19,32,19,13,1
SBI72EZN9017727,80,19,11,8,1
SBI18DCY1719158,85,22,21,1,1
SBI41AEC4258147,22,32,21,11,1
SBI06ZSS3070717,25,21,14,7,1
SBI27CPA6387805,22,29,16,13,1
SBI39WMO7247319,92,27,18,9,1
SBI55UOY4034474,73,23,17,6,1
SBI78AVH1477112,19,26,20,6,1
SBI48QWO1852505,66,29,24,5,1
SBI75PIL5887885,77,25,14,11,1
SBI29HLT3324718,82,21,14,7,1
SBI25KNP0741701,69,20,15,5,1
SBI53OMV9775407,81,27,14,13,1
SBI52PBU5460604,79,23,12,11,1
SBI82OHB6852200,65,24,15,9,1
SBI67VEB8437297,63,16,13,3,1
SBI83CSW8793478,72,26,17,9,1
SBI03EYF7191174,20,26,21,5,1
SBI59UOZ2494302,86,24,21,3,1
SBI97JCS0371564,70,27,18,9,1
SBI09CLC9798660,72,30,22,8,1
SBI19IBM6905687,19,24,15,9,1
SBI73YUK0252477,25,21,16,5,1
SBI23ESU2764601,80,27,17,10,1
SBI85VDO0226568,94,25,13,12,1
SBI51YEG1873523,82,34,26,8,1
SBI44UQC5683178,80,27,18,9,1
SBI78RAX8569350,87,18,15,3,1
SBI61OWU6528268,66,22,14,8,1
SBI67IUB3682953,91,25,21,4,1
SBI74WFZ9241937,21,18,12,6,1
SBI66AAM6129521,21,27,19,8,1
SBI26CEE6103889,20,32,30,2,1
SBI05IYM9528278,69,18,11,7,1
SBI86DYM4126162,68,26,24,2,1
SBI13IGL2156239,72,30,16,14,1
SBI57HMK7751072,78,25,23,2,1
SBI77BNO7010653,82,22,12,10,1
SBI21ZSN9566590,74,28,15,13,1
SBI79CRX5184420,62,26,16,10,1
SBI14EBS1841930,63,26,15,11,1
SBI61DTX9777267,63,22,19,3,1
SBI49WKS4709312,87,19,16,3,1
SBI02PPQ6120042,60,25,20,5,1
SBI61YVR6592403,80,28,15,13,1
SBI51EMJ7418393,67,18,10,8,1
SBI81TJJ8389013,76,32,23,9,1
SBI50SJR8631822,66,28,18,10,1
SBI00ENP9348211,18,30,18,12,1
SBI01OID2316095,18,24,15,9,1
SBI09HVN2609767,85,28,17,11,1
SBI07DVC1580246,80,26,17,9,1
SBI29UVG1872770,87,16,11,5,1
SBI79SJW0094669,68,31,30,1,1
SBI68TJX1045277,90,23,13,10,1
SBI84VZJ8448262,83,28,17,11,1
SBI10VBL8991068,78,31,25,6,1
SBI10VZL3657344,90,18,17,1,1
SBI86KCS5992978,98,25,14,11,1
SBI99IJU7245805,62,22,18,4,1
SBI34NJP0646884,80,21,16,5,1
SBI47BAM9591985,19,17,10,7,1
SBI68RUX6868901,71,18,17,1,1
SBI85ELV1968700,88,20,18,2,1
SBI64NBZ7926850,83,23,18,5,1
SBI76OAA0186400,95,20,14,6,1
SBI21JYF2134268,91,24,20,4,1
SBI14YVI9588365,99,29,18,11,1
SBI37LMA1644447,91,20,19,1,1
SBI84IAY5026155,92,24,15,9,1
SBI65BWX6861414,64,25,23,2,1
SBI93IJH6641238,97,26,22,4,1
SBI55RNK1999690,71,19,14,5,1
SBI32FVV3506613,76,19,16,3,1
SBI67HBB8689847,84,15,14,1,1
SBI84ACX5358578,66,28,23,5,1
SBI74UXX1661352,22,25,17,8,1
SBI16JTC1502612,73,22,15,7,1
SBI76YGE9128688,19,25,16,9,1
SBI87BDM9272895,68,16,14,2,1
SBI64JEA8039985,89,36,34,2,1
SBI91KKW5007884,95,22,15,7,1
SBI25BND0031102,88,14,13,1,1
SBI56UDS7868867,99,26,25,1,1
SBI06YCJ8288331,74,24,14,10,1
SBI15YOG4583151,75,34,33,1,1
SBI77LWT7298897,67,15,8,7,1
SBI08TCP5426709,72,20,18,2,1
SBI38ITR3255522,86,33,23,10,1
SBI41VWM8665479,89,24,21,3,1
SBI67HJX5384270,92,34,23,11,1
SBI74SUP5056210,22,20,19,1,1
SBI59TLP5763741,84,26,14,12,1
SBI91AMZ4921199,73,26,24,2,1
SBI68EDV7562571,66,23,15,8,1
SBI13LLD8250190,89,33,25,8,1
SBI88HYS7441124,95,25,15,10,1
SBI83SZG1180109,71,21,18,3,1
SBI77GNM7016389,72,25,14,11,1
SBI76GTO7263169,70,32,28,4,1
SBI27UZT7041515,70,21,17,4,1
SBI17JAY3599076,70,28,21,7,1
SBI21QDC8378248,70,28,27,1,1
SBI11TCO8214783,91,32,17,15,1
SBI99GBZ0546746,18,30,22,8,1
SBI01YLN4025026,77,30,28,2,1
SBI98RJT3998226,93,26,25,1,1
SBI27CEX2413598,77,27,17,10,1
SBI45ADO7456084,64,24,18,6,1
SBI31ZXW1155964,85,34,33,1,1
SBI91QJQ5317712,61,21,14,7,1
SBI34XGP3066311,81,20,17,3,1
SBI01ZUS0740813,66,22,17,5,1
SBI00RYX8898199,90,25,15,10,1
SBI99ZVE7130331,91,16,14,2,1
SBI16AHA1220117,93,28,24,4,1
SBI39WED7550454,78,19,12,7,1
SBI75SAK8295720,81,34,18,16,1
SBI68JLD2824842,67,29,24,5,1
SBI48XSD4055569,18,32,21,11,1
SBI09BCY7692460,22,25,14,11,1
SBI10EQM2095052,61,23,17,6,1
SBI55HAZ0749968,66,31,23,8,1
SBI69PBA0663456,91,22,18,4,1
SBI79OWX6234320,89,35,32,3,1
SBI74YLH0747477,75,19,10,9,1
SBI97LRT5018488,77,28,20,8,1
SBI94WAI1763402,23,24,16,8,1
SBI98LTE3825018,99,30,24,6,1
SBI09TFL7055878,18,27,25,2,1
SBI51EQZ8274404,93,20,16,4,1
SBI61GMR9731728,90,31,16,15,1
SBI83SRD1659223,80,26,24,2,1
SBI50KXH3208956,65,23,17,6,1
SBI40DYE0325065,72,23,12,11,1
SBI00YKV1763628,83,36,20,16,1
SBI77WTU6298839,99,33,17,16,1
SBI70MYQ8245480,99,25,14,11,1
SBI06WRT9517792,23,23,20,3,1
SBI64SRI7020059,64,21,14,7,1
SBI00CRU0752017,66,22,16,6,1
SBI64IIE8802307,69,22,17,5,1
SBI90FBH4311830,78,32,28,4,1
SBI73KVA5161383,88,21,11,10,1
SBI60YIZ0508957,92,26,21,5,1
SBI17QMN5212953,70,18,17,1,1
SBI07NET0395948,78,14,10,4,1
SBI56JIE1335097,78,27,16,11,1
SBI67MHQ6574021,98,25,13,12,1
SBI27WAL6895551,75,22,19,3,1
SBI69HQY3317391,79,22,18,4,1
SBI63TJJ3587140,19,27,26,1,1
SBI49DRV5814738,23,24,17,7,1
SBI55DEP4731409,81,21,13,8,1
SBI45ORH0689030,63,23,16,7,1
SBI63EIK3742841,61,25,17,8,1
SBI88RCJ5152275,22,28,18,10,1
SBI84NIB8326127,65,28,24,4,1
SBI01VNJ3266761,85,34,29,5,1
SBI56WHH7307279,70,26,22,4,1
SBI43WHE5746658,21,24,14,10,1
SBI93GWR1225732,76,36,27,9,1
SBI37IGG9732059,90,26,15,11,1
SBI37LQA2357189,73,38,25,13,1
SBI05XAQ6060734,18,28,18,10,1
SBI68YXK4255341,84,18,13,5,1
SBI04GHQ5266898,76,22,18,4,1
SBI72OQU4502152,94,29,19,10,1
SBI02KOX9864959,85,22,21,1,1
SBI37RLU2389832,71,29,19,10,1
SBI69PGD2831989,98,19,14,5,1
SBI87WQR5325000,25,23,15,8,1
SBI30APY6938479,20,21,18,3,1
SBI43VRL3410940,68,26,15,11,1
SBI50SJF7194229,74,26,25,1,1
SBI88YJH6669738,76,20,14,6,1
SBI95SYT0369008,92,24,17,7,1
SBI51FNI4518626,60,26,22,4,1
SBI73RSC5469412,66,21,12,9,1
SBI74PUS2970210,95,24,14,10,1
SBI63BAY4084547,96,29,19,10,1
SBI51WWJ8093042,85,27,18,9,1
SBI46VSC4363913,80,26,14,12,1
SBI69DOB9445228,94,22,21,1,1
SBI06VMG0261223,92,32,30,2,1
SBI31QDV7219593,83,27,18,9,1
SBI22IOE4373472,68,20,14,6,1
SBI23GAY5479797,67,22,20,2,1
SBI75EVW2713096,61,34,26,8,1
SBI81JWL3291104,80,31,18,13,1
SBI93NGN3244902,19,20,15,5,1
SBI09PJL8085981,82,25,13,12,1
SBI31FGB8829188,80,24,21,3,1
SBI92SUN1348319,73,19,14,5,1
SBI18XXD9448711,80,20,18,2,1
SBI82VQT6172531,77,25,17,8,1
SBI26PPW8497434,94,22,17,5,1
SBI84VOX0159278,19,34,30,4,1
SBI10RDB6378834,68,31,19,12,1
SBI64ABA0950841,22,25,13,12,1
SBI64YNK4392517,84,25,15,10,1
SBI50CLB2643827,88,23,16,7,1
SBI25SDV6534837,79,28,21,7,1
SBI60WCW7328946,78,24,22,2,1
SBI56YPI4521378,24,23,22,1,1
SBI57BSE5642678,63,21,14,7,1
SBI68SMR2961385,20,35,28,7,1
SBI52KPW2991760,94,33,17,16,1
SBI13KXK0062690,61,23,18,5,1
SBI10IBH6285220,82,22,21,1,1
SBI52RGY3301170,80,30,26,4,1
SBI10PIA8981004,87,21,16,5,1
SBI80VAG1985536,85,32,25,7,1
SBI33ILE8750487,95,26,24,2,1
SBI19GYI4598173,19,24,21,3,1
SBI46XKJ7180768,19,24,13,11,1
SBI59YUI4822419,22,29,22,7,1
SBI07HIZ7981651,19,23,15,8,1
SBI34IDO7883444,65,32,31,1,1
SBI72LKB8805533,63,24,20,4,1
SBI90GSK7341081,20,21,13,8,1
SBI34UIF2579454,60,30,21,9,1
SBI33HPQ8620880,80,30,18,12,1
SBI82OJM7692012,93,23,19,4,1
SBI05VAB7985436,65,23,17,6,1
SBI02OTN1358433,81,29,26,3,1
SBI17EHW9654341,84,29,18,11,1
SBI28ONQ3178437,90,19,12,7,1
SBI28AXM8961810,23,18,10,8,1
SBI54RSL2227545,99,21,13,8,1
SBI44WPM0655206,92,20,18,2,1
SBI40UOX9989203,90,21,12,9,1
SBI51XMO1349726,61,30,25,5,1
SBI93HRQ0745364,81,31,19,12,1
SBI11IIE4998864,66,29,28,1,1
SBI86CRW4339398,77,24,20,4,1
SBI76FIS0454315,97,27,23,4,1
SBI49RPO5537300,95,31,17,14,1
SBI89XZY8528468,69,32,25,7,1
SBI61HVM1151174,78,26,18,8,1
SBI40KSG8485049,67,25,17,8,1
SBI01PLC6690523,80,20,12,8,1
SBI89KIC0658004,81,20,19,1,1
SBI41UOO1267679,68,23,22,1,1
SBI44TAR3603929,97,29,19,10,1
SBI79VFJ5249610,96,20,11,9,1
SBI83SST4822746,93,40,37,3,1
SBI02DSJ9093645,66,20,15,5,1
SBI06CAD1977668,66,25,23,2,1
SBI79RKW3429323,96,20,18,2,1
SBI50UAK2871298,87,19,16,3,1
SBI09DEC8133928,76,25,15,10,1
SBI03TDF0312236,22,26,14,12,1
SBI18IHV7907157,76,17,12,5,1
SBI01KPQ2657439,19,29,26,3,1
SBI96VAU9957838,83,35,34,1,1
SBI78AAR2899509,24,19,14,5,1
SBI60AVL2447633,68,34,24,10,1
SBI94BDW2469355,76,28,15,13,1
SBI55VOJ8497966,24,24,14,10,1
SBI04HMU9894188,70,31,22,9,1
SBI01ZHA7764409,82,30,26,4,1
SBI37EJP7452320,94,28,17,11,1
SBI56AKC0978257,63,30,17,13,1
SBI67MQN6080061,23,18,12,6,1
SBI31BGK5006432,94,21,20,1,1
SBI11PAA4843524,69,26,20,6,1
SBI00VQZ6922325,90,32,25,7,1
SBI45TLS5269933,96,25,23,2,1
SBI58KBT1982484,97,23,22,1,1
SBI26GSN3130554,82,21,13,8,1
SBI01XOL9642250,85,33,29,4,1
SBI65VZQ9224430,93,26,23,3,1
SBI45CWT4802632,81,27,15,12,1
SBI35WLU5445781,19,15,10,5,1
SBI78FXB7974726,91,36,31,5,1
SBI33UPF8849230,88,28,16,12,1
SBI71CPR9972043,91,14,11,3,1
SBI76XPQ5228514,68,21,20,1,1
SBI57RWS9509019,73,25,15,10,1
SBI99QHX0502103,87,30,17,13,1
SBI12MZP6325251,62,31,16,15,1
SBI64MFG3398187,79,26,15,11,1
SBI28KJS4968089,20,27,17,10,1
SBI43BMO7162725,67,22,15,7,1
SBI92PKC9854085,88,27,26,1,1
SBI83MHR4796344,69,30,20,10,1
SBI08EFK7119846,86,31,29,2,1
SBI21QEI5316024,81,33,23,10,1
SBI03DOY4966253,69,27,20,7,1
SBI66RNS4237859,60,28,25,3,1
SBI23QHS9155359,62,21,16,5,1
SBI00YRD4941923,21,27,16,11,1
SBI36VEV5202648,94,17,16,1,1
SBI42IEI4319379,86,29,18,11,1
SBI19UCK9105582,87,28,16,12,1
SBI14YHQ1594892,22,23,16,7,1
SBI57AYQ0044670,93,17,14,3,1
SBI97WGX8941663,23,22,12,10,1
SBI90DJK8739556,90,25,15,10,1
SBI69XRX2929282,85,17,11,6,1
SBI16GFF5838704,23,21,12,9,1
SBI32JLT2139057,88,26,19,7,1
SBI96VZU3236873,62,25,20,5,1
SBI60AWT6885383,77,30,26,4,1
SBI68DFL3569754,72,26,17,9,1
SBI85TCJ9575235,63,24,16,8,1
SBI92IIJ1930641,91,31,17,14,1
SBI49QHC3818238,20,34,20,14,1
SBI60QXV9108918,79,21,16,5,1
SBI26AZU1282927,19,24,22,2,1
SBI83YRQ9772402,97,25,22,3,1
SBI50IDK6943385,98,28,19,9,1
SBI54OWF3390792,22,27,19,8,1
SBI59COK2645877,73,19,10,9,1
SBI90HOQ0223337,62,22,18,4,1
SBI32DXS8143951,77,24,22,2,1
SBI28QTN4898105,90,29,22,7,1
SBI57BGV3825793,18,23,14,9,1
SBI19YCW2345289,65,34,19,15,1
SBI02MGF5069103,75,26,18,8,1
SBI89LOI5482839,87,26,23,3,1
SBI05BLJ3956020,93,29,22,7,1
SBI72HMY5591200,94,29,24,5,1
SBI82BEK7629191,84,28,18,10,1
SBI63OJB4059222,98,24,21,3,1
SBI54ENY8546799,89,23,19,4,1
SBI22BCK4798865,77,19,15,4,1
SBI30LVH0828914,78,26,24,2,1
SBI03NFN6710778,65,22,18,4,1
SBI12OYG9317847,96,15,13,2,1
SBI13JCE7458715,84,29,27,2,1
SBI12LKX5826687,81,24,16,8,1
SBI30LDA8903190,61,27,17,10,1
SBI97YVD5031740,22,26,14,12,1
SBI59UEC5187639,79,24,13,11,1
SBI45ZFX4115127,80,28,24,4,1
SBI20IDJ8774063,64,37,31,6,1
SBI48NXF6305771,91,26,22,4,1
SBI46OSG2277552,63,23,15,8,1
SBI36DFX2080593,62,31,26,5,1
SBI72ECR5722021,94,27,26,1,1
SBI21IVS6545192,91,31,16,15,1
SBI74TUX8747978,21,24,20,4,1
SBI14EWF5468805,20,23,13,10,1
SBI54OTN1698287,25,21,17,4,1
SBI58SFL3295616,90,23,14,9,1
SBI56TGS6577178,18,22,12,10,1
SBI85OOE3038412,62,31,21,10,1
SBI34VRD6681073,84,19,16,3,1
SBI25CVZ3904432,84,28,21,7,1
SBI64XCN6026541,82,15,8,7,1
SBI09ENR6893716,97,24,14,10,1
SBI21QJF8143471,19,18,16,2,1
SBI75NKY7229245,66,16,9,7,1
SBI67CKU9860334,71,27,21,6,1
SBI33KPY8316008,92,24,15,9,1
SBI70VYJ2557463,72,25,15,10,1
SBI40CBJ1456233,97,25,19,6,1
SBI15QUD7783373,89,27,15,12,1
SBI95KZQ9475800,78,21,15,6,1
SBI60XAX4669703,70,26,14,12,1
SBI76ALE7191445,96,19,13,6,1
SBI40RZI2468943,71,32,20,12,1
SBI90EIH4605712,23,19,16,3,1
SBI29HYK2813144,18,32,23,9,1
SBI51SIQ5149127,96,23,16,7,1
SBI84QUI2647449,64,24,18,6,1
SBI44RWR2283297,71,24,22,2,1
SBI86YHG3796285,78,25,13,12,1
SBI03TUI2883165,21,30,20,10,1
SBI87RDP8401821,83,28,26,2,1
SBI19LNO6596883,25,22,12,10,1
SBI92HXX1316300,20,20,19,1,1
SBI19QJF8678285,96,23,14,9,1
SBI55XME7803430,66,21,11,10,1
SBI65BKY1593955,60,29,21,8,1
SBI53HGZ7470750,97,35,24,11,1
SBI74OFZ6662688,88,21,16,5,1
SBI47KMR8716011,99,15,8,7,1
SBI25VYH0968211,20,25,14,11,1
SBI15DJM7154051,63,24,13,11,1
SBI95GTT4066956,23,31,27,4,1
SBI85LEB5254687,88,20,14,6,1
SBI92GCT4199005,63,23,14,9,1
SBI63TQE2339339,69,25,16,9,1
SBI14WLH1035962,73,19,11,8,1
SBI99BNI8083578,73,23,13,10,1
SBI03CLZ5349331,86,24,21,3,1
SBI54OTB3778007,83,19,13,6,1
SBI41BHF3242030,23,24,19,5,1
SBI88GUG9304353,69,21,14,7,1
SBI38CPA8225063,93,29,18,11,1
SBI56ACK7625593,90,25,16,9,1
SBI17UUR2290770,66,28,21,7,1
SBI12UQH3597480,88,34,22,12,1
SBI85JGZ8226378,73,28,15,13,1
SBI03DGL4472814,80,27,20,7,1
SBI71GCZ5852501,69,22,18,4,1
SBI45SEM4622993,91,23,20,3,1
SBI82XNP5733829,21,18,17,1,1
SBI74GVZ8516090,66,26,21,5,1
SBI45IJB8007542,68,34,20,14,1
SBI18KWK9880527,21,35,31,4,1
SBI46XAP8998289,93,29,27,2,1
SBI54BSV6881516,73,23,22,1,1
SBI04YLQ2652344,71,22,21,1,1
SBI62ZBI3337806,64,25,19,6,1
SBI47ALS5200470,93,17,11,6,1
SBI57XTT3034425,72,27,18,9,1
SBI52KMY2962523,76,19,18,1,1
SBI14CWW6916180,62,11,9,2,1
SBI69LDE8351176,60,20,15,5,1
SBI13WDJ2649547,81,23,13,10,1
SBI60SGD8207723,68,29,19,10,1
SBI26TUG1996226,78,24,17,7,1
SBI24RPT2314716,62,29,28,1,1
SBI52XOX9831439,81,15,8,7,1
SBI86QCM8188167,23,24,14,10,1
SBI43HGV3422049,73,19,17,2,1
SBI39TAW3111234,73,19,18,1,1
SBI98SFN4845242,74,35,34,1,1
SBI16IRG3181682,19,24,23,1,1
SBI26IHH9916010,78,36,32,4,1
SBI20JJV2241693,62,28,23,5,1
SBI30UGV1643495,76,13,12,1,1
SBI60MZZ6839575,73,21,13,8,1
SBI12MMB0050273,60,23,13,10,1
SBI04ZBI7765861,25,13,7,6,1
SBI04BHU2441385,77,29,28,1,1
SBI61WFV3851398,19,19,12,7,1
SBI28LUE7190858,68,23,17,6,1
SBI62YTP5921504,82,21,16,5,1
SBI88VSK9329708,82,28,18,10,1
SBI85PBA0254578,25,25,18,7,1
SBI60MHI4933945,69,31,19,12,1
SBI79EDT2814880,62,21,17,4,1
SBI03GQW9829873,74,22,19,3,1
SBI39NFM4648418,83,35,28,7,1
SBI62CIE3988736,61,29,23,6,1
SBI98ITH8428947,83,23,12,11,1
SBI59ZXW4035059,95,26,21,5,1
SBI15PIJ5503111,75,26,15,11,1
SBI27HZQ2533614,18,28,24,4,1
SBI55NHP1945003,22,28,21,7,1
SBI76ROK0615664,81,29,23,6,1
SBI13TMG8498260,60,25,17,8,1
SBI78FDZ3086247,62,38,21,17,1
SBI45NYI7850209,81,28,15,13,1
SBI73JAT7836379,22,23,22,1,1
SBI52ENX5662983,65,30,24,6,1
SBI81VUC5965066,62,28,26,2,1
SBI49YNZ1001491,22,23,18,5,1
SBI27JJP6470391,65,33,21,12,1
SBI68TWU0559242,21,28,27,1,1
SBI71NHC6502559,82,31,29,2,1
SBI84AQT6043805,97,30,28,2,1
SBI16HTD2263472,78,21,20,1,1
SBI76GQB9380010,98,19,12,7,1
SBI53BQW8364043,25,30,27,3,1
SBI82KPM5678435,90,27,17,10,1
SBI24VDO2927972,60,26,19,7,1
SBI20YKH0743386,86,28,25,3,1
SBI93SAI2537386,18,22,18,4,1
SBI66JHP3498681,73,25,16,9,1
SBI58VWG1859773,63,26,20,6,1
SBI24DRD8330998,91,32,21,11,1
SBI48GFB4529470,79,22,15,7,1
SBI69PTX7405932,78,25,16,9,1
SBI17WIU4843907,83,23,22,1,1
SBI54DRE9506667,63,26,20,6,1
SBI46RFY9938807,74,27,17,10,1
SBI30LYY0887255,25,34,22,12,1
SBI47VEA9635288,22,33,29,4,1
SBI26ELI6037377,60,12,11,1,1
SBI48LWB0776236,66,25,19,6,1
SBI53BJX4031450,24,30,16,14,1
SBI29OHC1630449,84,26,14,12,1
SBI40FKM6272957,93,24,23,1,1
SBI13AOL8947541,62,26,20,6,1
SBI98ICD3108046,92,24,17,7,1
SBI94YWD7814652,63,28,25,3,1
SBI38ZYL1557807,87,17,15,2,1
SBI12ADG0042828,81,21,11,10,1
SBI90LND9721331,80,20,16,4,1
SBI19CBR3878312,23,15,14,1,1
SBI91LWM3916545,62,17,10,7,1
SBI77GWQ2756305,20,25,23,2,1
SBI30DFV8051137,78,29,16,13,1
SBI75BCZ7450928,61,29,17,12,1
SBI26DTA5570662,92,28,26,2,1
SBI14TFW5882941,83,22,16,6,1
SBI77RXE9014060,88,29,15,14,1
SBI07JZI9974184,87,23,14,9,1
SBI86VYI8527111,62,28,22,6,1
SBI80RKC1185476,66,29,22,7,1
SBI45CRL4474038,19,22,16,6,1
SBI97ESL8264743,77,22,18,4,1
SBI87AQA9390616,76,27,16,11,1
SBI22YRM7831463,66,24,21,3,1
SBI27AZT8643421,95,28,16,12,1
SBI25OTU1973767,18,25,21,4,1
SBI28ALS2309802,18,26,20,6,1
SBI64IIP9499011,63,25,14,11,1
SBI54VFP7273713,72,24,19,5,1
SBI56AZB7027533,60,29,24,5,1
SBI99HOH4681279,72,26,18,8,1
SBI42QXP1999129,75,19,12,7,1
SBI24XFF6215247,73,24,14,10,1
SBI27LTJ8869797,19,27,23,4,1
SBI62OYU4834364,60,28,21,7,1
SBI20OLF1110544,79,21,12,9,1
SBI36PWG1607831,69,20,11,9,1
SBI55TOV2819740,76,25,24,1,1
SBI12UXR8485498,77,28,20,8,1
SBI70LSE7049642,80,28,16,12,1
SBI99UPQ3612134,73,26,20,6,1
SBI79ADF1280684,85,30,28,2,1
SBI43JLM9994598,60,25,19,6,1
SBI23DPN3374680,25,22,12,10,1
SBI13CGF9894800,91,22,19,3,1
SBI34DOY6894987,81,22,13,9,1
SBI98JMW7822453,73,32,21,11,1
SBI17DSR9614582,97,36,27,9,1
SBI39HXC9584491,90,21,16,5,1
SBI14WTZ7171668,24,16,10,6,1
SBI99XFU1660762,72,21,13,8,1
SBI09UQT6130899,73,29,19,10,1
SBI18RCU6575386,90,23,21,2,1
SBI21LEP7517419,70,19,14,5,1
SBI48BLE7229669,67,21,18,3,1
SBI85URJ0670426,88,19,14,5,1
SBI65COI7639577,80,25,20,5,1
SBI06UXM1972890,66,27,26,1,1
SBI51DSL9541399,97,23,16,7,1
SBI22FFM3003985,70,24,22,2,1
SBI13OBW6918914,23,21,19,2,1
SBI78ADP8317428,81,30,22,8,1
SBI27JGR8788107,18,33,31,2,1
SBI66IUW2750804,23,27,26,1,1
SBI82ATE1508156,78,28,24,4,1
SBI44GAY6752778,72,21,16,5,1
SBI83ETJ8183074,70,25,19,6,1
SBI68WSU4964856,64,28,20,8,1
SBI30OVD8593130,81,31,21,10,1
SBI22VJE3325855,18,19,16,3,1
SBI49PWE2878504,75,32,21,11,1
SBI03BYQ3095684,92,22,20,2,1
SBI80MVT3776333,81,20,15,5,1
SBI34TYE4565118,91,21,14,7,1
SBI19CCQ5624449,97,28,17,11,1
SBI39VZM1968941,67,27,21,6,1
SBI52SQW2095239,65,21,20,1,1
SBI83TFY6757372,62,20,14,6,1
SBI03JTU3275627,95,23,16,7,1
SBI09LYP5883566,83,27,23,4,1
SBI58BPV5790265,84,33,20,13,1
SBI23LSK9297183,97,30,23,7,1
SBI63FEM0063094,60,26,24,2,1
SBI78CVR3924930,91,30,27,3,1
SBI95CDJ0863464,83,28,18,10,1
SBI04EQZ6231654,90,20,18,2,1
SBI29IWT6754988,94,19,18,1,1
SBI77VUL5062909,20,24,19,5,1
SBI43PCC2762233,81,27,20,7,1
SBI70HGR2012324,89,32,18,14,1
SBI36MJZ4425039,25,24,23,1,1
SBI66HBF2019394,76,29,25,4,1
SBI68NHB8835826,97,26,21,5,1
SBI03BGJ2653763,22,24,21,3,1
SBI54AFV1588506,84,28,17,11,1
SBI03CJI4592592,18,25,15,10,1
SBI31DLO2212772,88,21,18,3,1
SBI49RAH6149197,85,14,9,5,1
SBI01MQT1823055,74,26,21,5,1
SBI75IQX8104517,62,17,11,6,1
SBI99GLK8048857,77,26,16,10,1
SBI74LQD3994242,98,22,18,4,1
SBI85FAR9710465,79,29,17,12,1
SBI75FFO2383108,88,24,23,1,1
SBI30VXX4185775,99,31,29,2,1
SBI49IBI4582791,75,23,13,10,1
SBI22QGJ8132276,87,27,16,11,1
SBI30EQA5836592,60,17,15,2,1
SBI38YPE0294026,66,29,16,13,1
SBI52JNF2571100,62,25,13,12,1
SBI64KKG5864364,85,28,23,5,1
SBI79CAY9898568,22,16,11,5,1
SBI52CYY3990283,93,16,10,6,1
SBI47PWJ2662254,83,19,14,5,1
SBI42HZG1510033,74,30,20,10,1
SBI64VJU7608814,94,25,19,6,1
SBI81CBX2495401,76,31,17,14,1
SBI30KUO6676109,80,21,19,2,1
SBI18XWU1959448,83,23,15,8,1
SBI74GEG5403989,63,29,18,11,1
SBI42GGN1642196,76,18,10,8,1
SBI57KCY1734886,23,31,25,6,1
SBI39FJX3976676,78,21,20,1,1
SBI42HHI8985172,78,27,23,4,1
SBI50WUZ8317010,22,27,16,11,1
SBI88BRW4734299,83,25,18,7,1
SBI60UHM2464312,92,30,24,6,1
SBI75IHR9477742,82,24,21,3,1
SBI56VTO5687660,22,29,20,9,1
SBI03JIA4245260,23,25,15,10,1
SBI09DLY1440186,60,20,19,1,1
SBI43LIL8478303,91,22,19,3,1
SBI96MDO0583925,74,25,14,11,1
SBI70HDS7775061,24,24,15,9,1
SBI76HVH5329683,71,24,18,6,1
SBI91SOC9049268,65,26,15,11,1
SBI59VMZ2499034,88,31,22,9,1
SBI70SEV6582930,25,28,16,12,1
SBI75NWJ6660836,22,19,17,2,1
SBI32HSW9348967,25,18,10,8,1
SBI52NIE7284407,91,26,15,11,1
SBI64GHC0781749,67,28,21,7,1
SBI76IWH9196267,75,23,20,3,1
SBI14NMS2396862,91,25,24,1,1
SBI74RIO3201880,72,26,19,7,1
SBI61PDM7321999,90,18,10,8,1
SBI38TVF7261342,95,22,15,7,1
SBI21LYY7338868,97,23,19,4,1
SBI39ARZ9873907,75,24,19,5,1
SBI22HND3340577,81,18,17,1,1
SBI96FCH4156885,84,26,21,5,1
SBI51XAQ9546865,25,26,18,8,1
SBI03YLN7468937,76,17,11,6,1
SBI13XTV8154864,98,25,23,2,1
SBI71RAQ6655297,72,26,18,8,1
SBI99YIW7898887,22,36,22,14,1
SBI93TIH1772438,86,27,16,11,1
SBI36UNZ5351695,69,26,14,12,1
SBI46YXN6518248,90,21,18,3,1
SBI17QKZ5949583,25,20,17,3,1
SBI36CSA0973080,23,13,10,3,1
SBI71DYP8627856,67,17,11,6,1
SBI97PQA9489632,63,27,18,9,1
SBI14VPM2492536,62,20,18,2,1
SBI06URG3831692,93,17,11,6,1
SBI85DEB6205279,82,32,26,6,1
SBI53GPD5958274,65,31,18,13,1
SBI69SDT1852042,18,32,30,2,1
SBI91NVM8986255,89,29,16,13,1
SBI17HCD4070765,72,22,13,9,1
SBI71UIE3505961,60,19,16,3,1
SBI51XBR1097862,92,32,28,4,1
SBI82QZG2284594,84,22,16,6,1
SBI44PAD3205666,21,21,15,6,1
SBI28NIT7957202,22,25,13,12,1
SBI32ARU2863840,98,27,25,2,1
SBI81FPE6361656,94,24,19,5,1
SBI16DXZ7383421,78,23,14,9,1
SBI15GHM3930782,21,23,12,11,1
SBI89MTQ0610273,66,20,14,6,1
SBI80HXW1781851,73,23,21,2,1
SBI14HII9192993,91,17,12,5,1
SBI13TJI0402726,23,23,16,7,1
SBI84MXK6810153,93,20,14,6,1
SBI24MNQ8496283,66,22,14,8,1
SBI07EWJ3998097,20,23,13,10,1
SBI71IYK3214488,90,30,16,14,1
SBI21YAV8169189,77,27,22,5,1
SBI40TRM7008514,18,23,14,9,1
SBI61YAE5310286,18,29,25,4,1
SBI19CPX5003343,77,23,12,11,1
SBI66IOC2780181,99,28,27,1,1
SBI73XMI4379577,25,22,12,10,1
SBI01RTY6500990,23,26,23,3,1
SBI48UGK6597465,90,25,15,10,1
SBI17KUS4800725,63,12,9,3,1
SBI13YLT4364312,88,29,26,3,1
SBI75HZX5659908,62,34,22,12,1
SBI11ZPE1459389,73,28,15,13,1
SBI90PWH6432442,77,32,29,3,1
SBI86ILS7911468,22,32,23,9,1
SBI83UZC0573837,98,21,16,5,1
SBI45IEB8297214,68,31,17,14,1
SBI58DKX4557335,99,23,21,2,1
SBI60RIW6199213,84,26,18,8,1
SBI56SDP9215938,71,21,13,8,1
SBI97WSX6759752,72,25,16,9,1
SBI32OPG6764868,25,21,15,6,1
SBI18MAD6561536,99,26,15,11,1
SBI27OQH8326980,71,28,26,2,1
SBI19JUE9883072,23,23,17,6,1
SBI70JMX1139577,64,14,12,2,1
SBI63SNM7484717,21,21,12,9,1
SBI69OMD5227484,97,37,19,18,1
SBI44OTL6280498,75,28,15,13,1
SBI86LOR9015347,64,31,22,9,1
SBI56BLY6236051,85,27,14,13,1
SBI77QZR4580885,24,16,11,5,1
SBI46GXC2443211,64,13,7,6,1
SBI85WHN5709427,77,31,16,15,1
SBI05DVE6691355,22,23,18,5,1
SBI98OJR1290375,62,25,22,3,1
SBI83RQE5779336,96,27,23,4,1
SBI48OFA9091592,88,20,15,5,1
SBI97BUJ8610883,63,25,21,4,1
SBI24CUV1529414,86,29,16,13,1
SBI08QKP6218212,84,23,19,4,1
SBI51UWO3193230,80,20,16,4,1
SBI90PUT5300580,79,29,26,3,1
SBI42PGD3845995,82,24,22,2,1
SBI75QLF5463906,71,11,10,1,1
SBI83CQF0714066,97,15,11,4,1
SBI88FFL1420966,80,24,14,10,1
SBI57GCZ8180033,71,34,27,7,1
SBI23FDB8008400,95,21,17,4,1
SBI83LZL3250044,91,25,17,8,1
SBI04BRW5285788,20,25,20,5,1
SBI33UHV5844214,83,17,12,5,1
SBI32FNU9725637,19,25,22,3,1
SBI28BRB5208732,61,24,22,2,1
SBI11QLG8423907,25,26,23,3,1
SBI52YUD1036342,60,23,19,4,1
SBI90GTG7168677,99,19,10,9,1
SBI80YFY0707266,99,34,30,4,1
SBI88LBW0789038,78,28,22,6,1
SBI86EJP4360752,66,31,23,8,1
SBI67TYR9695630,25,24,22,2,1
SBI72FYS5797744,96,21,19,2,1
SBI48DWO8916969,79,20,14,6,1
SBI60XVP2927355,94,29,17,12,1
SBI22XLG5384364,83,26,22,4,1
SBI24OUX9015178,70,25,18,7,1
SBI13GRU2372944,94,24,21,3,1
SBI71PTR9325945,86,29,18,11,1
SBI05YTR3936772,60,32,20,12,1
SBI30BYU7169641,94,29,26,3,1
SBI60EML3544647,88,30,23,7,1
SBI46XRD7071346,72,28,15,13,1
SBI31YFW7348725,65,22,14,8,1
SBI00TNN3104913,91,20,17,3,1
SBI20VZS8346035,75,23,22,1,1
SBI66GLK9283802,72,20,11,9,1
SBI40HLH9040485,69,22,17,5,1
SBI92XGR8277631,90,29,16,13,1
SBI01TIR5446152,93,19,17,2,1
SBI97ULB8598852,64,21,12,9,1
SBI24QQI2492381,20,26,22,4,1
SBI65SCY3527632,23,22,12,10,1
SBI35VCE4306337,85,27,22,5,1
SBI20IEM7447571,88,21,16,5,1
SBI98CDG0364843,68,24,22,2,1
SBI31HRU8433555,18,29,26,3,1
SBI38HDQ4137334,89,26,16,10,1
SBI55ANT8292949,89,29,28,1,1
SBI10DYM9643236,24,30,25,5,1
SBI97ZPU9368517,84,25,22,3,1
SBI71PLU3474957,63,22,13,9,1
SBI38CVA0416252,69,18,11,7,1
SBI23OPM0509846,25,24,19,5,1
SBI04YZK1596093,72,18,15,3,1
SBI20DUX2112857,68,30,16,14,1
SBI71TMF2707746,95,31,23,8,1
SBI66VKE5344715,23,26,23,3,1
SBI05ZTS1723896,81,23,19,4,1
SBI67NPI0960652,85,25,18,7,1
SBI40FOW9255751,61,24,15,9,1
SBI93CUR5158895,97,30,23,7,1
SBI02MTX1868704,93,26,18,8,1
SBI60TPR1648385,60,20,12,8,1
SBI58LVK8847431,71,29,23,6,1
SBI61AUX3863134,88,33,23,10,1
SBI64IPQ8382855,25,19,13,6,1
SBI40VRT1901957,21,15,13,2,1
SBI60WVL1809291,75,28,22,6,1
SBI24MZE1858102,89,27,26,1,1
SBI56UTP3059321,90,29,21,8,1
SBI06OBU1603335,92,29,26,3,1
SBI10TTT6753888,20,19,13,6,1
SBI32SNU0767065,82,21,16,5,1
SBI53URN2913651,96,29,19,10,1
SBI84UDX6702892,88,18,15,3,1
SBI37EQZ8572910,84,26,17,9,1
SBI30EGU9769872,96,30,26,4,1
SBI58ZTH3621898,60,24,18,6,1
SBI58NGQ6022728,70,35,24,11,1
SBI27PQJ3346424,95,28,18,10,1
SBI76ETV1447086,92,21,12,9,1
SBI55YDQ3012441,67,20,12,8,1
SBI56QGD7065847,82,16,13,3,1
SBI46EYO6996959,79,13,7,6,1
SBI86IQR4934639,76,30,21,9,1
SBI54SZF9993914,82,25,18,7,1
SBI83XZY3459696,82,24,16,8,1
SBI25PTH6164311,84,22,18,4,1
SBI20NJT6433934,79,24,18,6,1
SBI70KTC8052234,25,21,20,1,1
SBI78BNO8362882,71,26,15,11,1
SBI84VMS9538164,80,24,23,1,1
SBI76HEO1855768,24,24,17,7,1
SBI80VOM6979726,67,30,25,5,1
SBI75XNP5286415,60,23,20,3,1
SBI16RDX5366229,80,26,17,9,1
SBI96ABS0200202,20,29,23,6,1
SBI86WUP3127576,60,30,28,2,1
SBI68WHH7805172,22,17,16,1,1
SBI67KVH7450260,22,18,10,8,1
SBI89SPC0400584,62,18,13,5,1
SBI05HRK5734439,71,17,16,1,1
SBI60YXM3160627,22,15,9,6,1
SBI96OPS3716354,21,29,17,12,1
SBI84ROL0073864,86,25,15,10,1
SBI13SGH4914208,21,31,21,10,1
SBI26NGY7110265,96,25,19,6,1
SBI46RXM9340671,91,31,29,2,1
SBI00NFH4666955,71,19,14,5,1
SBI48ENU5429998,76,29,24,5,1
SBI32ZSV8421207,94,11,7,4,1
SBI49FBY0491487,79,24,18,6,1
SBI62TMK9347801,61,26,14,12,1
SBI90NPK8776774,80,27,14,13,1
SBI27XNA8606725,89,23,19,4,1
SBI18GQJ6845036,86,24,14,10,1
SBI20LKF6315786,21,18,12,6,1
SBI70EDO1167277,67,29,20,9,1
SBI56FUZ7149822,71,19,10,9,1
SBI29HFM7077715,24,28,16,12,1
SBI73SVV9207914,63,23,19,4,1
SBI14BWD7490152,86,33,20,13,1
SBI80YFH6939309,87,22,17,5,1
SBI66KJT4520537,21,26,23,3,1
SBI34RKZ0426295,61,17,9,8,1
SBI61TWW9179115,68,26,19,7,1
SBI50LGB4376789,93,23,14,9,1
SBI11OGR2493468,83,12,8,4,1
SBI14SBQ2562537,25,18,17,1,1
SBI51BXK8140069,92,17,10,7,1
SBI36PGZ9478806,24,28,25,3,1
SBI60ENU5876250,72,25,17,8,1
SBI57DZC0634326,68,25,24,1,1
SBI38BXW6240143,95,26,25,1,1
SBI37YNB1650229,68,23,22,1,1
SBI23XAE6157140,93,22,15,7,1
SBI83FMT5204918,66,26,23,3,1
SBI46VFL9275465,99,29,20,9,1
SBI84XVP3319220,21,26,20,6,1
SBI65HCA5116253,86,23,21,2,1
SBI27IXE6087170,84,20,13,7,1
SBI19CYW3617568,86,21,20,1,1
SBI61UBJ9090089,84,21,20,1,1
SBI41YCN4037516,75,14,13,1,1
SBI39KSG4847651,96,27,18,9,1
SBI53CLT0837409,21,21,14,7,1
SBI52HKM0786136,78,18,11,7,1
SBI52ONI1501867,89,23,19,4,1
SBI65UIP7684597,85,22,16,6,1
SBI17YYX7045066,89,17,9,8,1
SBI86XST8367556,92,22,21,1,1
SBI97FIO3412916,97,27,16,11,1
SBI00MFT7369376,97,31,27,4,1
SBI77LPI1394076,18,21,12,9,1
SBI97LWP7233335,99,25,18,7,1
SBI84LTC6569252,84,18,15,3,1
SBI37LII9038992,87,30,21,9,1
SBI39WRL2657329,70,31,22,9,1
SBI60TQB6510366,90,24,13,11,1
SBI61JJR7463597,84,24,17,7,1
SBI41HQB2746498,64,27,22,5,1
SBI79DCI0523803,75,32,27,5,1
SBI97NVO6517127,22,26,25,1,1
SBI20XZX0009985,94,25,14,11,1
SBI00CNE0668984,63,25,18,7,1
SBI70WEF4511797,73,23,15,8,1
SBI62WQB3849906,92,25,21,4,1
SBI79FQC0986413,66,25,20,5,1
SBI70LTK2132032,21,25,14,11,1
SBI96JWD7182136,60,19,13,6,1
SBI04MVZ5485098,79,17,13,4,1
SBI33IKE4913813,21,26,17,9,1
SBI72WKD5584323,84,26,24,2,1
SBI26LWL7041252,81,27,14,13,1
SBI41VLC6739642,79,21,11,10,1
SBI49CAT5706576,90,21,15,6,1
SBI17FEW8399599,96,27,18,9,1
SBI98OES3971517,81,29,25,4,1
SBI81YIF4661796,90,18,16,2,1
SBI01MOJ1015336,73,17,9,8,1
SBI27MVR3905893,88,33,26,7,1
SBI59YCN6532136,83,31,20,11,1
SBI72JMI5575402,91,36,28,8,1
SBI45VYG2657925,84,22,20,2,1
SBI54TBB4215313,82,28,21,7,1
SBI43LRU6690185,94,21,11,10,1
SBI04FJZ4757499,81,28,25,3,1
SBI56VHF5834641,68,35,33,2,1
SBI44IXE8442804,73,24,18,6,1
SBI34CGP4568318,73,22,15,7,1
SBI95JTO3667151,85,27,21,6,1
SBI23OCJ5062101,79,12,10,2,1
SBI86CZT0293036,21,21,18,3,1
SBI11BLZ2267618,99,25,24,1,1
SBI66URD9976591,94,24,13,11,1
SBI85MGY7500104,91,26,14,12,1
SBI87QKE6267670,60,25,20,5,1
SBI19GKJ6972004,18,25,22,3,1
SBI16NFQ8865011,98,27,22,5,1
SBI29ZIN2844711,89,25,17,8,1
SBI04IGZ1020280,76,23,13,10,1
SBI31AQE7014307,94,27,16,11,1
SBI16JYM1053866,64,24,22,2,1
SBI63APG1514904,67,32,24,8,1
SBI88NTB7686951,94,39,31,8,1
SBI05DBG0631191,24,20,17,3,1
SBI00BLM6824101,94,20,13,7,1
SBI99NFD5932266,18,20,11,9,1
SBI81KQH8202719,79,26,25,1,1
SBI84VKH8581284,90,34,24,10,1
SBI70HWS2414018,78,23,18,5,1
SBI87YLU7495458,24,28,17,11,1
SBI72DFI5525044,95,22,18,4,1
SBI37JNV4690675,19,27,16,11,1
SBI68XED6068219,75,29,24,5,1
SBI71WIJ7955621,64,15,8,7,1
SBI68ZQV3428944,65,18,16,2,1
SBI92YTL4104928,76,32,21,11,1
SBI99VON6437943,66,13,8,5,1
SBI45VXU9792793,65,26,16,10,1
SBI71AAZ4083802,71,21,16,5,1
SBI38LEY6508283,63,22,13,9,1
SBI05LTF4541546,69,20,16,4,1
SBI31EVB6197660,24,24,18,6,1
SBI23QHG9644689,78,28,19,9,1
SBI79ULY7733793,86,20,14,6,1
SBI23SXJ2726656,70,30,23,7,1
SBI73CEH7537254,91,24,16,8,1
SBI81IMI4314797,22,33,27,6,1
SBI57DAO0043308,68,19,13,6,1
SBI65DAK1404586,60,28,27,1,1
SBI29NTY5740311,86,18,13,5,1
SBI32MGT9530570,89,25,16,9,1
SBI90RZH8660218,86,27,17,10,1
SBI52NXQ3951519,60,25,17,8,1
SBI13SVG6813240,98,22,15,7,1
SBI84WGA2228262,65,23,16,7,1
SBI80DJB7654367,18,27,18,9,1
SBI34KDE8429699,70,25,22,3,1
SBI17PRF3669561,64,34,32,2,1
SBI59VGN7710254,82,23,16,7,1
SBI17KLX0458946,80,17,9,8,1
SBI51OFH3407348,93,23,14,9,1
SBI51TZD4092137,77,23,13,10,1
SBI68QFH9551131,74,17,14,3,1
SBI24DIB1720695,23,29,28,1,1
SBI83ILA3688167,75,23,22,1,1
SBI12PWS8094460,19,28,26,2,1
SBI67MBE4753938,81,24,20,4,1
SBI45ISU8123547,82,20,19,1,1
SBI00PQO4233382,60,23,18,5,1
SBI15GWN5613780,61,22,18,4,1
SBI87QTW7598366,66,30,21,9,1
SBI38HLR7708659,66,16,15,1,1
SBI84CTQ5669129,80,30,25,5,1
SBI86GCI1578161,74,31,19,12,1
SBI61IDV4490388,75,36,27,9,1
SBI13RTX3592737,88,29,19,10,1
SBI01FGI3271238,60,27,18,9,1
SBI87NFW1883274,71,24,18,6,1
SBI00VND0239360,20,19,14,5,1
SBI74MXA1130638,22,21,20,1,1
SBI71QCM0609405,18,20,12,8,1
SBI69VGP0654794,98,23,14,9,1
SBI27AHO3593779,63,22,19,3,1
SBI81OYP4546027,24,23,17,6,1
SBI54LND4642688,95,26,18,8,1
SBI33FQT0556739,70,17,14,3,1
SBI19QQL7713734,79,18,10,8,1
SBI52TYM8287399,86,24,13,11,1
SBI48ZEU0111545,18,22,13,9,1
SBI77UTM3906653,20,24,19,5,1
SBI93EZH3107685,78,22,16,6,1
SBI17FTK6832775,88,22,19,3,1
SBI44KBZ5394089,25,31,22,9,1
SBI62FNL7156342,66,25,19,6,1
SBI93FII6937891,85,18,15,3,1
SBI68DOR7107140,62,35,20,15,1
SBI88UDV3359270,93,14,13,1,1
SBI74NJK0094335,76,23,15,8,1
SBI25TSG9109020,19,29,26,3,1
SBI36IZN0885591,74,31,30,1,1
SBI21LQY0822111,84,26,17,9,1
SBI48VEP7141559,97,31,24,7,1
SBI54ZFM6108473,21,22,21,1,1
SBI95SEW7085479,71,22,18,4,1
SBI54GPE2470748,21,20,18,2,1
SBI09IGQ2900057,97,18,15,3,1
SBI54UBA8217190,94,23,21,2,1
SBI30QRN7621181,22,24,21,3,1
SBI90VAE4797147,65,27,22,5,1
SBI36ZHA1626958,74,29,15,14,1
SBI14AOP1809868,82,23,22,1,1
SBI47PSC5665972,90,27,15,12,1
SBI64ETF6988712,70,20,15,5,1
SBI68HMX6366090,18,25,16,9,1
SBI37FGW4412597,97,17,15,2,1
SBI47BIL0848353,22,29,18,11,1
SBI45ZYT5136028,76,18,17,1,1
SBI51XCU9385119,71,30,16,14,1
SBI64QPY2287963,72,25,18,7,1
SBI16IJC9573011,60,23,14,9,1
SBI81THQ8265508,78,26,17,9,1
SBI25ZKQ2603395,62,22,20,2,1
SBI31WJI6540953,75,14,11,3,1
SBI38DZL9229542,18,16,14,2,1
SBI40PFP9629682,61,26,21,5,1
SBI73SUD4848647,84,24,13,11,1
SBI35RJT7027860,77,19,12,7,1
SBI73WYE2076523,73,19,13,6,1
SBI01NGF9981278,62,24,19,5,1
SBI21XUK3787668,97,22,21,1,1
SBI82OQB8926166,99,20,11,9,1
SBI71RLT6064559,85,25,18,7,1
SBI45POS0297826,85,25,24,1,1
SBI36PHC8918673,72,21,15,6,1
SBI61UNF2977528,20,26,22,4,1
SBI42YVJ3774026,20,16,14,2,1
SBI74IYB4206262,90,11,9,2,1
SBI03DSS7280129,63,29,22,7,1
SBI03BVT1103259,18,28,26,2,1
SBI48HRY9530741,71,25,24,1,1
SBI93QWZ0152987,22,26,22,4,1
SBI07GIX5136456,79,15,13,2,1
SBI33QQE2097175,61,32,29,3,1
SBI04SKX3577038,72,23,21,2,1
SBI89HWP9401597,62,26,24,2,1
SBI37UPX7723859,69,23,14,9,1
SBI30YGC7049682,88,24,22,2,1
SBI53WSA1970799,94,29,19,10,1
SBI77WFU4351501,86,22,16,6,1
SBI10NZY5105588,66,25,24,1,1
SBI89ZCC0633900,84,21,18,3,1
SBI50PXO2565444,25,27,22,5,1
SBI55WFZ1338928,69,31,16,15,1
SBI07ORB2067370,60,29,17,12,1
SBI99OLY7414213,82,20,12,8,1
SBI25WAC6627035,69,20,15,5,1
SBI00ZES7364238,67,21,18,3,1
SBI84RWN3222114,95,28,16,12,1
SBI40BRE9554482,96,26,22,4,1
SBI97EMT8080308,96,24,21,3,1
SBI73SYM5550099,72,22,14,8,1
SBI83OGS4790898,21,13,8,5,1
SBI61HDP6858704,68,23,22,1,1
SBI96WGU1068391,80,26,14,12,1
SBI98YUU0715312,86,22,13,9,1
SBI42AFF2014733,25,30,16,14,1
SBI26DAJ5587009,25,29,21,8,1
SBI26FPE7209423,72,14,13,1,1
SBI25MLG5467835,25,19,14,5,1
SBI70DGG4827582,74,25,15,10,1
SBI09JLK5560714,89,22,12,10,1
SBI55QZM4622010,24,20,16,4,1
SBI20CJA4830177,61,37,36,1,1
SBI74RND8933072,61,21,20,1,1
SBI61JHP6276387,81,28,20,8,1
SBI20KMY0153045,67,26,17,9,1
SBI36WSQ7755987,64,21,11,10,1
SBI21GZB7958589,73,13,8,5,1
SBI57VKD3619051,86,29,28,1,1
SBI08SWI9604910,72,34,24,10,1
SBI99KMQ3094914,88,26,25,1,1
SBI26HYN7614889,24,20,17,3,1
SBI15JWX7432807,80,31,27,4,1
SBI57XLS0357903,19,25,19,6,1
SBI61NQF7809824,79,26,24,2,1
SBI15IDA2667409,60,22,21,1,1
SBI11HLN5268338,69,26,16,10,1
SBI39NHI8446392,63,21,15,6,1
SBI70HJS6485411,77,33,28,5,1
SBI85ZGR2302389,70,21,18,3,1
SBI25UWL8577737,24,36,23,13,1
SBI55XTA4245388,69,24,17,7,1
SBI20DFF0595163,93,25,17,8,1
SBI34RXY1095984,24,24,21,3,1
SBI49EBZ4249275,18,22,13,9,1
SBI95AHO3842106,23,24,21,3,1
SBI30AYR2791425,88,24,13,11,1
SBI58CYI6819559,75,25,24,1,1
SBI86DJH0113706,25,28,18,10,1
SBI18EPB9510635,24,25,22,3,1
SBI48FVV4859653,88,25,18,7,1
SBI04BWH0326277,99,26,14,12,1
SBI69KQB9455951,82,23,21,2,1
SBI82SLK3473449,20,21,15,6,1
SBI62SQL4585981,77,15,14,1,1
SBI63KON5669780,92,25,20,5,1
SBI69TIH2578913,71,17,12,5,1
SBI20OUU9614647,22,17,10,7,1
SBI03ZOI7376347,20,23,15,8,1
SBI75KAP9216143,83,20,11,9,1
SBI37BBM2560667,65,20,14,6,1
SBI62MNF0019682,82,19,15,4,1
SBI15MSJ3772831,67,26,19,7,1
SBI45GQP7632883,99,28,23,5,1
SBI46IXJ5671855,76,24,21,3,1
SBI40DLQ3508314,88,21,18,3,1
SBI57SNK5903427,74,27,24,3,1
SBI48YSD0457529,67,33,30,3,1
SBI72EZR9446823,92,23,20,3,1
SBI84DFR0592130,70,23,13,10,1
SBI85HRW9816738,25,32,19,13,1
SBI54CPA2926198,90,23,20,3,1
SBI43MHA8827628,93,25,18,7,1
SBI09TCU6792233,71,25,14,11,1
SBI69EEH4697169,60,24,21,3,1
SBI67VLQ6589433,19,19,12,7,1
SBI38HAR5010470,98,26,20,6,1
SBI42TLX2607580,97,32,27,5,1
SBI97WBP1968724,93,23,21,2,1
SBI52MQR0601772,82,21,12,9,1
SBI42EJK6241303,66,20,17,3,1
SBI59PIY3157420,18,36,31,5,1
SBI02YPC2839728,78,33,25,8,1
SBI37PGT1482088,65,25,13,12,1
SBI20YUN5320979,82,26,21,5,1
SBI32FNU2264501,21,27,20,7,1
SBI46ATC8713282,87,24,16,8,1
SBI02MYL1719038,96,30,25,5,1
SBI22TEX6926872,62,30,24,6,1
SBI84CZL2166746,89,24,19,5,1
SBI17OCK1818501,86,27,21,6,1
SBI40TPC7718930,22,22,16,6,1
SBI57WCZ8973845,21,20,18,2,1
SBI61RHC6748675,80,24,13,11,1
SBI01WQW7665015,74,24,21,3,1
SBI44JPS0287969,23,21,12,9,1
SBI86SUO7962346,76,32,22,10,1
SBI00BDV2257424,20,17,10,7,1
SBI07RIN8602987,82,19,12,7,1
SBI05TYI6099643,84,23,12,11,1
SBI00SDP0461039,25,27,14,13,1
SBI35KYF4467083,86,24,20,4,1
SBI46LRP8372708,77,26,17,9,1
SBI18MUA4115604,68,24,23,1,1
SBI93ZMU9759043,99,22,13,9,1
SBI91IEZ9650031,19,27,16,11,1
SBI21BHT8584246,20,21,17,4,1
SBI56QCC3642020,23,24,22,2,1
SBI38CIF0224978,89,22,12,10,1
SBI46QOE8532250,92,23,19,4,1
SBI20GAV2753723,23,35,22,13,1
SBI79UHY7176369,24,22,20,2,1
SBI48BFL8386770,66,33,18,15,1
SBI38PHY3744061,70,26,23,3,1
SBI56ZDB0024155,71,26,24,2,1
SBI90RIF5247990,68,24,20,4,1
SBI90NWK0257982,61,24,19,5,1
SBI86HWS6916132,88,24,17,7,1
SBI09OMO0231168,65,39,37,2,1
SBI44KAC2664530,90,24,13,11,1
SBI19XHC4333791,69,19,15,4,1
SBI63CSP4256451,25,29,22,7,1
SBI25SPH3568775,79,17,11,6,1
SBI19AXK5508300,20,20,13,7,1
SBI40AGE6005004,68,27,23,4,1
SBI11JAM2525254,71,21,14,7,1
SBI08ZQS3861852,82,34,28,6,1
SBI90XFV8776602,77,32,21,11,1
SBI36IOD4310237,97,24,21,3,1
SBI77SFL7993469,24,26,15,11,1
SBI83TLB7435811,78,24,23,1,1
SBI15IXS7971978,95,30,21,9,1
SBI60JDB0684815,89,22,15,7,1
SBI70PZG4277954,94,30,17,13,1
SBI06KSD2520871,75,40,21,19,1
SBI58RRT8455925,93,32,29,3,1
SBI85LQC0595624,69,25,19,6,1
SBI18YPI8514282,94,14,10,4,1
SBI79QWU7513716,97,29,26,3,1
SBI05RCC0651346,23,25,21,4,1
SBI96XAK7256944,65,25,20,5,1
SBI04ZTD7113458,95,22,14,8,1
SBI06PYD7678376,86,24,23,1,1
SBI91UWF8435432,76,19,14,5,1
SBI05ERR0139373,89,19,12,7,1
SBI75EEZ8520467,63,18,11,7,1
SBI80TJH2258905,65,25,15,10,1
SBI56HCG5404137,60,25,20,5,1
SBI36OAD4830402,91,26,15,11,1
SBI89ZIX5433900,24,22,19,3,1
SBI79ZBP4965841,61,16,10,6,1
SBI18WMQ1245772,78,18,12,6,1
SBI83FRC0241267,80,22,15,7,1
SBI68OGW1916522,72,28,24,4,1
SBI71BCS5506569,96,21,14,7,1
SBI13QPB6356905,68,25,15,10,1
SBI68ABG4048177,79,25,24,1,1
SBI14KCC3066412,70,27,14,13,1
SBI03JKZ8023753,78,27,23,4,1
SBI38PTD4619289,73,23,13,10,1
SBI30LFI3874190,64,27,18,9,1
SBI90KZW9810054,68,30,23,7,1
SBI46IJG9014716,67,25,21,4,1
SBI21SZB5229539,24,22,16,6,1
SBI03VUB9854410,65,22,16,6,1
SBI74DMV4415636,80,19,18,1,1
SBI85JUN8649375,95,25,16,9,1
SBI93PDM2215236,98,31,16,15,1
SBI34QGW8625744,69,23,14,9,1
SBI56KVP8968019,74,20,13,7,1
SBI88SUV3707662,70,26,22,4,1
SBI23SOQ6598565,91,26,21,5,1
SBI11ZNE1264004,70,26,23,3,1
SBI24ZON9358212,81,28,23,5,1
SBI39FZM8559295,25,30,22,8,1
SBI30BNI0890759,22,20,14,6,1
SBI84IHD2242600,97,23,20,3,1
SBI27TVK1160914,75,22,19,3,1
SBI19SSB7409837,74,18,11,7,1
SBI58EUJ7120562,88,13,7,6,1
SBI96WAY3403190,25,15,11,4,1
SBI85YNC2706770,98,22,17,5,1
SBI43LLQ1581443,66,28,18,10,1
SBI85AJJ0222608,88,22,12,10,1
SBI84YTW0504603,81,20,14,6,1
SBI96VML4938856,19,25,19,6,1
SBI95KJJ9943538,98,25,17,8,1
SBI32QHN4808588,95,28,23,5,1
SBI65HLB7955891,75,26,18,8,1
SBI92UNZ6450561,60,21,17,4,1
SBI94SRR2157133,88,20,18,2,1
SBI76PBL2070698,25,25,21,4,1
SBI21YKQ0924589,74,29,18,11,1
SBI06WVP9795025,78,26,23,3,1
SBI64HUP5959161,64,24,17,7,1
SBI40MYS4590468,23,23,21,2,1
SBI58RDY3812785,76,28,20,8,1
SBI81FVD9677593,95,29,27,2,1
SBI24WYW7177038,22,27,24,3,1
SBI50KPJ8486972,87,30,27,3,1
SBI80TSF6457243,87,26,17,9,1
SBI37VJN6436651,21,23,21,2,1
SBI65QNN1987206,66,30,28,2,1
SBI72CZQ0440536,93,26,24,2,1
SBI12LXU1403423,76,27,23,4,1
SBI87QIY8629757,99,26,23,3,1
SBI56LXM4688035,23,23,16,7,1
SBI65GLX8151524,60,25,17,8,1
SBI40PZN4733307,96,22,15,7,1
SBI75CVN3914082,18,20,11,9,1
SBI72TDD0160843,71,18,14,4,1
SBI99FDT4990585,19,37,27,10,1
SBI75WML4316803,92,30,18,12,1
SBI56HCJ5776230,22,23,18,5,1
SBI85VNJ7090559,64,23,14,9,1
SBI48KTP0002199,73,29,15,14,1
SBI21JNY6859709,62,25,20,5,1
SBI63YOF7870574,25,32,30,2,1
SBI13GGW1877414,97,16,12,4,1
SBI10YIW8465405,76,33,24,9,1
SBI82JUY8921440,87,25,19,6,1
SBI12OJR9029685,86,16,13,3,1
SBI79THJ2652625,76,21,18,3,1
SBI26QYS4112423,20,26,22,4,1
SBI73EDB9151205,92,32,29,3,1
SBI92MVQ7316621,76,21,19,2,1
SBI50OKS3585303,80,21,16,5,1
SBI16DWR3115750,99,32,21,11,1
SBI77VZD8611843,22,18,12,6,1
SBI06LTF6248954,61,23,15,8,1
SBI93LXW5180611,74,17,16,1,1
SBI61TMC7837819,24,18,10,8,1
SBI79SGE5450508,73,25,22,3,1
SBI59ZXQ8863457,89,23,14,9,1
SBI56FOO4227043,81,29,28,1,1
SBI69BKJ5248244,60,19,12,7,1
SBI91HXC9266981,61,28,20,8,1
SBI38LYY9862924,70,31,17,14,1
SBI42TFE8482369,19,21,11,10,1
SBI56HHM9403771,68,25,24,1,1
SBI10STB1111921,66,23,12,11,1
SBI50PWX7539548,81,28,21,7,1
SBI85UKJ7692280,62,26,18,8,1
SBI24WJH2155340,83,26,14,12,1
SBI65QEN6376148,21,20,18,2,1
SBI72EQS8422056,73,16,13,3,1
SBI97UHJ4693967,61,24,17,7,1
SBI38HEH1056914,81,36,29,7,1
SBI52UNL3374297,79,25,23,2,1
SBI96SUH6676717,80,22,15,7,1
SBI12IUF0508323,24,21,18,3,1
SBI29CJT8442628,67,25,13,12,1
SBI39VYN0537589,84,25,15,10,1
SBI35DPD0893340,91,17,9,8,1
SBI77VJV6637480,93,16,13,3,1
SBI88AXS0895596,18,28,15,13,1
SBI59YVD6313531,73,31,28,3,1
SBI70NGA8804591,70,22,17,5,1
SBI14UQW4730937,76,26,23,3,1
SBI34JNK3002106,21,22,21,1,1
SBI83RQO1547959,62,22,14,8,1
SBI25IKZ0528118,75,17,9,8,1
SBI76BFZ5322760,98,19,12,7,1
SBI52DOR4252371,84,29,20,9,1
SBI69PBV8659252,99,23,18,5,1
SBI32PRK3807233,98,30,17,13,1
SBI31WAM7563443,74,18,12,6,1
SBI76GKX7163561,87,31,21,10,1
SBI63OWW7503160,22,18,12,6,1
SBI95YOV0805351,67,27,16,11,1
SBI27YDW6793233,62,22,12,10,1
SBI00OMW0814120,78,24,17,7,1
SBI47BCR8002611,67,19,13,6,1
SBI36DRD2449190,62,27,23,4,1
SBI89ANW4843512,25,24,18,6,1
SBI87TPP6273914,92,23,12,11,1
SBI48TCT9536785,79,27,17,10,1
SBI64TQE5900780,19,21,13,8,1
SBI37SMV3641922,20,30,19,11,1
SBI16KKE7314091,87,27,15,12,1
SBI40YZR1663334,24,27,21,6,1
SBI39EKO5254202,85,20,13,7,1
SBI79NZS3849567,89,27,16,11,1
SBI90DIP6380382,65,26,16,10,1
SBI39HLU9497590,96,31,16,15,1
SBI51VJF2362228,62,19,10,9,1
SBI62WEC8308789,87,20,13,7,1
SBI97DEU1004277,72,28,27,1,1
SBI14HEF8011272,72,25,21,4,1
SBI14NJR8291248,66,33,17,16,1
SBI05EPN7554315,72,24,20,4,1
SBI56DDJ8528306,82,24,13,11,1
SBI64NLO1303384,23,23,18,5,1
SBI81JON6031517,60,23,20,3,1
SBI51EJT0868968,87,22,15,7,1
SBI08SBN6285331,91,21,13,8,1
SBI66ULN2740905,99,33,19,14,1
SBI13DYP3079792,19,27,14,13,1
SBI09POF6640507,81,21,14,7,1
SBI31GTM7870670,21,23,17,6,1
SBI65OPU9621339,60,23,20,3,1
SBI99BBY1274723,98,33,27,6,1
SBI07QSR0739506,82,28,15,13,1
SBI93XHS2057134,72,30,16,14,1
SBI34TEM0907363,95,15,14,1,1
SBI32FBT0223528,96,26,20,6,1
SBI98WPN6731547,74,27,18,9,1
SBI61DCP7471821,63,19,15,4,1
SBI85AID4420266,74,23,13,10,1
SBI98KAS6585032,61,33,27,6,1
SBI48HAP9863642,96,17,9,8,1
SBI78KOY7932245,23,18,11,7,1
SBI71KMF5081254,71,28,23,5,1
SBI83CNJ5132263,88,23,17,6,1
SBI58ZBR1869077,70,25,22,3,1
SBI24YJR1007601,84,19,17,2,1
SBI71WQK8830574,69,21,19,2,1
SBI72LET8670359,85,33,24,9,1
SBI18EFN2154432,95,21,13,8,1
SBI85UMF4312674,93,25,18,7,1
SBI44KPK5412564,22,25,22,3,1
SBI14MAJ8912894,91,26,21,5,1
SBI50BWQ0880386,86,32,31,1,1
SBI70UQY1084404,83,32,26,6,1
SBI74UKK3761065,62,22,13,9,1
SBI19LDI2222562,22,22,18,4,1
SBI04ZHB6181153,90,22,16,6,1
SBI70DCW2960521,64,23,22,1,1
SBI10IOX0289811,25,37,20,17,1
SBI80VCV9422348,21,27,24,3,1
SBI37OUZ9830109,25,29,28,1,1
SBI13VRP4108291,69,35,30,5,1
SBI83CNL6017042,85,23,17,6,1
SBI46HIZ8324330,19,28,17,11,1
SBI50EVW7555842,92,25,23,2,1
SBI35FRM6283495,92,31,17,14,1
SBI18LEF2345271,66,31,28,3,1
SBI95MKR9344105,99,25,13,12,1
SBI28CUM2664873,91,26,18,8,1
SBI53GYG8081675,80,28,21,7,1
SBI50TMS2154538,70,32,30,2,1
SBI60NJS0246230,93,25,24,1,1
SBI60OFO0277236,77,20,13,7,1
SBI52DAR8660484,20,28,26,2,1
SBI02JMO2418163,98,26,23,3,1
SBI34KUP5867289,64,35,28,7,1
SBI91KWF2056089,97,17,12,5,1
SBI00GPQ8433234,62,24,16,8,1
SBI63PLQ0090860,99,30,22,8,1
SBI04QGO4379253,78,24,18,6,1
SBI69SMG2465741,79,36,22,14,1
SBI95WZW2096494,75,26,21,5,1
SBI33JAW0482523,82,32,28,4,1
SBI29XWP3708887,21,24,17,7,1
SBI21OQH9366458,92,19,14,5,1
SBI97RDG1500855,67,28,18,10,1
SBI05JTD0167153,89,34,24,10,1
SBI59QDZ7548577,19,28,20,8,1
SBI24XTP7331043,87,17,11,6,1
SBI50JKV8461905,69,30,22,8,1
SBI08ADW0523882,64,31,21,10,1
SBI56ORU2591165,68,29,28,1,1
SBI66ILH5804074,97,29,20,9,1
SBI34WHE3902690,97,19,13,6,1
SBI46HZK9194013,98,25,20,5,1
SBI01HHB9254467,75,26,24,2,1
SBI71TCY7233492,69,31,28,3,1
SBI90QBH7302366,21,21,13,8,1
SBI59RGH9419994,97,24,14,10,1
SBI67OJV9778428,61,23,17,6,1
SBI84RSZ3044286,70,28,20,8,1
SBI33NGO2105336,87,27,25,2,1
SBI07SQI6623943,95,27,17,10,1
SBI08DUW9033677,74,21,16,5,1
SBI10RAA9143666,61,22,13,9,1
SBI88ZTT0704138,73,29,22,7,1
SBI76IWQ6898676,66,27,25,2,1
SBI00ZIM2069970,75,29,20,9,1
SBI05JIU4781691,24,23,15,8,1
SBI63ZUH8510467,62,28,17,11,1
SBI79KNG6279786,72,25,17,8,1
SBI52FPY1419770,71,15,13,2,1
SBI47NJM2662239,63,24,15,9,1
SBI40MWE3478218,72,33,30,3,1
SBI97KPB0653014,88,25,15,10,1
SBI12YBA9125074,67,27,25,2,1
SBI28HGH6233045,91,31,29,2,1
SBI56AZO6897055,91,33,17,16,1
SBI77YQP1194453,76,19,17,2,1
SBI04AAZ2221735,75,21,13,8,1
SBI28FPC6455850,76,27,16,11,1
SBI97ZXW7866795,18,21,11,10,1
SBI47GQA1598301,82,26,24,2,1
SBI06BRB0576300,92,24,17,7,1
SBI63FMM0734324,87,17,16,1,1
SBI57KHY0632049,67,30,19,11,1
SBI37DMZ8968661,61,27,21,6,1
SBI54QEV7527562,89,29,27,2,1
SBI12CIJ3551024,85,17,12,5,1
SBI41VQN1110956,67,28,25,3,1
SBI55EGU3759426,87,19,13,6,1
SBI21ETA6273948,68,22,19,3,1
SBI68HMZ5593833,77,18,12,6,1
SBI09QPP3837787,21,15,14,1,1
SBI20MLV4127240,99,19,12,7,1
SBI16CCI1513222,62,16,13,3,1
SBI69LPZ6082818,79,23,18,5,1
SBI41OON4389783,72,25,22,3,1
SBI33YIY0307016,21,29,15,14,1
SBI33USK3857556,90,24,15,9,1
SBI64IAN0291071,95,23,19,4,1
SBI65PBR1462571,74,21,19,2,1
SBI72ZJG5375852,70,25,15,10,1
SBI96WRT4614108,80,24,23,1,1
SBI90URA1577180,68,24,16,8,1
SBI45ZUU1616564,78,19,17,2,1
SBI73KDX1305323,70,25,18,7,1
SBI79NGV2559924,95,23,15,8,1
SBI38JJT5630496,85,24,18,6,1
SBI77SHG6662036,24,20,19,1,1
SBI17XFU9910361,90,18,13,5,1
SBI94TRL7758748,18,30,18,12,1
SBI73RJP8402506,94,28,21,7,1
SBI89JTK3456821,87,31,30,1,1
SBI00FTC6391089,76,23,12,11,1
SBI26LJN5230621,20,24,18,6,1
SBI19KYQ1513711,21,30,23,7,1
SBI25ARY6745596,72,26,22,4,1
SBI92CYM2611802,95,23,13,10,1
SBI01AIV7463826,78,23,15,8,1
SBI44XLY8759279,79,19,17,2,1
SBI07MJK6150903,62,23,18,5,1
SBI48NVN9094870,86,28,22,6,1
SBI99KZG8112198,63,20,19,1,1
SBI03UMV7155941,65,21,14,7,1
SBI84XCA4284156,25,33,24,9,1
SBI44JMC8692156,92,26,25,1,1
SBI24QJO7951109,22,30,23,7,1
SBI05IEL0285477,64,21,12,9,1
SBI53GHX5975466,61,24,18,6,1
SBI08BYY1098126,76,23,18,5,1
SBI40DXG7173358,66,19,10,9,1
SBI77DBE2713127,91,27,17,10,1
SBI83VSG4937567,81,23,15,8,1
SBI80KFK7709768,21,20,17,3,1
SBI57TOD5449749,79,33,17,16,1
SBI89NGG9174258,93,23,16,7,1
SBI41TKW1348468,98,30,22,8,1
SBI35OOR8995956,72,23,20,3,1
SBI25KWX8977774,89,14,8,6,1
SBI67OKZ3296325,93,25,17,8,1
SBI42CQT9827090,72,16,11,5,1
SBI83NKB4600418,91,22,13,9,1
SBI23KWR6683405,90,31,18,13,1
SBI26LDU6814065,96,27,21,6,1
SBI58QXN4759227,82,22,16,6,1
SBI56ZGH2100298,72,25,20,5,1
SBI74UDX3683526,61,26,19,7,1
SBI78WYK6185232,71,29,28,1,1
SBI71WAL9384983,67,22,16,6,1
SBI69BKC7715348,87,24,20,4,1
SBI17TCG5122544,75,33,30,3,1
SBI32KHX8262774,85,25,21,4,1
SBI03KUM2258837,79,27,20,7,1
SBI74XPT7609956,98,24,21,3,1
SBI62TCN3320019,60,21,19,2,1
SBI15UAR2054107,18,28,23,5,1
SBI08WQR1966638,64,26,22,4,1
SBI20JHR9928793,67,21,20,1,1
SBI46WTW5978996,72,18,16,2,1
SBI51ZAU4931284,74,30,18,12,1
SBI16COD1128090,99,21,14,7,1
SBI20QIE9486921,96,21,15,6,1
SBI94HIU8442990,73,22,13,9,1
SBI48YON0975672,84,20,14,6,1
SBI07NIR8322702,96,24,19,5,1
SBI65IRV4764081,91,21,19,2,1
SBI17JIL8169189,70,30,27,3,1
SBI79BMF9372760,82,20,11,9,1
SBI93KFS1005646,65,20,17,3,1
SBI68FGL0703560,19,27,25,2,1
SBI25DGE7245503,83,24,19,5,1
SBI35CYN1645174,20,35,18,17,1
SBI27QQN4075234,87,24,18,6,1
SBI81AUT5476945,74,28,22,6,1
SBI17JTN2883451,66,23,17,6,1
SBI21MTQ7333429,73,24,19,5,1
SBI59OZH2562549,76,14,11,3,1
SBI26CFS3376040,84,13,12,1,1
SBI25EHW0874955,94,26,16,10,1
SBI49JUB6346833,62,28,17,11,1
SBI08SXS3632909,62,25,21,4,1
SBI62ADL6431336,67,20,13,7,1
SBI09QLN0546189,97,38,24,14,1
SBI88IAK5095607,70,24,23,1,1
SBI87GKM7326073,18,23,12,11,1
SBI77NRB6451982,86,23,20,3,1
SBI02YVG5955000,82,37,35,2,1
SBI30DHZ7497802,69,34,18,16,1
SBI83VAA2037594,64,23,12,11,1
SBI72TBF3926416,24,28,19,9,1
SBI35YIK2769730,24,21,16,5,1
SBI53PJA0335170,94,24,19,5,1
SBI13BBI0745325,97,25,19,6,1
SBI07ZKS7731389,99,15,12,3,1
SBI99MSD3680669,97,29,27,2,1
SBI18AKE8824315,65,23,13,10,1
SBI44SAQ5991193,97,24,20,4,1
SBI82FHF0133374,92,28,24,4,1
SBI33FSK4479651,21,24,15,9,1
SBI46ODZ5166924,67,25,21,4,1
SBI83ZOG8199725,96,27,23,4,1
SBI18GCG1398214,72,16,12,4,1
SBI63XJM6304595,21,24,23,1,1
SBI33SYS4971896,25,29,16,13,1
SBI19GZA0617060,23,30,18,12,1
SBI75FQU7594331,93,30,16,14,1
SBI44RIM2789269,88,20,12,8,1
SBI44YFW2474211,97,24,21,3,1
SBI23ZTT7132561,65,22,15,7,1
SBI49WIJ1178671,21,19,14,5,1
SBI11GRQ9244563,62,23,17,6,1
SBI15CBJ7263880,72,28,19,9,1
SBI43ZEW2767731,60,26,22,4,1
SBI33MNT1164028,90,8,5,3,1
SBI41LCP2666338,97,25,15,10,1
SBI49SKR6796676,94,21,20,1,1
SBI26TCW5534258,25,24,16,8,1
SBI58IWS2947108,68,19,17,2,1
SBI15GBU3200492,19,25,19,6,1
SBI78RQB2663893,20,34,33,1,1
SBI01KFW5031650,62,20,16,4,1
SBI32DPY6781380,65,27,24,3,1
SBI55IRK5078876,66,21,14,7,1
SBI47UIG1203791,92,29,25,4,1
SBI04OWO0416953,91,26,14,12,1
SBI59VAE9955057,67,17,13,4,1
SBI87MQM4207585,23,23,14,9,1
SBI86FRD7844211,75,28,26,2,1
SBI97RIT1911523,98,23,12,11,1
SBI63PBT1466833,78,26,23,3,1
SBI69BHC4251409,99,30,26,4,1
SBI98PEJ4347773,77,22,15,7,1
SBI61EOC2913117,61,23,14,9,1
SBI36SWR0834769,92,22,18,4,1
SBI87UZH2876419,90,18,17,1,1
SBI78DXL8976985,70,20,13,7,1
SBI66LLT2687931,88,24,17,7,1
SBI47FHB6189475,66,29,15,14,1
SBI20FHF5862544,86,21,13,8,1
SBI17PUU3620922,18,16,12,4,1
SBI39FBC9923634,96,29,20,9,1
SBI01NRP0331584,87,16,9,7,1
SBI85TGK7596301,85,25,15,10,1
SBI74ODJ4966941,97,31,25,6,1
SBI16XMO3688038,67,17,10,7,1
SBI02JHR7537682,94,20,18,2,1
SBI07OCO7751969,77,30,26,4,1
SBI16NQQ3597315,85,18,15,3,1
SBI15QOC7242304,90,19,14,5,1
SBI14DMU6779564,83,22,19,3,1
SBI94TFK8746860,77,21,14,7,1
SBI52XPL8341295,72,19,16,3,1
SBI94RXJ7790571,79,24,18,6,1
SBI05TFK5809816,72,23,18,5,1
SBI76OFW2991262,89,25,24,1,1
SBI34NKW9221965,85,22,17,5,1
SBI13XSR0296001,90,17,10,7,1
SBI15POU4714638,24,28,18,10,1
SBI42FSN6815106,18,29,24,5,1
SBI89RBV3632224,98,23,16,7,1
SBI31INS9590743,92,27,26,1,1
SBI20NZL2131079,94,24,23,1,1
SBI21MCI0660070,71,31,23,8,1
SBI53FGN7250716,62,27,16,11,1
SBI23GUE4959308,21,21,11,10,1
SBI89VIW9691157,97,28,16,12,1
SBI04URN6302753,70,21,17,4,1
SBI75YLP2331289,70,29,24,5,1
SBI62MPG2364394,74,33,29,4,1
SBI06QQO8762746,81,37,27,10,1
SBI44TDY4599629,97,34,33,1,1
SBI14NXN2298214,98,25,14,11,1
SBI68ACE8675436,88,17,13,4,1
SBI50FGD0802588,99,26,23,3,1
SBI77ANB8646156,19,20,12,8,1
SBI65GYQ9771144,24,27,24,3,1
SBI21LLE8106673,96,23,15,8,1
SBI53USM5530768,69,16,13,3,1
SBI98AUA1908533,65,23,21,2,1
SBI80MHF7172625,18,24,20,4,1
SBI13GKB1907527,73,24,16,8,1
SBI05TRH7176273,91,27,21,6,1
SBI56JVC2338190,76,28,21,7,1
SBI21HHW0207099,92,18,11,7,1
SBI39AAU2371269,92,37,19,18,1
SBI57HIB5172041,68,21,18,3,1
SBI83GBQ9309291,77,24,22,2,1
SBI24PCB0796030,23,23,22,1,1
SBI32COE4901600,66,24,22,2,1
SBI51GOW3673825,98,20,12,8,1
SBI79UQR4452418,68,22,16,6,1
SBI09FDX2415759,79,24,16,8,1
SBI49TSQ3006225,75,29,25,4,1
SBI05NCJ3328832,80,21,18,3,1
SBI63WGK3016843,18,28,22,6,1
SBI07OUT5753674,91,23,18,5,1
SBI19LTM3289897,74,27,23,4,1
SBI33IZR3661194,94,17,16,1,1
SBI15BNG0609516,94,31,21,10,1
SBI42EAO2033869,72,24,17,7,1
SBI10EGV5999291,60,20,11,9,1
SBI36NOR9696875,86,19,14,5,1
SBI34ACH8655961,69,25,19,6,1
SBI11LBI9464253,89,27,20,7,1
SBI94SMX8938728,69,22,16,6,1
SBI17UTP1474006,85,33,30,3,1
SBI43VMV0903298,87,18,14,4,1
SBI27GEF3094216,69,23,16,7,1
SBI02UZS5691916,60,35,32,3,1
SBI15FJB5446733,75,29,16,13,1
SBI21JFM0589010,82,23,18,5,1
SBI60KTH0886915,63,32,24,8,1
SBI81HCH4568487,99,14,10,4,1
SBI43FNF4598456,21,30,29,1,1
SBI63SRL7511653,21,30,20,10,1
SBI43ZAS1584716,90,21,17,4,1
SBI71SOZ2387521,91,26,18,8,1
SBI68VAU7641511,88,25,23,2,1
SBI85HBZ1130590,72,20,17,3,1
SBI86GLM6972378,66,23,15,8,1
SBI75JSW2765201,97,28,22,6,1
SBI62MAQ9969720,97,23,15,8,1
SBI11KEI7091308,70,19,15,4,1
SBI43ARA1765195,73,26,20,6,1
SBI95SOL0450943,99,24,16,8,1
SBI79XKP0345996,24,25,18,7,1
SBI67LPL7538551,99,31,28,3,1
SBI57QUK8302937,88,28,26,2,1
SBI95GEJ6066479,77,28,21,7,1
SBI52RKO9027812,61,29,28,1,1
SBI84TDJ5874416,80,13,11,2,1
SBI68OMW2546605,60,22,13,9,1
SBI12DPX2836253,70,22,20,2,1
SBI06BZP2561866,88,31,21,10,1
SBI44TFI4725273,79,25,15,10,1
SBI38SRF8216865,71,27,19,8,1
SBI08RQK3211708,98,27,25,2,1
SBI13XXM1659682,92,19,10,9,1
SBI19TZB0174727,93,32,29,3,1
SBI09IOF1795564,90,16,12,4,1
SBI95EPO2046251,21,29,22,7,1
SBI76GOV3153788,20,30,19,11,1
SBI59HEG9754934,70,33,26,7,1
SBI65OMD2389133,64,31,20,11,1
SBI28ANY4383937,91,7,5,2,1
SBI26DKV8888219,19,25,14,11,1
SBI65MYL3945442,88,25,18,7,1
SBI47ZFT3604291,93,24,16,8,1
SBI36GZC9624916,69,25,19,6,1
SBI68OVL3988978,69,15,9,6,1
SBI20VQH1188556,71,23,17,6,1
SBI31ZIN0043427,98,13,7,6,1
SBI90ZMZ6897862,84,27,21,6,1
SBI83HMA0632386,78,25,24,1,1
SBI76QLX8098305,77,23,18,5,1
SBI26CQE8914660,77,22,14,8,1
SBI59OOE2309675,83,41,27,14,1
SBI76NHS9467968,60,28,17,11,1
SBI78BWH6271007,92,19,16,3,1
SBI50KHC9618567,21,28,24,4,1
SBI82OLQ5247817,23,35,28,7,1
SBI83CHB5755115,94,29,24,5,1
SBI48TRS8744362,96,23,16,7,1
SBI22GGF2750213,22,29,25,4,1
SBI03LWN5299749,88,20,17,3,1
SBI98LDJ3712921,21,23,17,6,1
SBI60ZSR2197641,72,25,19,6,1
SBI27IIS7258544,71,20,18,2,1
SBI09EUJ5741736,93,23,20,3,1
SBI49HJC5789938,63,22,18,4,1
SBI21IJN0829920,96,13,7,6,1
SBI65BVN5567196,20,24,22,2,1
SBI10BDA7499700,89,21,19,2,1
SBI35MHI4499808,63,22,14,8,1
SBI92GFX4559711,93,31,17,14,1
SBI70ESZ0650769,76,27,15,12,1
SBI22AZJ7513397,79,20,14,6,1
SBI47TIS7585905,71,23,22,1,1
SBI95JFO4481524,85,20,11,9,1
SBI67NQO7416254,71,33,32,1,1
SBI47KST3674488,61,22,14,8,1
SBI14VVQ7041026,98,28,23,5,1
SBI67OEU5802149,89,15,12,3,1
SBI99OMP0611473,94,25,21,4,1
SBI75NTU4999782,24,21,14,7,1
SBI15FNT9923972,64,24,14,10,1
SBI35AMI7903176,88,34,18,16,1
SBI64GYX6964111,81,25,24,1,1
SBI37WRD0296548,91,18,13,5,1
SBI68OWG4028619,99,23,17,6,1
SBI84SMD8722266,24,23,15,8,1
SBI39TWE7211573,87,26,21,5,1
SBI07JZH9368178,60,22,13,9,1
SBI17AVG3076485,71,22,14,8,1
SBI70GXP6433711,66,26,20,6,1
SBI15RGJ8862655,83,26,22,4,1
SBI80RHK9679726,63,30,28,2,1
SBI34GFR8624601,91,34,25,9,1
SBI20SXV4506915,74,25,16,9,1
SBI95XRJ0389111,87,25,15,10,1
SBI55NED6246902,77,20,19,1,1
SBI54SXO5005487,64,21,20,1,1
SBI79JFR0619990,97,20,11,9,1
SBI71JYO7177893,25,9,5,4,1
SBI65TRP4013663,22,19,14,5,1
SBI16YDA9365922,89,34,32,2,1
SBI33DQH6308634,61,24,21,3,1
SBI92ZGH7646374,94,31,25,6,1
SBI41DCP5189051,65,30,25,5,1
SBI56GMY7467090,19,16,15,1,1
SBI14AWZ6043351,97,20,18,2,1
SBI20NVG2543895,90,26,16,10,1
SBI44WFJ3302900,99,25,18,7,1
SBI87IBL6513097,89,29,24,5,1
SBI77PKR4138509,18,25,22,3,1
SBI61WXH9716818,23,25,24,1,1
SBI40QAH2384936,93,30,28,2,1
SBI30TUA0189328,99,26,16,10,1
SBI15PDM6829571,83,24,20,4,1
SBI46GMF3706053,62,18,13,5,1
SBI35GBR1980949,76,29,22,7,1
SBI90KQK8523876,79,27,25,2,1
SBI81VLB4797367,63,16,13,3,1
SBI27BMQ8612388,95,24,13,11,1
SBI81MNI2431848,75,25,21,4,1
SBI22LFU4454478,80,23,19,4,1
SBI67QCM2037438,99,19,17,2,1
SBI75ILT3302222,85,25,16,9,1
SBI90WDW3072413,83,26,18,8,1
SBI56ILV0590643,60,16,11,5,1
SBI15BKA2144098,81,26,23,3,1
SBI83JET4684761,82,25,15,10,1
SBI97RQD7827457,91,36,30,6,1
SBI10ESG1450131,92,34,21,13,1
SBI41WVL7179382,25,23,20,3,1
SBI25QYY9364723,93,35,33,2,1
SBI11PAA6039176,99,34,28,6,1
SBI09DKR4066221,87,19,14,5,1
SBI03YCC0974490,92,27,21,6,1
SBI03KPW0923434,25,28,17,11,1
SBI75EAF7395890,22,14,12,2,1
SBI21MXG5280429,60,33,20,13,1
SBI71KZM9781887,91,16,12,4,1
SBI11GPK9850181,62,22,12,10,1
SBI28USM2958362,64,22,13,9,1
SBI57QGE1624198,21,18,15,3,1
SBI94TXF4752740,25,18,11,7,1
SBI64PZW9643049,86,33,18,15,1
SBI92XWT1086712,72,32,19,13,1
SBI92QAJ4051815,22,23,13,10,1
SBI52UVW4620500,96,30,25,5,1
SBI32KLX5372046,22,21,20,1,1
SBI04HME9176924,25,20,12,8,1
SBI24QHP3785307,77,31,17,14,1
SBI24ORR8933287,92,26,17,9,1
SBI47MLU3173968,92,22,16,6,1
SBI83KZB0894461,61,8,7,1,1
SBI11FQS7264112,60,19,10,9,1
SBI95LSY2009709,78,28,22,6,1
SBI41NZV2819029,71,19,14,5,1
SBI63OOD3866138,83,28,15,13,1
SBI32CBL4786225,77,24,13,11,1
SBI77RHL8403836,63,25,14,11,1
SBI97AYI0227684,72,24,14,10,1
SBI87PKQ0810094,69,28,17,11,1
SBI74OSK3665152,18,22,15,7,1
SBI78PED4265649,92,21,14,7,1
SBI21OGI6976128,84,24,21,3,1
SBI59COG4117693,63,31,21,10,1
SBI77KEQ4944701,70,30,24,6,1
SBI87IXD2191978,21,28,17,11,1
SBI15SAX5052483,95,18,16,2,1
SBI29CBB6732726,95,18,11,7,1
SBI47VBQ1699830,96,26,24,2,1
SBI77BKI7946694,21,30,28,2,1
SBI83WNU6567197,69,24,14,10,1
SBI16RUW6576593,84,28,17,11,1
SBI92OKB7772071,70,27,16,11,1
SBI95UGJ7732254,78,33,29,4,1
SBI60YTC9504178,74,27,20,7,1
SBI44UXE7399582,93,24,20,4,1
SBI34LKU4775648,78,29,26,3,1
SBI42NKG0439139,98,26,24,2,1
SBI66JVW6960712,65,22,17,5,1
SBI86GKV5667922,76,30,17,13,1
SBI60CEZ1667882,68,14,12,2,1
SBI21SAQ5961665,99,29,26,3,1
SBI72JQA4371963,99,21,20,1,1
SBI20YNG3009914,77,31,21,10,1
SBI25WOJ2505461,84,23,21,2,1
SBI05QDE9066700,83,35,34,1,1
SBI27HRS3738373,66,16,11,5,1
SBI61TAR2602537,88,22,20,2,1
SBI02WOJ1988525,70,36,28,8,1
SBI01WRT8681306,74,33,28,5,1
SBI34XYZ7272679,86,24,20,4,1
SBI74LEL1566922,19,29,21,8,1
SBI17BLX0166689,76,30,17,13,1
SBI43JBX4025031,84,29,28,1,1
SBI71ZNZ9117970,73,28,21,7,1
SBI18WGU3546239,93,19,16,3,1
SBI47PXS2763219,99,26,24,2,1
SBI47MHX5473127,95,23,22,1,1
SBI48UIY1624648,61,33,30,3,1
SBI70OMO7015950,23,28,24,4,1
SBI72NWP8802841,62,22,16,6,1
SBI14YUN1108086,61,28,21,7,1
SBI39JET8443826,76,19,10,9,1
SBI83HDF2894558,92,27,15,12,1
SBI02LRD1915098,97,26,17,9,1
SBI83HOM2118937,96,29,28,1,1
SBI82WXB8555575,20,25,17,8,1
SBI29YHE6178611,60,26,16,10,1
SBI75UYE2591168,93,26,17,9,1
SBI44MEB2138856,23,28,21,7,1
SBI95CLE7997420,69,24,22,2,1
SBI88YYD7800069,66,25,24,1,1
SBI92URO3534455,71,22,20,2,1
SBI64ZEW7384200,64,21,13,8,1
SBI50HYN5225002,99,32,26,6,1
SBI18EZG4699296,92,32,20,12,1
SBI09PYM2659580,91,30,27,3,1
SBI58NBV1837308,65,40,30,10,1
SBI56CQZ8569976,88,20,15,5,1
SBI75FJE1681825,90,21,14,7,1
SBI95JAE6132542,71,17,11,6,1
SBI07TAK5362330,87,21,19,2,1
SBI04FCU7908028,78,23,17,6,1
SBI59FOT6058105,90,25,18,7,1
SBI52BZB1907720,75,31,17,14,1
SBI15GMV4575025,60,28,27,1,1
SBI78VJP1510955,62,28,16,12,1
SBI07GAQ6095788,96,24,13,11,1
SBI36WUT3788888,90,15,14,1,1
SBI79QQM1609581,64,27,15,12,1
SBI64PAT6905680,88,37,23,14,1
SBI91VWY1997792,60,21,15,6,1
SBI59TED5061668,65,23,15,8,1
SBI10LKS3882655,75,20,11,9,1
SBI56LTM1878093,87,18,10,8,1
SBI56GOP9739722,23,34,30,4,1
SBI84MKF1626690,76,26,23,3,1
SBI04TMZ3817609,84,27,22,5,1
SBI69WJU6098810,67,30,26,4,1
SBI82RST5011914,84,23,19,4,1
SBI10BBE7119845,82,22,15,7,1
SBI92MBP6156221,84,29,18,11,1
SBI50VXF2783126,83,27,26,1,1
SBI26IVL4419776,65,25,17,8,1
SBI77JSH2976927,89,15,8,7,1
SBI89JUI0460029,70,15,10,5,1
SBI42LXW7263428,72,19,13,6,1
SBI52ESX6231446,96,17,15,2,1
SBI96YFI5087377,61,24,22,2,1
SBI12GZY3117687,90,24,23,1,1
SBI04KNT6253436,92,30,26,4,1
SBI39PXX5199059,67,29,15,14,1
SBI20FVN5835501,67,22,16,6,1
SBI53ZYZ9187158,84,26,18,8,1
SBI74UZA9640973,64,16,14,2,1
SBI29PPC9909712,61,22,12,10,1
SBI65AUB8075476,63,20,14,6,1
SBI91PYT1173892,87,35,20,15,1
SBI42ZHC1452441,63,21,16,5,1
SBI51VWL4691791,76,25,15,10,1
SBI75TPI1496220,76,21,18,3,1
SBI36SYK8161633,99,20,16,4,1
SBI49QOI0279731,69,18,11,7,1
SBI87MIL0236240,65,21,15,6,1
SBI57VFK6480078,95,25,18,7,1
SBI41VAT4725852,93,28,22,6,1
SBI96CCL1682186,91,23,16,7,1
SBI08IWR7870979,97,24,23,1,1
SBI80JPX0195909,95,20,19,1,1
SBI70KJI9335956,70,25,14,11,1
SBI65CYX1363406,87,24,15,9,1
SBI47RBF5521525,18,29,19,10,1
SBI45FIG5718924,21,25,19,6,1
SBI47ZCL1750775,79,21,14,7,1
SBI76OMZ2606384,65,22,14,8,1
SBI90IXI8202453,24,25,14,11,1
SBI67QER2477162,69,27,14,13,1
SBI79RRU6690266,64,28,25,3,1
SBI81RFK1414333,82,20,18,2,1
SBI44GJB2189541,70,24,22,2,1
SBI20VMM9641428,97,21,17,4,1
SBI82JZL9203026,96,34,20,14,1
SBI83ZHG1951351,18,30,25,5,1
SBI16RGW0136205,94,22,16,6,1
SBI49HLL1172141,81,23,15,8,1
SBI41FMF2323325,80,17,14,3,1
SBI46FWZ6642786,79,22,17,5,1
SBI32AHG3763092,24,21,14,7,1
SBI62OLX8321388,73,31,26,5,1
SBI51CMB9639878,87,24,18,6,1
SBI85VHI1454526,79,22,15,7,1
SBI09FCE1476427,18,29,18,11,1
SBI15ZLL9558400,97,27,14,13,1
SBI85YKR8116916,67,23,14,9,1
SBI25YGU3765673,77,25,13,12,1
SBI58IZH2619928,20,25,24,1,1
SBI35DYO7841042,89,18,15,3,1
SBI56UIU4605422,19,23,21,2,1
SBI48GZQ7104037,91,20,13,7,1
SBI89ORE4728569,71,24,14,10,1
SBI10QLP2399159,70,26,20,6,1
SBI39BCB6367732,18,21,16,5,1
SBI65JJS2643217,78,22,13,9,1
SBI47EXX7106476,78,23,19,4,1
SBI30FDE7662066,70,18,10,8,1
SBI61WQM1683483,74,27,25,2,1
SBI24XKP0286567,84,29,24,5,1
SBI98OFS7363594,99,23,18,5,1
SBI96MAG6396323,62,23,15,8,1
SBI54SJG1282480,95,31,29,2,1
SBI76CXZ3194941,75,26,14,12,1
SBI82RBM9321514,25,25,18,7,1
SBI37IQE5870205,60,22,20,2,1
SBI81QIO1514020,99,13,11,2,1
SBI00BFM1609333,63,23,20,3,1
SBI39CBK7722889,66,20,19,1,1
SBI96WFF9947762,92,25,24,1,1
SBI80LQF4037855,23,19,16,3,1
SBI12OSX6046477,72,22,17,5,1
SBI78KXO0807350,97,22,20,2,1
SBI95TJQ6509483,91,24,20,4,1
SBI44WZT2050745,68,19,11,8,1
SBI42VUU0807835,66,24,17,7,1
SBI70SQU7208285,74,24,20,4,1
SBI02VOE0480199,82,18,17,1,1
SBI50KUP0725447,88,22,15,7,1
SBI63LIG2295276,18,26,23,3,1
SBI24QNO9524912,73,25,23,2,1
SBI83LUX8384404,95,32,22,10,1
SBI18GJS0609607,81,24,21,3,1
SBI90SJZ9288757,75,22,17,5,1
SBI42HYK9538711,99,28,23,5,1
SBI68OMV7288532,81,28,23,5,1
SBI00LMV3296840,85,28,22,6,1
SBI56RWV1555711,77,33,18,15,1
SBI18MNQ7988839,98,32,25,7,1
SBI81LJY4527650,61,30,20,10,1
SBI66BBW2285442,24,22,16,6,1
SBI83GBG1111592,68,27,19,8,1
SBI93KWR7905621,72,24,19,5,1
SBI72TFR0858650,65,25,21,4,1
SBI30YYE5922863,89,21,11,10,1
SBI89WIU5791470,94,21,12,9,1
SBI91DKW1602281,24,29,25,4,1
SBI59ZWK9635856,73,32,29,3,1
SBI81IGN5118159,78,31,28,3,1
SBI92MAS4605062,87,26,23,3,1
SBI99LDM0631661,94,22,14,8,1
SBI87KJL2718760,95,23,15,8,1
SBI99YTW0868190,95,15,11,4,1
SBI48UUG0887868,19,33,22,11,1
SBI10UUB3053898,20,26,18,8,1
SBI02LOL2951659,69,30,20,10,1
SBI15UMK9898495,78,23,20,3,1
SBI63FLM1400929,77,15,11,4,1
SBI78LPN6960114,68,24,17,7,1
SBI59OTU5943328,25,20,17,3,1
SBI98NXX1494967,94,21,16,5,1
SBI88JSC0961869,88,30,26,4,1
SBI01TTN5348847,70,32,29,3,1
SBI63WRY2171297,95,22,14,8,1
SBI07FVX6637835,21,26,20,6,1
SBI07ZAA4728165,95,18,12,6,1
SBI60XUY0752664,62,24,22,2,1
SBI05LYW5535560,82,23,16,7,1
SBI26PZZ0328930,94,30,16,14,1
SBI35MHB0413930,94,19,14,5,1
SBI27XAI0302690,93,19,11,8,1
SBI92MIT1919715,69,27,26,1,1
SBI95CAN9784842,80,27,24,3,1
SBI03OQU2844248,95,20,12,8,1
SBI27ASD5279341,89,21,11,10,1
SBI00VHG5072820,60,35,19,16,1
SBI18DGS0577437,77,20,15,5,1
SBI61VTO5251525,18,17,9,8,1
SBI01UDJ7801634,18,28,26,2,1
SBI30WKB6861632,85,30,18,12,1
SBI43MMO7431928,61,25,19,6,1
SBI35VAC3944040,19,20,15,5,1
SBI68GBN6530127,76,15,10,5,1
SBI38KYJ6429736,88,24,20,4,1
SBI69MBC2698028,86,27,19,8,1
SBI20BTY7423153,88,24,14,10,1
SBI14TYD6721221,62,17,14,3,1
SBI73GCD6007713,24,36,24,12,1
SBI56THJ0550246,74,21,11,10,1
SBI71BII8111398,81,25,16,9,1
SBI08AAC9205019,19,16,10,6,1
SBI88NSQ2414294,78,23,16,7,1
SBI53LQI1485089,93,24,14,10,1
SBI00KCG9507431,75,33,27,6,1
SBI70JMH9132933,65,32,28,4,1
SBI99EOB0895011,94,28,19,9,1
SBI42LYM6393680,22,28,25,3,1
SBI43WMR6599174,62,29,27,2,1
SBI07TGO9858145,81,26,21,5,1
SBI20NKV6723889,69,23,19,4,1
SBI18KMP9079050,68,29,21,8,1
SBI30FJB9196789,74,30,19,11,1
SBI49FOA8212314,63,30,28,2,1
SBI97MZN1096454,85,31,17,14,1
SBI31JVI2959149,20,26,14,12,1
SBI19RJD8580505,22,22,19,3,1
SBI56QGJ6224894,99,30,19,11,1
SBI62SIY4781547,76,22,14,8,1
SBI88GNL0432229,21,27,23,4,1
SBI82RQQ9851619,71,26,14,12,1
SBI91MVJ1247908,84,27,19,8,1
SBI80MCX4890196,95,25,17,8,1
SBI92UYB4740514,79,24,13,11,1
SBI65WYT0756295,84,34,19,15,1
SBI03AAH7733010,64,24,15,9,1
SBI76NUI6345194,24,21,13,8,1
SBI30RLC4147208,85,30,24,6,1
SBI92FUQ3803593,88,26,25,1,1
SBI67KXI5658963,74,17,14,3,1
SBI67ERY7618865,97,17,12,5,1
SBI65FJQ6084780,65,27,20,7,1
SBI91PLG7870016,66,24,20,4,1
SBI48WKT4641696,62,19,11,8,1
SBI94IOI9798596,18,23,19,4,1
SBI66GXA5794593,96,29,22,7,1
SBI00PEL3658374,95,29,17,12,1
SBI27ZDY6784940,90,32,25,7,1
SBI79JQT6538287,77,33,29,4,1
SBI52GFY7223344,93,25,20,5,1
SBI93CKO2444912,68,32,27,5,1
SBI36YWD0381330,18,25,15,10,1
SBI40EOQ1031519,93,23,19,4,1
SBI60VRM7909870,88,31,18,13,1
SBI26EUR5331135,71,23,17,6,1
SBI94JJB9674878,68,28,19,9,1
SBI64MUH6973145,86,23,15,8,1
SBI09AKG6116906,19,20,16,4,1
SBI13NHG1308144,71,28,19,9,1
SBI55AGQ9288430,61,28,20,8,1
SBI20IHF7250996,67,29,28,1,1
SBI29AHE9384619,76,25,20,5,1
SBI78EYA2682553,67,22,20,2,1
SBI79UER1119220,84,28,15,13,1
SBI87YFK1794195,94,33,22,11,1
SBI35NVC1656188,88,31,16,15,1
SBI87NNZ3391352,82,21,20,1,1
SBI25BZM6059855,63,23,17,6,1
SBI65KMW4404449,96,25,21,4,1
SBI17RYX1924731,65,25,16,9,1
SBI59YBV8143499,81,29,25,4,1
SBI63IES3488512,70,26,16,10,1
SBI86MLH1793104,82,24,18,6,1
SBI97AJZ1825143,25,23,18,5,1
SBI56LMA0840261,76,27,26,1,1
SBI70PII4445471,80,27,20,7,1
SBI56DXV0601606,24,22,18,4,1
SBI22SIA5597786,76,29,25,4,1
SBI09ITX9392233,22,14,11,3,1
SBI67FPW3680927,76,20,14,6,1
SBI16CMP4579190,91,32,29,3,1
SBI51JOP3857415,76,30,17,13,1
SBI80HFA6098924,65,21,17,4,1
SBI83OSM1081884,96,31,24,7,1
SBI02WPT7484567,94,21,13,8,1
SBI22LLH5743655,67,28,18,10,1
SBI17PTC0986151,81,24,13,11,1
SBI53AAW0184785,69,22,18,4,1
SBI01QVM2482208,97,21,18,3,1
SBI31AKH1428678,93,23,19,4,1
SBI85JPQ7232793,70,28,24,4,1
SBI58YQV0522464,93,23,13,10,1
SBI38IVZ3325172,93,19,14,5,1
SBI54EDT5181344,96,33,30,3,1
SBI25SOZ0575405,77,24,22,2,1
SBI76HBB8775524,70,19,18,1,1
SBI39PMI9983877,99,13,7,6,1
SBI29UQQ2222835,74,24,13,11,1
SBI85UUD6499059,24,21,15,6,1
SBI75HEI3572175,63,25,14,11,1
SBI16VEI5855887,96,12,11,1,1
SBI24TZC6110225,81,21,16,5,1
SBI12ZDD9543237,77,26,20,6,1
SBI13OMR3781948,93,29,24,5,1
SBI15TGP0772053,88,20,19,1,1
SBI44GUJ0765946,93,25,20,5,1
SBI79SUR3560883,18,22,20,2,1
SBI89OCX3697060,94,13,12,1,1
SBI66IKP2662537,70,25,14,11,1
SBI78ZOK9717635,24,26,22,4,1
SBI50ZVL3840200,23,24,18,6,1
SBI68RFF6200839,62,31,26,5,1
SBI40MTR2720558,96,24,13,11,1
SBI34OIR9187349,90,23,17,6,1
SBI03LYG9605565,19,23,15,8,1
SBI69JPZ5559332,84,28,20,8,1
SBI24ZRE7712019,66,19,13,6,1
SBI72YOC6353443,66,15,10,5,1
SBI34SFK2613729,90,27,21,6,1
SBI27HBH4452399,90,26,22,4,1
SBI24WBJ8782615,18,30,23,7,1
SBI28CTK9152526,73,21,12,9,1
SBI82OFW7819825,73,23,17,6,1
SBI09QII1802846,78,22,18,4,1
SBI88TXI9552122,62,31,19,12,1
SBI64JRP0327972,63,28,20,8,1
SBI89PQA9914922,92,24,21,3,1
SBI32TTY7418377,97,19,17,2,1
SBI14VXQ4832511,92,22,16,6,1
SBI97PDK8372270,20,19,16,3,1
SBI22OJD8139473,85,22,15,7,1
SBI87ZVH6011330,62,28,24,4,1
SBI75VYS1626972,66,22,14,8,1
SBI65MFD0581455,72,33,22,11,1
SBI38MAH4544178,91,23,18,5,1
SBI67JKA7645254,74,22,15,7,1
SBI97HTR7606307,89,25,15,10,1
SBI52EWY3214933,24,29,24,5,1
SBI24GIF1869499,66,21,18,3,1
SBI20QOH3992135,85,27,24,3,1
SBI20YQQ3073280,75,20,16,4,1
SBI60CSW0442139,88,25,20,5,1
SBI79NFN6587110,98,23,17,6,1
SBI56MSM6966483,95,29,19,10,1
SBI54BDC1660295,63,32,17,15,1
SBI64TRF8295367,88,17,10,7,1
SBI76WFF2997493,78,22,20,2,1
SBI51EWB5323959,67,33,23,10,1
SBI68APP0727808,70,32,25,7,1
SBI00XCU3432823,69,28,27,1,1
SBI04UMI6513614,60,18,16,2,1
SBI85ZIR3276295,99,28,22,6,1
SBI18HMU4224883,18,23,20,3,1
SBI11IYL5377264,99,22,18,4,1
SBI97RJY8057655,21,26,14,12,1
SBI37XKU6983151,62,25,14,11,1
SBI89DKI5650715,19,24,13,11,1
SBI59JTF6249286,85,16,15,1,1
SBI97QMF6801230,78,28,21,7,1
SBI68ZSB1376016,77,32,30,2,1
SBI84BWP9988134,79,32,19,13,1
SBI44BLZ5394683,76,22,17,5,1
SBI94IJN8422493,68,30,22,8,1
SBI69RYD3012559,82,31,21,10,1
SBI90XAF5304759,80,25,23,2,1
SBI20KKN0254249,96,27,26,1,1
SBI07RYR7608799,19,12,9,3,1
SBI96KTH3940483,61,23,13,10,1
SBI64IWV4277512,82,12,11,1,1
SBI43BCA0402793,79,27,20,7,1
SBI94IBX3842659,83,27,22,5,1
SBI18ZGV8700731,76,22,17,5,1
SBI40DSM6371896,85,22,13,9,1
SBI12LDJ6224800,81,32,30,2,1
SBI52XYB3955521,20,21,16,5,1
SBI01PAB4364929,93,24,21,3,1
SBI95GTK9861221,61,30,29,1,1
SBI06ICG8593882,99,33,20,13,1
SBI62PPT6012401,92,29,18,11,1
SBI09XVP7797912,65,19,15,4,1
SBI73RQA5742730,85,26,22,4,1
SBI54AXU9649844,89,23,22,1,1
SBI24ZKF7078492,86,26,23,3,1
SBI86WFG9120828,97,21,18,3,1
SBI92BWF3985105,95,33,27,6,1
SBI33HQQ1884737,76,17,13,4,1
SBI23PSD6678530,93,19,10,9,1
SBI93GUP0311859,72,31,17,14,1
SBI93GQW9373129,81,32,25,7,1
SBI66RIH0844558,25,25,15,10,1
SBI85CZD9144025,86,17,10,7,1
SBI47HXA8120692,69,26,21,5,1
SBI36TDH5910836,96,19,16,3,1
SBI79NSK4850093,66,22,13,9,1
SBI54YXB8747684,94,20,14,6,1
SBI30SRK5555999,66,19,14,5,1
SBI90ZUQ1454204,96,29,18,11,1
SBI79MIM0108790,88,28,23,5,1
SBI68FCM0468640,67,24,21,3,1
SBI61LRH4262905,67,20,14,6,1
SBI81RIH4194375,93,20,15,5,1
SBI46LNZ7114780,23,22,17,5,1
SBI72KYM0198204,79,24,19,5,1
SBI25KYL1274992,77,25,16,9,1
SBI45MFW8203370,65,36,29,7,1
SBI46FYE4834124,86,21,18,3,1
SBI09UTZ8298136,90,23,22,1,1
SBI77TDJ9541955,97,28,27,1,1
SBI19OWY0888670,81,29,18,11,1
SBI32ZUZ5336034,25,31,17,14,1
SBI53QUZ0761638,69,20,11,9,1
SBI97NWT1443189,21,22,17,5,1
SBI06FLH2246047,18,24,18,6,1
SBI78NDW4444129,79,16,9,7,1
SBI54ZWE1159529,83,18,14,4,1
SBI60VOZ1656860,72,26,18,8,1
SBI54CYW3484736,63,18,11,7,1
SBI19PNL4126937,20,21,17,4,1
SBI05KKN2736894,63,30,28,2,1
SBI07PAY3746108,84,28,19,9,1
SBI33PVX2677063,21,27,18,9,1
SBI53KGR2624407,69,32,17,15,1
SBI56AEZ7746219,95,24,20,4,1
SBI56PJU6769057,63,22,16,6,1
SBI51MGU9708461,79,30,16,14,1
SBI65IGI4831346,80,22,16,6,1
SBI89CUI5932835,62,13,11,2,1
SBI26NVF5368505,95,9,8,1,1
SBI05YHO0260201,92,27,22,5,1
SBI33TTG9122123,67,28,23,5,1
SBI15PSV9977466,89,20,13,7,1
SBI36CNL9922727,89,32,23,9,1
SBI56IAV2298630,71,28,20,8,1
SBI03DBE5410059,19,29,18,11,1
SBI31FUN6148467,87,33,21,12,1
SBI26RCJ3672231,18,28,25,3,1
SBI64BIW9008129,74,19,16,3,1
SBI71LCK4996634,67,19,17,2,1
SBI04VLA1446020,99,30,17,13,1
SBI37NTJ6938071,71,24,17,7,1
SBI13DUC7583601,86,16,12,4,1
SBI83XFA6207309,69,21,15,6,1
SBI44FVN7116712,70,25,13,12,1
SBI86QWL3014225,72,21,17,4,1
SBI59NRQ7468757,84,17,14,3,1
SBI28PHV2503329,70,20,11,9,1
SBI72RZF0921066,79,24,14,10,1
SBI66TGU2055954,72,27,14,13,1
SBI31ALO9291300,82,26,19,7,1
SBI91OCQ1319975,84,25,23,2,1
SBI58ULX2635932,88,29,19,10,1
SBI86SDA3489910,86,26,18,8,1
SBI18FUD2870886,61,22,12,10,1
SBI01COD0239616,65,22,21,1,1
SBI01KRS2100625,25,20,11,9,1
SBI25PUI6256409,22,22,14,8,1
SBI11ENG6551513,70,25,22,3,1
SBI83UCI7943173,96,23,17,6,1
SBI32TLD7348436,72,18,15,3,1
SBI90FLT9014890,69,24,20,4,1
SBI43KCE8809498,94,26,21,5,1
SBI61ENS4948001,73,21,15,6,1
SBI79OUZ3141989,68,26,24,2,1
SBI63ORF8647951,70,31,16,15,1
SBI16KXI1508754,67,24,17,7,1
SBI71CFO4608405,91,27,24,3,1
SBI81UWO0788056,95,29,21,8,1
SBI18GZS0066565,67,30,22,8,1
SBI76EDB9024437,87,24,17,7,1
SBI15HSE1016515,73,21,11,10,1
SBI52WQL5542003,78,21,14,7,1
SBI55SUN6545751,78,26,17,9,1
SBI90HDQ8772629,88,25,19,6,1
SBI68QIR7065752,85,28,21,7,1
SBI23XYA0933608,81,30,18,12,1
SBI86YHV4485186,89,22,12,10,1
SBI95NII7165272,88,21,16,5,1
SBI91LCU0636963,22,27,23,4,1
SBI54NXP9535575,99,34,26,8,1
SBI53RYW5351361,88,23,20,3,1
SBI91KBI5717857,86,26,19,7,1
SBI41UQA0040508,25,24,16,8,1
SBI15NWT2337138,73,27,20,7,1
SBI86MFA9848314,78,26,14,12,1
SBI50KAS9686080,66,32,24,8,1
SBI09TLA9834089,25,23,17,6,1
SBI58YQU7080651,75,30,29,1,1
SBI37DOK9984889,71,25,20,5,1
SBI96RFA8249467,71,22,17,5,1
SBI75LGK6347278,98,18,13,5,1
SBI42BTK3198003,78,35,28,7,1
SBI71GEZ9367113,23,32,28,4,1
SBI25RGW1817469,88,23,14,9,1
SBI23ROE4370558,23,15,12,3,1
SBI78GIN1226732,83,21,19,2,1
SBI27CNB4939086,87,34,25,9,1
SBI19MLP5009604,96,34,28,6,1
SBI15AJW2145638,95,28,21,7,1
SBI17DKT1696756,22,26,19,7,1
SBI39ZSX5544267,80,29,18,11,1
SBI04QWA0364445,71,33,18,15,1
SBI02KQU2252394,23,26,16,10,1
SBI80EZJ5591298,25,20,18,2,1
SBI54PNI3150907,90,21,16,5,1
SBI78LWD1720559,19,19,15,4,1
SBI12KMW8370172,72,19,14,5,1
SBI22UNM7785635,23,22,12,10,1
SBI70GJR2342894,96,24,22,2,1
SBI29XHB9384156,68,17,13,4,1
SBI22AAJ1948105,99,28,26,2,1
SBI59DHE3098692,74,21,19,2,1
SBI31NQR2042829,97,24,22,2,1
SBI21AIE8383129,82,34,32,2,1
SBI80FEZ9998925,95,24,15,9,1
SBI32SRN9799825,69,22,18,4,1
SBI54STH7937087,71,19,10,9,1
SBI24HCZ1129214,86,30,28,2,1
SBI02EGS7013971,70,24,20,4,1
SBI53NLE0628882,90,21,13,8,1
SBI21GMB8329227,67,26,14,12,1
SBI44BKI8003407,92,21,12,9,1
SBI59JPZ4104201,68,23,16,7,1
SBI56CLA8648729,79,23,12,11,1
SBI96JXY9279317,77,23,16,7,1
SBI43ILA5878952,97,25,23,2,1
SBI42QDI0564923,20,28,16,12,1
SBI99OXU9615525,78,25,18,7,1
SBI94PMS0626845,91,23,14,9,1
SBI93JMK2245223,83,28,25,3,1
SBI58AVH4369890,82,19,12,7,1
SBI35VAI0311993,63,22,18,4,1
SBI12BJE5815476,77,24,22,2,1
SBI50HLF1942949,87,30,23,7,1
SBI99KZH7549321,83,21,19,2,1
SBI84NSR3985900,23,33,31,2,1
SBI39BZZ8739920,86,21,17,4,1
SBI25GVG4829215,74,34,25,9,1
SBI23JYQ5069065,92,21,14,7,1
SBI47YVT1038293,80,35,24,11,1
SBI10NDB5221646,60,26,17,9,1
SBI03CKU9927767,64,32,22,10,1
SBI82VID2045388,88,22,17,5,1
SBI39HTO1626474,97,29,24,5,1
SBI18ZDQ4554011,93,27,20,7,1
SBI57FYZ1200144,24,33,22,11,1
SBI31DKB9295198,75,25,15,10,1
SBI56YIK9572495,74,23,20,3,1
SBI65GUI0332892,98,21,15,6,1
SBI48FTG3713999,62,25,22,3,1
SBI74LWK5629610,79,18,12,6,1
SBI98VBQ6750730,82,20,16,4,1
SBI99AQR5532256,21,22,13,9,1
SBI88MVY5065480,97,29,18,11,1
SBI81VDX6370855,82,26,16,10,1
SBI30CKZ9459023,62,26,24,2,1
SBI20OOL8818343,22,26,14,12,1
SBI37KGH1172081,83,23,15,8,1
SBI36SXE3339351,60,23,22,1,1
SBI28ZHU7169269,19,26,22,4,1
SBI10RSH4910010,75,28,27,1,1
SBI88HML2093325,70,17,12,5,1
SBI52IXL9278252,80,26,18,8,1
SBI80PAM1530373,96,22,21,1,1
SBI04RXO5861405,93,28,25,3,1
SBI00ZIQ4622564,60,22,16,6,1
SBI27XWO5179282,90,31,18,13,1
SBI15JHY7086235,78,25,23,2,1
SBI38TGA7770507,89,35,20,15,1
SBI43SLD9108937,65,19,16,3,1
SBI86OWY8556559,62,27,26,1,1
SBI00WYY5161529,82,26,15,11,1
SBI89IZS8720793,90,26,21,5,1
SBI99TGY7546270,86,30,23,7,1
SBI76WEE4163343,89,29,18,11,1
SBI45QOY4417221,81,25,22,3,1
SBI17NFY7118083,84,34,33,1,1
SBI38EHD1705470,98,26,20,6,1
SBI35HMM8423396,61,28,24,4,1
SBI60ZVS4158629,84,16,14,2,1
SBI94UHT1744806,60,29,28,1,1
SBI13PHM2836208,92,16,13,3,1
SBI42INM2970050,91,26,18,8,1
SBI17JOU4607083,74,22,16,6,1
SBI29DYQ7425712,78,18,14,4,1
SBI29AHV8728419,60,30,17,13,1
SBI92AJI3810265,77,25,20,5,1
SBI47GNZ7530554,61,18,12,6,1
SBI15MQP8994067,93,32,26,6,1
SBI44WOW2775007,91,25,21,4,1
SBI66WQR8935606,21,28,15,13,1
SBI12JZV7058918,96,16,13,3,1
SBI42WGF4654507,97,25,20,5,1
SBI31NIF3044896,80,31,27,4,1
SBI10NOD7270434,95,28,16,12,1
SBI84YQC8659067,64,17,14,3,1
SBI08NZZ0207295,83,23,22,1,1
SBI00NVN9870280,69,30,29,1,1
SBI30TIM6680580,85,26,17,9,1
SBI64TMZ7842996,75,18,13,5,1
SBI16XGO9728346,79,23,16,7,1
SBI64EJO4560271,95,29,20,9,1
SBI27SNA5667453,74,16,9,7,1
SBI82CCI1624637,63,25,16,9,1
SBI69TPB0831562,68,30,21,9,1
SBI27RPW0068488,94,16,13,3,1
SBI29FXD6875667,24,17,15,2,1
SBI60TVH6429820,72,25,20,5,1
SBI70WSN0488724,96,20,19,1,1
SBI88ARQ7165303,70,18,14,4,1
SBI84ISZ9140842,85,28,16,12,1
SBI59EKO4373004,78,23,16,7,1
SBI62URR8556678,65,16,13,3,1
SBI46BMI7442295,89,28,22,6,1
SBI70EDV1974363,86,28,19,9,1
SBI88SXH0686107,24,28,23,5,1
SBI10TDQ1077247,90,21,14,7,1
SBI52CLN5755793,25,21,16,5,1
SBI80RYO3863534,72,21,16,5,1
SBI04HXC4629515,80,16,14,2,1
SBI31AIS6472000,68,29,22,7,1
SBI96AWF8762544,95,42,39,3,1
SBI26EVF7878448,99,27,14,13,1
SBI13RSN2518168,80,24,15,9,1
SBI41MWN3629913,95,25,19,6,1
SBI75KPF1544495,88,27,16,11,1
SBI80SOY3431921,96,19,16,3,1
SBI75DPK3339271,88,23,21,2,1
SBI49IVN2046926,91,25,23,2,1
SBI29CFX9510035,23,24,17,7,1
SBI26QNP6166524,81,27,14,13,1
SBI63QUU1334257,76,24,19,5,1
SBI02PWT5917963,86,21,20,1,1
SBI10SNK4177589,64,25,15,10,1
SBI28JHA3169830,94,23,21,2,1
SBI53CYS0701301,61,24,17,7,1
SBI86FFG6537119,83,23,18,5,1
SBI62VSM4417118,88,22,18,4,1
SBI52AJF5791466,63,22,14,8,1
SBI60PMS6887443,62,28,20,8,1
SBI11TMM6895088,70,25,22,3,1
SBI30XYA3838872,81,18,14,4,1
SBI50AXI5006336,74,19,13,6,1
SBI37JPC2016151,69,26,23,3,1
SBI68KBJ4872153,93,26,23,3,1
SBI53PTC5100029,96,34,27,7,1
SBI55EGN7196563,82,22,15,7,1
SBI95FLV1348634,22,16,9,7,1
SBI54IJI8502882,69,33,26,7,1
SBI74LNO1778207,23,24,17,7,1
SBI18LQN9327785,91,31,30,1,1
SBI31KEA4597941,81,30,21,9,1
SBI44BQR2226457,69,25,19,6,1
SBI28DYS3502846,99,31,28,3,1
SBI15JMQ0080217,66,24,22,2,1
SBI29FAX5240013,82,19,16,3,1
SBI16TYH8173515,79,31,18,13,1
SBI04NET8154520,74,21,18,3,1
SBI45OYT1988567,20,30,17,13,1
SBI14GVQ2175276,65,24,22,2,1
SBI97TEQ5603085,88,34,20,14,1
SBI07YAU1542559,98,24,18,6,1
SBI70ZUW6344387,62,31,17,14,1
SBI44OII9478799,25,26,24,2,1
SBI91EDH4801362,62,31,24,7,1
SBI97SWS2625375,78,31,28,3,1
SBI99JRL3040442,84,26,18,8,1
SBI93KOH5224344,64,14,9,5,1
SBI73TMV5264343,83,23,14,9,1
SBI36YUM5202781,19,25,18,7,1
SBI92PNN1972468,99,16,13,3,1
SBI38XWK2479258,96,27,25,2,1
SBI20ALX6180073,67,21,16,5,1
SBI94OMD5315523,94,26,23,3,1
SBI92VGO5989708,97,21,17,4,1
SBI07KDN4006578,77,29,17,12,1
SBI65BCY4315385,61,18,12,6,1
SBI92BZC6662250,71,32,20,12,1
SBI25ZGT1551528,97,28,22,6,1
SBI70GVD9356287,92,26,14,12,1
SBI57FJK7359110,20,26,20,6,1
SBI06HJC3783607,62,24,14,10,1
SBI50PBW9711799,68,25,17,8,1
SBI59RLW3372710,96,23,19,4,1
SBI58UWO5637763,78,23,22,1,1
SBI71FUV7263243,18,29,24,5,1
SBI54AYA7960178,95,25,13,12,1
SBI23MPE9085444,18,24,16,8,1
SBI32LBI0665619,77,24,22,2,1
SBI42GQB1533882,99,15,10,5,1
SBI93DHJ0831305,69,31,25,6,1
SBI29FUH6716105,87,25,17,8,1
SBI52QSI2613889,89,21,15,6,1
SBI39BBQ8470877,91,22,18,4,1
SBI95KBD7529966,77,28,18,10,1
SBI62JEW5278756,69,17,12,5,1
SBI52ROT0020424,74,31,19,12,1
SBI86DIU5711416,71,22,17,5,1
SBI06EEN0382991,85,24,22,2,1
SBI31IXN1661569,81,16,15,1,1
SBI03CIA6886755,76,21,15,6,1
SBI86NZQ6117879,72,27,26,1,1
SBI01SVB0044921,60,25,24,1,1
SBI18JPE8596776,73,17,12,5,1
SBI56LIR5789919,61,28,19,9,1
SBI93QCN8493197,63,23,17,6,1
SBI55CQP3241659,70,28,21,7,1
SBI98OPA0652391,61,24,16,8,1
SBI33SPE1771942,61,27,26,1,1
SBI73JJB0548070,79,18,15,3,1
SBI85NME1658821,19,28,26,2,1
SBI10SMZ3848977,18,25,20,5,1
SBI15BZQ2879238,64,25,14,11,1
SBI12ODU7965975,77,22,21,1,1
SBI93ZCB6297332,81,22,16,6,1
SBI24GWI2721636,85,21,18,3,1
SBI11RRT4951733,22,16,13,3,1
SBI27LEZ3449947,71,28,20,8,1
SBI01GYA6203146,70,24,16,8,1
SBI80GRG3088256,74,29,23,6,1
SBI68FPE7902204,94,24,14,10,1
SBI51KEG3396840,70,31,20,11,1
SBI48RND0324495,22,14,12,2,1
SBI24JLA1688169,78,27,15,12,1
SBI26ITB5086314,85,22,21,1,1
SBI24LSC0307485,96,21,20,1,1
SBI96XWF9735551,76,29,18,11,1
SBI22OCE1679277,87,26,20,6,1
SBI10NDQ4173365,87,22,12,10,1
SBI51FVL0974390,23,31,30,1,1
SBI60AKG1207923,87,19,17,2,1
SBI86XJV1237114,24,27,25,2,1
SBI00LZM2139961,99,26,22,4,1
SBI55FOT5191788,75,34,28,6,1
SBI98ZXQ4073602,91,32,28,4,1
SBI63PKL7291659,61,26,18,8,1
SBI11WPP7903648,64,28,26,2,1
SBI51ZNL8504518,69,26,15,11,1
SBI40WLS7533078,86,14,11,3,1
SBI72IGQ3850803,83,20,19,1,1
SBI44HQC2746873,62,29,28,1,1
SBI46GEA5808134,88,29,25,4,1
SBI81AGV8665994,87,29,24,5,1
SBI33XNT6322104,91,18,10,8,1
SBI13RQM7018050,84,29,27,2,1
SBI65YMS3093009,82,33,27,6,1
SBI15AWP8556942,20,25,21,4,1
SBI20QOH1466566,91,30,20,10,1
SBI43OIM3491188,80,29,18,11,1
SBI18XMW0998393,63,31,19,12,1
SBI53FMJ9373722,60,25,15,10,1
SBI81PTP8666633,82,24,19,5,1
SBI02YXM1987779,78,26,20,6,1
SBI58YVW0065220,69,25,20,5,1
SBI68IMY6664383,80,25,24,1,1
SBI03NZD5665760,94,30,24,6,1
SBI29WRF5925812,73,30,23,7,1
SBI83DAB4085945,76,22,19,3,1
SBI17CVZ6051610,94,30,19,11,1
SBI37QUN1472561,68,21,13,8,1
SBI61UJK7596307,85,22,12,10,1
SBI91DTY6650927,22,23,13,10,1
SBI59TTN4850156,70,31,16,15,1
SBI41XQR1691214,65,21,19,2,1
SBI63WWN6086699,83,33,18,15,1
SBI27RLX5906320,97,20,16,4,1
SBI20AKO1378885,90,20,18,2,1
SBI65VNR0716613,76,24,21,3,1
SBI32SDA3894144,70,26,22,4,1
SBI49VJE5094774,94,25,18,7,1
SBI48OYO4797872,65,24,18,6,1
SBI80YYT9970437,99,25,22,3,1
SBI36YBH3060622,98,28,25,3,1
SBI55PFM8327501,19,31,30,1,1
SBI07PLI1347309,93,27,15,12,1
SBI63JXC1204175,86,27,15,12,1
SBI90JFB5708523,23,25,15,10,1
SBI37QQI7232528,84,21,11,10,1
SBI21KZK1942142,76,23,13,10,1
SBI32VSW5995945,71,22,19,3,1
SBI68WOR4014450,83,30,28,2,1
SBI76UNY8971603,96,33,25,8,1
SBI11NAE4330069,82,27,16,11,1
SBI48CPL1854762,21,29,25,4,1
SBI57LQZ6523547,74,23,13,10,1
SBI82WEK7026022,65,24,19,5,1
SBI08INK0263001,22,27,18,9,1
SBI96HHY8903752,78,30,23,7,1
SBI10SAQ5534199,63,24,16,8,1
SBI61PRM7334533,89,20,13,7,1
SBI51LLA9280762,24,24,22,2,1
SBI16WWI9090497,25,24,20,4,1
SBI39QDW6443266,98,26,15,11,1
SBI73HVI9657172,19,22,21,1,1
SBI86QWS4350953,74,30,24,6,1
SBI30VDU4455619,24,26,24,2,1
SBI75PRX8585787,63,28,24,4,1
SBI65RHJ0601138,22,25,13,12,1
SBI91FPK1092995,85,23,13,10,1
SBI03MLR4116813,84,19,16,3,1
SBI45KNP9288093,81,22,12,10,1
SBI11UZS5104439,96,33,20,13,1
SBI21JLJ4015292,60,23,12,11,1
SBI77ZLI0024264,90,26,23,3,1
SBI24RGI2383172,82,15,11,4,1
SBI41ZRW0455309,78,39,22,17,1
SBI04EOI4423102,97,25,14,11,1
SBI77VBE0606614,71,32,28,4,1
SBI98NIQ6482761,78,17,14,3,1
SBI39JHG7805067,83,29,16,13,1
SBI94AXT3543461,62,26,24,2,1
SBI77IEC3294819,81,24,23,1,1
SBI20WSW0902210,84,25,17,8,1
SBI54EMP2182708,22,22,14,8,1
SBI51QAH1134099,61,16,13,3,1
SBI13WVZ1608211,25,32,23,9,1
SBI82EJA0279418,60,25,21,4,1
SBI47QZY9581585,86,26,15,11,1
SBI52UAA1314052,73,33,17,16,1
SBI27PJF5223239,98,21,19,2,1
SBI74HCP4582326,82,29,20,9,1
SBI30XXQ6681632,77,33,32,1,1
SBI16TNN3506883,92,29,21,8,1
SBI56MUH8443374,93,18,17,1,1
SBI73WPJ2336492,71,17,10,7,1
SBI93HZU3538947,78,32,20,12,1
SBI63VUB5549394,81,32,20,12,1
SBI79YDR8236058,23,33,28,5,1
SBI37TGO5608255,62,23,16,7,1
SBI45ZHW9907421,90,29,26,3,1
SBI73QOK6209988,67,19,14,5,1
SBI01SFN5769621,78,26,22,4,1
SBI57GYI0783890,74,16,9,7,1
SBI76SQB3258130,66,36,28,8,1
SBI55TWY7036013,77,26,17,9,1
SBI31UMS6072812,91,16,13,3,1
SBI50IXJ7922492,68,23,16,7,1
SBI95WWA1804417,24,23,16,7,1
SBI36IYT5726384,18,20,18,2,1
SBI46RIE6236486,90,19,15,4,1
SBI51VJQ4078550,65,27,17,10,1
SBI33WEM0368063,64,26,17,9,1
SBI37MOD7614503,64,29,23,6,1
SBI70UWZ4423086,18,21,20,1,1
SBI17VDC2555078,80,26,15,11,1
SBI46PXC3513374,60,22,19,3,1
SBI18FNE3718902,93,17,15,2,1
SBI66ZWS1268307,18,29,24,5,1
SBI14SMM7143319,71,28,27,1,1
SBI60ZKW0069033,92,28,23,5,1
SBI58LIZ9316857,22,27,22,5,1
SBI38JJL6903593,79,18,14,4,1
SBI17DLJ6733394,99,25,19,6,1
SBI63FKR8276261,99,30,21,9,1
SBI97VPE4511385,97,35,18,17,1
SBI74AKC8418728,71,12,9,3,1
SBI98WUF1813237,19,22,17,5,1
SBI54FHV7430348,69,19,16,3,1
SBI34FVZ5999330,69,22,14,8,1
SBI33QWC9815648,81,27,24,3,1
SBI03EVV9478246,22,22,13,9,1
SBI71RLM1624082,68,27,14,13,1
SBI27JWG0409835,74,19,14,5,1
SBI31FGQ2989016,20,27,24,3,1
SBI86SVX2513233,97,23,13,10,1
SBI47QKH3899255,93,23,20,3,1
SBI12COT7911053,80,31,25,6,1
SBI79ASL3652462,68,25,15,10,1
SBI45YMJ0087506,18,22,19,3,1
SBI07NGE2227257,68,31,19,12,1
SBI87KIZ7915830,21,14,13,1,1
SBI61GJH6013930,98,27,24,3,1
SBI36WFC8227421,21,20,15,5,1
SBI45CSW0974459,66,20,14,6,1
SBI65XAL7355002,23,21,14,7,1
SBI52POS6996502,98,24,18,6,1
SBI20RBF3491316,63,29,17,12,1
SBI63ACJ3005200,22,32,22,10,1
SBI04TKD4217636,19,16,15,1,1
SBI16JYD4233531,70,27,20,7,1
SBI00PVQ6075687,72,32,28,4,1
SBI03CHF1630460,66,26,18,8,1
SBI93PRG1036097,95,22,19,3,1
SBI10SDJ9168758,80,17,9,8,1
SBI11AYO0592762,96,22,16,6,1
SBI96NTH2972905,21,14,12,2,1
SBI21XFW6301278,20,24,14,10,1
SBI75MJZ5808419,61,25,15,10,1
SBI48BHD6464082,86,28,24,4,1
SBI12PVL4686772,83,27,18,9,1
SBI38JYM6876721,22,25,16,9,1
SBI23GQF6082358,89,25,23,2,1
SBI00KCD9449027,96,33,29,4,1
SBI26DXW2561399,94,17,13,4,1
SBI68YCE7342487,77,30,16,14,1
SBI00EVS5844340,82,26,25,1,1
SBI08RYI5515735,18,20,17,3,1
SBI95GXJ1449501,90,23,20,3,1
SBI99HGW3838171,95,24,21,3,1
SBI93KJS3689410,83,20,19,1,1
SBI18RPB2132880,72,16,15,1,1
SBI80CFM6831014,96,15,11,4,1
SBI88MZW0976627,20,19,17,2,1
SBI81WPL1271874,62,36,24,12,1
SBI94VPG6995522,69,21,20,1,1
SBI46ZUK1369913,94,13,10,3,1
SBI98AXB2367613,64,23,22,1,1
SBI57ZBL4770769,73,20,13,7,1
SBI82PEK8940819,93,29,17,12,1
SBI60HLH3843486,89,17,15,2,1
SBI77EUR8211953,76,25,24,1,1
SBI79MHY8273623,19,36,27,9,1
SBI60LRQ8400940,60,20,14,6,1
SBI44WRN2379447,86,20,16,4,1
SBI51QWK0746905,68,29,17,12,1
SBI46ITM6436964,86,20,19,1,1
SBI34IYG0039625,22,29,18,11,1
SBI22DPF9205056,60,22,13,9,1
SBI29ELX4238102,98,38,21,17,1
SBI68STY8972425,69,26,23,3,1
SBI03SIA2627882,66,37,36,1,1
SBI59MMS6162215,76,25,21,4,1
SBI46DDB0529096,93,35,20,15,1
SBI27GYL3338486,60,27,21,6,1
SBI97UCN1398346,22,26,16,10,1
SBI98GLV2173728,21,36,34,2,1
SBI64TNF5484246,66,32,17,15,1
SBI12GAX8019898,73,26,17,9,1
SBI88ZSC3983840,81,21,15,6,1
SBI58ANU3344260,72,32,25,7,1
SBI39FER6106108,71,25,21,4,1
SBI64QGT6797566,95,27,26,1,1
SBI53ZAJ4326048,95,29,19,10,1
SBI28GEE0123363,71,15,10,5,1
SBI80VSR9512879,87,26,18,8,1
SBI80DIT5825474,24,33,27,6,1
SBI87CKX5057400,95,31,22,9,1
SBI35KWV0747061,72,26,17,9,1
SBI34EUC2872714,84,19,17,2,1
SBI14VVZ8595349,86,28,25,3,1
SBI97AZQ6168295,76,22,16,6,1
SBI47COF7567315,65,24,17,7,1
SBI42OUF8161045,66,29,18,11,1
SBI32BVV9129754,94,21,11,10,1
SBI15ZHK8852385,68,28,27,1,1
SBI70EDV9890148,67,29,24,5,1
SBI82ABP2113247,88,27,14,13,1
SBI48JZK3822837,72,20,12,8,1
SBI02SLI9174644,74,24,19,5,1
SBI43IAN5494167,62,28,24,4,1
SBI02ACR5871601,75,24,19,5,1
SBI21WKT4613121,20,21,17,4,1
SBI33MAR5427386,82,29,22,7,1
SBI54KFE6896708,68,34,18,16,1
SBI50IEJ3902187,74,20,11,9,1
SBI90XJH1483509,68,25,17,8,1
SBI26DEC1857714,75,26,24,2,1
SBI98ILG7040948,65,20,17,3,1
SBI78JQL0015917,95,25,21,4,1
SBI73JJF4685796,96,28,17,11,1
SBI47ZCT8456489,78,27,21,6,1
SBI49SNU7224663,60,26,14,12,1
SBI96XLH5115753,89,21,12,9,1
SBI71TYB4228070,91,31,28,3,1
SBI76PSO5563782,85,19,15,4,1
SBI83VIZ0638069,91,30,23,7,1
SBI39ECJ6528263,63,22,13,9,1
SBI52RMZ9609166,99,31,16,15,1
SBI34XMS4297777,76,28,21,7,1
SBI98ULH1909833,18,25,23,2,1
SBI09YMM6725312,61,23,12,11,1
SBI01QYQ4425460,72,17,14,3,1
SBI80NEL6217245,77,31,18,13,1
SBI34YIW9665754,20,28,26,2,1
SBI11MJI6434681,80,25,24,1,1
SBI34VTF7066559,61,33,31,2,1
SBI82EVD1960939,99,25,18,7,1
SBI43PID3982109,91,25,22,3,1
SBI21FSG2988354,20,24,21,3,1
SBI81VCO6022531,67,24,15,9,1
SBI81MWN3655350,98,23,21,2,1
SBI68LRN2344687,98,28,22,6,1
SBI20FZW1699654,64,27,17,10,1
SBI86LFP1822074,62,27,21,6,1
SBI35LWX0157031,81,34,18,16,1
SBI94JOB9636171,97,30,16,14,1
SBI23NSG3820775,95,23,21,2,1
SBI66WKC0467650,23,29,15,14,1
SBI15JEE7527342,63,23,21,2,1
SBI84KBD1397707,87,19,18,1,1
SBI46MZH0059604,89,18,14,4,1
SBI33HBN5794771,62,16,11,5,1
SBI32XAV5205315,65,20,17,3,1
SBI68OAA6568698,65,20,19,1,1
SBI60DJS7373701,84,18,17,1,1
SBI83SYH3017270,20,19,18,1,1
SBI14FRE3300561,96,22,20,2,1
SBI80LSO1590450,18,22,12,10,1
SBI19AHL2490684,81,13,8,5,1
SBI59DQB1488787,79,21,12,9,1
SBI70GPP8184460,61,25,20,5,1
SBI43AXD8293717,67,21,12,9,1
SBI13VUF0753930,19,19,10,9,1
SBI74LZW0986329,83,23,17,6,1
SBI66PDV1917666,63,30,16,14,1
SBI20TFI7257749,61,26,21,5,1
SBI90IWH2882553,92,20,15,5,1
SBI66SGU3955213,85,21,17,4,1
SBI34EXX3946605,78,27,15,12,1
SBI94MXU8053158,76,26,23,3,1
SBI72ODC5711010,89,32,28,4,1
SBI53ZVO9599678,77,25,15,10,1
SBI77VAY3086475,75,19,14,5,1
SBI33CYY8184388,61,27,25,2,1
SBI41PRF2327495,65,26,14,12,1
SBI33CKF1192837,74,24,20,4,1
SBI20XWU5495229,79,24,13,11,1
SBI88UHP2289464,92,22,21,1,1
SBI26ESB1842816,78,39,21,18,1
SBI35JUM1592965,22,23,14,9,1
SBI54AFF8019553,65,22,20,2,1
SBI79APL0573170,60,19,18,1,1
SBI74EFS8568840,67,26,16,10,1
SBI75KQJ9326660,67,17,15,2,1
SBI64TRB1377540,22,29,24,5,1
SBI92YOO4377244,80,31,24,7,1
SBI90UFP7073788,85,21,19,2,1
SBI54JKT8592470,97,31,25,6,1
SBI72ICD2589485,20,21,20,1,1
SBI51VQB6966454,81,31,25,6,1
SBI83ILG1544691,88,23,16,7,1
SBI04SBU7325458,66,28,24,4,1
SBI05QAT4252293,94,26,23,3,1
SBI65RAW4209406,80,29,23,6,1
SBI71HEB4053892,21,28,23,5,1
SBI86EBO8618451,79,22,13,9,1
SBI01EUC8382419,62,27,19,8,1
SBI09KYM0532440,81,24,13,11,1
SBI09JNF1743789,63,23,18,5,1
SBI07HKN6725638,93,17,14,3,1
SBI20FRW2501811,65,20,13,7,1
SBI08IJU0464448,89,27,26,1,1
SBI62KOQ3893675,88,25,17,8,1
SBI90CYM1586824,68,27,16,11,1
SBI28NYE3414674,85,25,20,5,1
SBI80HZW5359256,71,24,21,3,1
SBI38OCE5456394,18,28,25,3,1
SBI70YCO3377886,89,29,18,11,1
SBI47HJO2863999,91,25,15,10,1
SBI98OHP9019524,68,25,24,1,1
SBI42NNS1674098,19,26,18,8,1
SBI16YEG6272063,23,26,18,8,1
SBI52HAC2616087,67,24,21,3,1
SBI65YRN2690652,25,13,8,5,1
SBI97WOC9726875,25,31,17,14,1
SBI07AWZ8402521,60,31,29,2,1
SBI69YXY6320247,80,35,28,7,1
SBI47VAB6308516,73,17,16,1,1
SBI42FIJ4569469,79,22,17,5,1
SBI56VPC8477403,63,23,20,3,1
SBI34LZG1103417,64,18,15,3,1
SBI20UHK3186585,80,21,11,10,1
SBI79EWK8361239,84,28,18,10,1
SBI93HUV4674179,99,23,20,3,1
SBI69WLY4942689,81,27,26,1,1
SBI48UJT9763439,86,29,28,1,1
SBI99OWY9140224,97,26,15,11,1
SBI27SRD8601125,22,26,14,12,1
SBI61RWP1885917,98,25,22,3,1
SBI13WKP7116756,72,20,11,9,1
SBI13HPJ2892394,99,26,20,6,1
SBI11XLL0199335,21,25,14,11,1
SBI01CKV0615262,79,29,16,13,1
SBI23SEM1176053,92,28,25,3,1
SBI69WWD9313779,92,28,21,7,1
SBI16LWS8692371,64,18,17,1,1
SBI10WNY4597754,97,21,14,7,1
SBI59WTL7578561,19,25,13,12,1
SBI44CVQ6720422,83,23,20,3,1
SBI10PMS4620608,25,24,18,6,1
SBI05EKC2892549,74,22,16,6,1
SBI30GFQ3015177,72,24,19,5,1
SBI69LWL7981487,60,18,12,6,1
SBI00MQF0083137,62,14,13,1,1
SBI36NBF7149109,24,29,21,8,1
SBI02XSJ8775544,98,25,24,1,1
SBI28QVD1283903,99,24,17,7,1
SBI75RXQ1904854,97,21,12,9,1
SBI77OAI5083109,66,22,17,5,1
SBI20SEO5466726,87,34,23,11,1
SBI37WEZ6757985,61,28,20,8,1
SBI73SHU4229578,19,26,18,8,1
SBI55KQX4216382,89,25,18,7,1
SBI97SBN7409170,80,10,7,3,1
SBI40PLD5919356,63,20,18,2,1
SBI24XDU6791900,77,20,13,7,1
SBI86FQP7995395,19,20,18,2,1
SBI26NRK2127911,79,26,14,12,1
SBI56LTL8320868,82,33,17,16,1
SBI66HHL4490668,18,22,19,3,1
SBI55MBI8074087,20,41,39,2,1
SBI39YLD5475059,94,26,20,6,1
SBI58FSO7821655,74,19,16,3,1
SBI59TPF2203818,94,23,16,7,1
SBI77EZE5004771,89,19,16,3,1
SBI70VYW1584733,86,12,11,1,1
SBI38CQI7147662,81,24,22,2,1
SBI66UPH0848018,72,17,9,8,1
SBI98NSP4015215,24,12,10,2,1
SBI96PCN0741551,73,23,22,1,1
SBI43TIK5897513,91,25,20,5,1
SBI40XPO3046384,96,24,19,5,1
SBI49TWA3798423,73,21,15,6,1
SBI31CNZ2301520,24,24,22,2,1
SBI27QGU2890557,23,26,17,9,1
SBI31XVI1437359,21,19,11,8,1
SBI92VQN8016748,86,27,25,2,1
SBI94KGI8842673,70,24,22,2,1
SBI07XCD8840509,83,22,17,5,1
SBI94LWG4194096,97,29,23,6,1
SBI45GLY8951242,62,27,22,5,1
SBI99ZTI5804046,82,23,14,9,1
SBI92WGI4637364,63,26,14,12,1
SBI28NMB8158139,92,17,12,5,1
SBI98KCD2903197,74,24,14,10,1
SBI63MWS9950444,62,16,11,5,1
SBI27WEO2152444,96,19,16,3,1
SBI51JVW6741956,23,19,12,7,1
SBI27AWL7963424,66,21,19,2,1
SBI92ERL5210280,72,26,19,7,1
SBI12BBF1991587,90,21,16,5,1
SBI00EHF0648803,88,15,12,3,1
SBI02TNV3904828,90,25,15,10,1
SBI43JUM3837286,63,23,16,7,1
SBI27EDT9029553,62,24,22,2,1
SBI74QHR4746890,93,28,27,1,1
SBI01YBM4631719,76,20,12,8,1
SBI83CGD2329061,91,31,22,9,1
SBI73WGW6903631,82,21,17,4,1
SBI76OFQ6405175,61,27,26,1,1
SBI12FAI9660796,24,37,35,2,1
SBI29AIS3651952,86,34,20,14,1
SBI55RIP1283628,96,27,17,10,1
SBI61HYJ6904420,89,27,17,10,1
SBI76WSA4455095,86,34,22,12,1
SBI60AAJ7756884,72,18,12,6,1
SBI51GTY7256270,64,15,11,4,1
SBI06LRB1171461,85,29,21,8,1
SBI36OCB2247796,89,22,17,5,1
SBI87XXY6338702,82,36,29,7,1
SBI53VFG9504977,70,35,32,3,1
SBI15KQG6301691,84,32,17,15,1
SBI86EBC2992726,67,24,15,9,1
SBI30UWU1293530,77,28,24,4,1
SBI85DYI3942611,75,27,14,13,1
SBI87FUX2006807,95,15,13,2,1
SBI13OKX1323595,79,21,18,3,1
SBI09MEK8634315,91,23,17,6,1
SBI25AHA4877982,88,24,19,5,1
SBI76YEN5628106,61,26,15,11,1
SBI18ZQX5553229,73,19,17,2,1
SBI69KAK6694417,76,14,10,4,1
SBI33RQG9658583,18,27,24,3,1
SBI59YEJ3085693,61,11,7,4,1
SBI13JXC9129771,64,28,22,6,1
SBI43KGO6482884,88,14,12,2,1
SBI65ZHG5493140,83,21,11,10,1
SBI07ACD4709742,64,22,13,9,1
SBI77OGR9594342,80,14,8,6,1
SBI34UPX8225163,97,29,17,12,1
SBI28REG8883288,18,34,28,6,1
SBI36WNT3132085,73,33,24,9,1
SBI60MIK3859692,19,23,19,4,1
SBI42OUS9336233,91,31,19,12,1
SBI52MZV5713918,71,25,16,9,1
SBI67YRB6548434,69,18,17,1,1
SBI07NKB6376954,90,20,13,7,1
SBI96UGS6901613,96,15,14,1,1
SBI62RVV8535661,77,23,16,7,1
SBI27GHR8850726,70,35,28,7,1
SBI06STS9290161,71,27,15,12,1
SBI96VGT2378063,99,28,16,12,1
SBI63HGQ1635833,20,18,15,3,1
SBI75SCF1375428,63,21,14,7,1
SBI07YOB8750116,86,17,9,8,1
SBI81XOC8078142,92,31,26,5,1
SBI20DCR5430043,96,23,15,8,1
SBI46YEM0819739,24,17,15,2,1
SBI59GAP7408207,60,20,11,9,1
SBI86SQN1047166,68,26,15,11,1
SBI11BAL8452462,61,38,21,17,1
SBI55ANR2874082,87,22,19,3,1
SBI35OBH0111004,75,27,15,12,1
SBI02YVM5316392,60,28,25,3,1
SBI61EAW7434613,67,25,23,2,1
SBI50JDA3816170,78,21,15,6,1
SBI43QFF8280426,86,23,18,5,1
SBI63VCH1117848,90,21,11,10,1
SBI04HNI1608189,90,18,17,1,1
SBI05ZOG4199526,21,21,18,3,1
SBI03IBK8691865,18,31,21,10,1
SBI71TLT9327970,76,18,10,8,1
SBI16MXH3926209,84,24,22,2,1
SBI94WGH0254994,87,20,17,3,1
SBI20PAF2577824,60,27,14,13,1
SBI04OPI2202426,79,23,19,4,1
SBI15WOP8053531,20,26,18,8,1
SBI91UPI9894495,95,17,13,4,1
SBI83OMJ5727698,74,22,20,2,1
SBI94KPW1756025,95,19,13,6,1
SBI07WIT3204293,88,14,8,6,1
SBI66RZV2011967,85,29,21,8,1
SBI40QAQ0944875,83,32,29,3,1
SBI53HMV2599277,82,28,23,5,1
SBI77FCI7243120,75,29,21,8,1
SBI57RDE4684690,74,35,34,1,1
SBI42SGI2441016,92,24,14,10,1
SBI88REJ1588272,93,28,16,12,1
SBI20DCN3777527,77,38,21,17,1
SBI63ONJ7436700,63,26,15,11,1
SBI38HTD1809567,94,29,23,6,1
SBI07SFG2366761,99,29,17,12,1
SBI50VSC3707927,24,22,19,3,1
SBI71CCY9888624,93,23,16,7,1
SBI79UOC9170130,92,32,30,2,1
SBI19RNV0650381,74,27,20,7,1
SBI97QGN7448254,79,21,16,5,1
SBI15VPY9713815,95,24,19,5,1
SBI65FKI5124743,64,27,24,3,1
SBI93HNC2147893,18,19,15,4,1
SBI80MEE5839986,63,23,20,3,1
SBI85XEC0640022,75,26,23,3,1
SBI46DBS3693425,60,36,30,6,1
SBI98UKU3077078,25,28,19,9,1
SBI60IYZ1452121,19,24,14,10,1
SBI77VAS5760626,61,19,11,8,1
SBI45HJX7827611,96,17,9,8,1
SBI69YUJ6818746,77,26,15,11,1
SBI70BGF7271059,71,27,19,8,1
SBI13BRL3587742,93,22,13,9,1
SBI55EBK2357658,66,19,11,8,1
SBI23MZG2926556,90,29,28,1,1
SBI52IVY9102356,87,26,15,11,1
SBI29YBO7375288,79,26,17,9,1
SBI96TBB0594466,24,24,14,10,1
SBI75AFQ2072932,62,22,14,8,1
SBI38XUT5118848,24,17,11,6,1
SBI98PVF8672199,79,23,20,3,1
SBI71QUE7158972,66,20,17,3,1
SBI73SPU7862612,25,20,17,3,1
SBI87HVX2640152,18,22,14,8,1
SBI70RGE5637428,91,35,34,1,1
SBI56ODW0735576,64,27,22,5,1
SBI22NDU9245671,80,18,11,7,1
SBI70YEA8755959,23,25,14,11,1
SBI61HHO0042676,97,19,17,2,1
SBI24PZU3550551,90,21,13,8,1
SBI34OMU6675496,86,31,23,8,1
SBI32WTB8933529,75,27,14,13,1
SBI72RJB3660764,91,30,18,12,1
SBI85FOQ0813905,25,15,13,2,1
SBI81VUJ2359841,90,19,16,3,1
SBI08BKB8396244,73,22,17,5,1
SBI52KWN9723952,63,19,17,2,1
SBI34IUA7102107,99,23,16,7,1
SBI38NQK6701423,60,15,12,3,1
SBI65FEL8150669,91,26,23,3,1
SBI99KMH6095871,83,27,25,2,1
SBI99VZO0451879,80,25,22,3,1
SBI81OHX4644867,93,31,19,12,1
SBI35LUL3480143,66,29,20,9,1
SBI07KSB5112856,87,19,12,7,1
SBI67VEJ3065542,24,29,24,5,1
SBI56UDG0387939,88,23,22,1,1
SBI90DJV5875038,98,23,15,8,1
SBI63YLG0692417,95,20,15,5,1
SBI12XGQ6483416,22,26,23,3,1
SBI62ZAH2193804,73,27,23,4,1
SBI71BPC4543010,93,16,13,3,1
SBI42DRX0912931,92,26,23,3,1
SBI04VDU5462509,24,17,10,7,1
SBI23HLX0594926,90,16,15,1,1
SBI57KEN4483065,83,27,18,9,1
SBI98EWK5777458,61,27,22,5,1
SBI23AYD0956552,65,18,13,5,1
SBI41VTC9440109,88,15,13,2,1
SBI76OSV1189294,23,30,25,5,1
SBI28MZD5390241,97,31,25,6,1
SBI65CIW4778729,62,24,19,5,1
SBI25PIV7807194,19,37,20,17,1
SBI76FYD2478320,89,28,20,8,1
SBI01EAW0853768,95,20,13,7,1
SBI64UJV8920401,19,26,23,3,1
SBI52WXF1332503,95,28,22,6,1
SBI45BNI4937166,75,28,27,1,1
SBI44JHR3525967,61,23,13,10,1
SBI29CBD3698369,65,21,14,7,1
SBI41NHD0583660,63,31,19,12,1
SBI06VUV3684498,95,24,14,10,1
SBI66QBT9199303,74,30,16,14,1
SBI60MUF5746717,88,27,21,6,1
SBI39PNY6767010,68,27,21,6,1
SBI33BDS1757040,67,21,20,1,1
SBI83ZVJ4836856,80,31,28,3,1
SBI24SOV8527410,91,24,14,10,1
SBI34BNQ9620023,83,22,18,4,1
SBI33NQU4085682,60,19,18,1,1
SBI06DTN8444926,95,31,19,12,1
SBI25JUO4979844,18,28,19,9,1
SBI96PDM6621932,80,29,22,7,1
SBI74ZEB9152168,71,25,14,11,1
SBI66RAP8123541,88,24,22,2,1
SBI09YCI1609204,67,32,25,7,1
SBI92BSK6852922,76,31,18,13,1
SBI78VYQ9363335,23,23,15,8,1
SBI25YAV1290697,83,20,13,7,1
SBI34KHQ8098867,86,28,16,12,1
SBI67GOZ2311693,21,24,13,11,1
SBI91JMJ5767556,92,24,15,9,1
SBI20KDG5730437,63,27,16,11,1
SBI02WKL8793180,20,23,14,9,1
SBI25KAP4656333,78,22,16,6,1
SBI31FEP2857886,66,23,20,3,1
SBI54NZT6719131,25,23,21,2,1
SBI67MIQ2519490,74,27,14,13,1
SBI87KRQ4041935,90,24,23,1,1
SBI32XBQ8127877,62,34,19,15,1
SBI53GIS5589152,81,21,16,5,1
SBI52THL9417356,75,28,23,5,1
SBI88RBP5428190,76,25,16,9,1
SBI20ASH3801574,83,22,21,1,1
SBI71ZOF7248511,85,18,11,7,1
SBI70UNR3975286,22,31,20,11,1
SBI43SJT8802047,24,24,20,4,1
SBI86QEX9288459,77,22,20,2,1
SBI13KKL4334823,70,25,14,11,1
SBI43TJI8528067,69,22,17,5,1
SBI62HDU3258774,67,35,21,14,1
SBI08UXJ8145045,99,20,19,1,1
SBI58HVO1614386,20,29,18,11,1
SBI05HFR3641377,88,31,19,12,1
SBI02NQD7395420,91,26,17,9,1
SBI23GYD9494609,89,27,17,10,1
SBI12ZSM7293632,25,17,10,7,1
SBI70YTU0729985,86,28,19,9,1
SBI53LKG6202205,62,16,10,6,1
SBI51MVG5168925,80,28,22,6,1
SBI08JNQ7456326,84,17,16,1,1
SBI16CAG8583057,87,24,16,8,1
SBI22ZOI5558831,66,28,15,13,1
SBI33NTI6118301,61,28,25,3,1
SBI56DKC5181787,63,19,16,3,1
SBI33LBS4966652,18,25,21,4,1
SBI13HSI5259776,61,27,14,13,1
SBI94RSY9427473,62,21,11,10,1
SBI81ZEM4149816,20,29,25,4,1
SBI62DCK1220157,93,26,23,3,1
SBI65AJH6238185,88,22,17,5,1
SBI14BKY0108238,77,28,24,4,1
SBI44UIM4473809,82,23,12,11,1
SBI15CXT9448896,72,34,26,8,1
SBI97IEP8301701,86,22,21,1,1
SBI63VJK8414739,96,20,18,2,1
SBI80GVX0318737,92,30,19,11,1
SBI51KKN3045728,79,25,16,9,1
SBI34PUU7032579,87,14,8,6,1
SBI59UZC9187640,71,21,19,2,1
SBI55UUD5220838,71,19,13,6,1
SBI76OVX5654430,98,19,17,2,1
SBI35EZE4487764,61,25,22,3,1
SBI68WSI6081176,76,28,24,4,1
SBI95DLC1428705,76,28,26,2,1
SBI71YNB3377773,89,24,23,1,1
SBI17FFH0313035,60,28,17,11,1
SBI03GHV5944117,60,24,20,4,1
SBI34XZA9021634,75,30,25,5,1
SBI90OOV9637897,93,24,14,10,1
SBI88FFD4314750,94,31,26,5,1
SBI79GCV9869276,89,22,18,4,1
SBI28IPO8374390,85,29,23,6,1
SBI02CGA8335755,85,28,16,12,1
SBI16JYO9757755,75,23,12,11,1
SBI83ULO5203983,95,31,21,10,1
SBI43CUT9592769,87,20,13,7,1
SBI11GKK3655456,20,26,18,8,1
SBI71EFS0837567,87,35,34,1,1
SBI52YJE7034773,90,26,19,7,1
SBI12SCE9638746,64,29,27,2,1
SBI46JOP6752941,72,25,24,1,1
SBI54PCN6876322,76,31,18,13,1
SBI93VUE8056830,83,33,22,11,1
SBI39ODA6580787,90,27,16,11,1
SBI60JVX8316251,73,27,22,5,1
SBI82MHT1167105,69,21,14,7,1
SBI68OTC1230221,93,30,27,3,1
SBI90MFO1031742,66,31,30,1,1
SBI69HXN5984094,99,18,10,8,1
SBI47BWS2825293,65,22,14,8,1
SBI54RKA6079480,25,29,24,5,1
SBI24RHZ4009861,72,13,11,2,1
SBI27CUM6265012,94,28,16,12,1
SBI65GCK2091822,95,24,13,11,1
SBI58DYU9490703,90,28,25,3,1
SBI46SKY5294517,71,27,16,11,1
SBI10JLQ7754777,68,23,13,10,1
SBI75WDM1582214,96,25,13,12,1
SBI56LYH7540263,84,24,16,8,1
SBI96OVQ5048934,99,26,17,9,1
SBI09CGI3106693,90,22,12,10,1
SBI16JEG6465153,61,26,23,3,1
SBI98TKJ9830626,68,20,16,4,1
SBI49ZLU1629029,89,20,17,3,1
SBI55UAH1787560,60,25,20,5,1
SBI19GCO3448621,68,23,15,8,1
SBI43NFK5276794,60,32,31,1,1
SBI85TMA7463790,74,27,18,9,1
SBI96ZTI7185359,71,29,21,8,1
SBI90GTV9972668,25,15,9,6,1
SBI70BNG2141980,80,20,17,3,1
SBI03DLI6194984,73,33,24,9,1
SBI92XTS8494169,23,20,15,5,1
SBI84SXF9124041,86,28,22,6,1
SBI65LOF9838273,23,23,14,9,1
SBI80IVX1886055,75,27,18,9,1
SBI14HTB9049110,62,21,13,8,1
SBI37VJQ0432761,73,20,18,2,1
SBI23PFR7009604,78,28,25,3,1
SBI28LII8206404,70,24,20,4,1
SBI98IET1283066,67,18,13,5,1
SBI39NQV1734440,75,25,24,1,1
SBI50KPD9911979,19,20,14,6,1
SBI59NGM7448055,91,21,14,7,1
SBI25FMW5867850,80,23,14,9,1
SBI32NKC9685609,81,25,16,9,1
SBI08JHR9391399,82,16,14,2,1
SBI88MGA9312594,21,22,13,9,1
SBI72DNQ0859678,24,24,22,2,1
SBI01ZQL4538339,92,31,19,12,1
SBI65LUT6529610,23,25,23,2,1
SBI51WWW1729778,76,22,15,7,1
SBI09GZX7028860,25,26,24,2,1
SBI58OYZ4037995,95,17,9,8,1
SBI40BBC9035601,20,23,18,5,1
SBI27JGC1705648,69,32,24,8,1
SBI75YTE8418091,68,21,11,10,1
SBI47ILY6344952,69,30,17,13,1
SBI00IPB1767083,98,21,17,4,1
SBI35MTR1386803,25,16,13,3,1
SBI92FOJ6399817,65,23,13,10,1
SBI31HRS5386699,22,28,18,10,1
SBI12GNS5705796,66,18,14,4,1
SBI33ZZC2898106,61,19,14,5,1
SBI22BCE1540288,60,18,14,4,1
SBI00YMK1115421,75,28,20,8,1
SBI95SDR5167043,93,21,14,7,1
SBI36CWO9922026,19,22,15,7,1
SBI23GWC3192664,63,29,25,4,1
SBI63AIO7322085,90,32,18,14,1
SBI99DMN2926034,20,21,17,4,1
SBI43XYQ5555410,22,32,28,4,1
SBI07SGT1950082,85,24,23,1,1
SBI05LYV8958890,91,18,14,4,1
SBI09MNA7828152,68,29,27,2,1
SBI68URY0286217,76,22,19,3,1
SBI30ZLB5411698,85,20,19,1,1
SBI96MGZ2323459,95,27,26,1,1
SBI78GQF4974247,87,22,13,9,1
SBI66ZCX7017999,22,28,22,6,1
SBI78MPC1003083,64,25,17,8,1
SBI70QPS1166055,98,21,12,9,1
SBI89EID4609639,89,33,18,15,1
SBI88SMU2344745,64,18,13,5,1
SBI71AAL7902984,99,21,14,7,1
SBI09ZAI4163012,82,33,28,5,1
SBI55LTR1932617,81,15,8,7,1
SBI76QEY9369317,18,25,21,4,1
SBI48ZTO7821746,82,24,20,4,1
SBI67QUP0972846,80,25,20,5,1
SBI36GRN1781746,95,23,15,8,1
SBI18LZN3563307,74,15,8,7,1
SBI04AOV3528979,61,26,17,9,1
SBI45CFO2800354,18,17,9,8,1
SBI06EOC5802185,73,12,10,2,1
SBI62XOB8557205,19,25,21,4,1
SBI89NQX8604789,77,17,13,4,1
SBI20TFI7930506,24,30,27,3,1
SBI61DHR6073363,20,31,19,12,1
SBI73AFA8768571,80,26,15,11,1
SBI90GGO6345804,60,27,21,6,1
SBI91DFJ8724025,72,31,20,11,1
SBI11XRH7128513,78,26,19,7,1
SBI57ITZ6049553,86,21,14,7,1
SBI78OTP0040043,82,21,17,4,1
SBI99FFI2413044,89,28,23,5,1
SBI27NXS3543279,87,27,24,3,1
SBI55QWY9022497,94,27,15,12,1
SBI76MTL8715523,75,16,14,2,1
SBI02ACO9831124,98,29,19,10,1
SBI58WMJ8301300,64,12,7,5,1
SBI52HAB0054457,62,27,15,12,1
SBI30VWE2951326,21,26,22,4,1
SBI49ZNI4256169,96,22,12,10,1
SBI23CRP8828311,67,30,27,3,1
SBI81KOE3866871,97,20,19,1,1
SBI67BPD8671493,74,16,11,5,1
SBI37RKS7771154,93,24,21,3,1
SBI94XBM0489532,71,18,11,7,1
SBI45KEN6142819,61,24,20,4,1
SBI78MSW0615188,95,11,8,3,1
SBI93RLK1380705,20,28,22,6,1
SBI98NYX7828538,97,20,16,4,1
SBI17JWJ2473879,66,24,18,6,1
SBI62SYR3442733,70,30,23,7,1
SBI15RFB9336358,93,19,13,6,1
SBI18TPC1223771,18,23,16,7,1
SBI29FFS9894433,86,30,23,7,1
SBI61KHM8413592,19,27,14,13,1
SBI94HSK4849988,21,18,13,5,1
SBI89RRF3214940,76,27,22,5,1
SBI93PXJ6603910,23,25,16,9,1
SBI04XNE7589598,70,25,15,10,1
SBI60QTX7708458,64,21,11,10,1
SBI56KFZ9432336,60,28,24,4,1
SBI72ZIN3923321,86,21,19,2,1
SBI87SFU7369083,79,19,10,9,1
SBI91ESU1370716,81,22,21,1,1
SBI27DTI1227369,88,26,20,6,1
SBI16QQQ7598355,89,17,15,2,1
SBI50ICQ6479464,92,30,21,9,1
SBI33VHE1267113,67,24,13,11,1
SBI93FIJ3488111,94,33,21,12,1
SBI04GJJ6609404,94,20,14,6,1
SBI47JFF5299082,19,34,26,8,1
SBI37SZU8857285,62,11,9,2,1
SBI97HHO6676817,89,14,10,4,1
SBI83TBR8396497,89,26,19,7,1
SBI16XNL0954035,77,26,16,10,1
SBI44QNX0756952,72,17,16,1,1
SBI50CEW2318567,95,23,16,7,1
SBI87VCC6197807,99,30,28,2,1
SBI92HLH1989979,68,20,19,1,1
SBI06FVC6889346,65,27,24,3,1
SBI60VHV4546174,90,28,18,10,1
SBI84CQS5576948,86,16,15,1,1
SBI05MML3823684,93,19,12,7,1
SBI72PMS6312775,95,26,23,3,1
SBI01RPI7640612,66,15,10,5,1
SBI84HNR5153463,64,18,16,2,1
SBI29TFO4138378,96,11,6,5,1
SBI98LSN4444962,92,21,20,1,1
SBI60LWR9897546,71,18,10,8,1
SBI36UJF4977172,18,12,9,3,1
SBI15IRI9260624,72,25,22,3,1
SBI70KBO7843502,73,31,27,4,1
SBI67BNE4129249,99,20,11,9,1
SBI12PXN0225475,81,27,22,5,1
SBI36QUX7911720,79,19,16,3,1
SBI54YZO0991928,82,24,22,2,1
SBI74PVB3775971,25,21,11,10,1
SBI96NAD5262490,85,21,20,1,1
SBI96PVY6583222,20,21,18,3,1
SBI75YBL3253105,77,21,12,9,1
SBI93RIR2070426,89,33,21,12,1
SBI26WXV5924111,72,25,21,4,1
SBI30VIW4766858,87,26,17,9,1
SBI16AZK8314752,99,12,11,1,1
SBI75SJS3270180,22,28,27,1,1
SBI22OPF0012665,63,34,28,6,1
SBI90IOA8914556,99,18,17,1,1
SBI53CMP5442794,67,23,21,2,1
SBI75KKJ7389504,22,20,15,5,1
SBI39UBV0519760,90,27,25,2,1
SBI45VPX4610720,60,23,19,4,1
SBI56ZUN1871151,90,32,24,8,1
SBI30UKF9594978,86,31,22,9,1
SBI87LDL4208712,66,26,17,9,1
SBI18RQH6178963,21,23,14,9,1
SBI00HOI1020865,93,33,29,4,1
SBI80ZKS0525965,79,28,18,10,1
SBI61SWX4326859,61,28,24,4,1
SBI01UVZ7341221,75,33,17,16,1
SBI03RXK4045123,89,19,14,5,1
SBI86YKG7462305,23,18,17,1,1
SBI45NBH7610454,24,30,24,6,1
SBI00ZQX8052339,25,29,19,10,1
SBI34VXQ0841736,84,24,15,9,1
SBI99LQY8220657,83,17,11,6,1
SBI98OAL7448125,24,21,16,5,1
SBI20LJV6924507,80,25,24,1,1
SBI30FJK2951472,87,21,16,5,1
SBI57UNP0630449,96,24,16,8,1
SBI39HHP7241602,19,25,13,12,1
SBI36PIC0396447,25,22,21,1,1
SBI86XFQ0792550,65,25,22,3,1
SBI70ZZD6283145,19,26,20,6,1
SBI37MCC0277547,21,12,9,3,1
SBI64QLM8077964,19,29,16,13,1
SBI58FHY4253760,82,28,23,5,1
SBI64QQL6964351,69,32,18,14,1
SBI90RLU6966845,98,34,27,7,1
SBI60NZT0450883,78,27,14,13,1
SBI47LUO3509587,98,27,16,11,1
SBI46DYV6560863,24,30,23,7,1
SBI79ERM6093046,97,25,13,12,1
SBI76VUZ5829087,77,27,23,4,1
SBI51IKS6219872,97,36,33,3,1
SBI64MGA1891041,86,29,21,8,1
SBI30VGZ3801111,89,29,19,10,1
SBI21LKJ5489836,62,17,12,5,1
SBI28IUZ3474115,60,25,22,3,1
SBI74CFB6413865,85,25,14,11,1
SBI42UMG7000049,84,33,29,4,1
SBI40PSV3425226,22,19,15,4,1
SBI66OBC1386102,19,22,19,3,1
SBI58IZF4733481,63,28,15,13,1
SBI46TQZ0529822,68,24,18,6,1
SBI90JCA4494799,91,33,32,1,1
SBI30ECE6293801,86,28,25,3,1
SBI06QBT6608231,86,30,24,6,1
SBI60EZF9000569,81,26,24,2,1
SBI50JKP6517917,96,19,17,2,1
SBI49RRE4410018,22,29,24,5,1
SBI78OWS7336748,80,17,15,2,1
SBI25RYF3943842,22,28,16,12,1
SBI33DXM6630902,66,26,25,1,1
SBI43PWE1943388,60,33,28,5,1
SBI78VGZ1401687,85,21,20,1,1
SBI44HLS7520358,96,27,15,12,1
SBI02OBB4430619,76,22,14,8,1
SBI97FRJ3232860,62,21,18,3,1
SBI95VCV2604775,88,24,23,1,1
SBI41IEB4369452,76,26,19,7,1
SBI14COI4744630,25,24,17,7,1
SBI97BPD4965067,70,32,18,14,1
SBI21YSF7537147,88,36,20,16,1
SBI25COW0937752,88,20,13,7,1
SBI92XLN0508165,66,20,17,3,1
SBI65HNN9771552,23,21,12,9,1
SBI59CRZ0843478,60,35,30,5,1
SBI73JKZ5738593,98,29,18,11,1
SBI97RAA5257594,75,32,19,13,1
SBI87ZKX4531688,73,25,22,3,1
SBI92WUY6380355,71,31,24,7,1
SBI58LZV5063442,86,19,13,6,1
SBI15BEH0548521,79,25,18,7,1
SBI54NSG2029349,23,21,12,9,1
SBI96NOJ2529137,84,27,22,5,1
SBI32SJW2058091,77,24,16,8,1
SBI77HCS4973705,92,29,23,6,1
SBI68IED6335595,22,24,13,11,1
SBI97TPV1758450,99,19,15,4,1
SBI08PQV2907320,64,29,25,4,1
SBI02VZS7070685,88,22,17,5,1
SBI47TBJ8167736,71,23,15,8,1
SBI26AUJ5153850,84,22,19,3,1
SBI37ZFB8498237,21,26,17,9,1
SBI26NTV9764598,77,21,15,6,1
SBI20GAC5364856,69,31,26,5,1
SBI28URT2767879,65,20,19,1,1
SBI39VQO4439308,89,20,15,5,1
SBI51MYP6516172,22,26,23,3,1
SBI62AKE4092501,92,27,20,7,1
SBI67JLH0587759,86,30,16,14,1
SBI06RXN2962408,19,28,26,2,1
SBI20XER8133454,91,27,18,9,1
SBI99ZBM1909289,72,15,13,2,1
SBI53VEZ9161908,68,19,18,1,1
SBI59FPV7921025,69,23,22,1,1
SBI45JZK0346842,61,29,27,2,1
SBI23QVF9987870,21,15,8,7,1
SBI00YQC1216727,65,32,18,14,1
SBI27BWD0359043,92,29,20,9,1
SBI00OKH6903014,73,36,21,15,1
SBI82CBJ9963614,18,20,15,5,1
SBI06JSU8427507,81,29,15,14,1
SBI34NNQ4483823,60,29,22,7,1
SBI81XHQ7913416,65,25,21,4,1
SBI98EYM2513366,85,13,11,2,1
SBI48TWF6585828,97,20,15,5,1
SBI86RSQ9563146,94,26,15,11,1
SBI09HJH9910264,69,24,14,10,1
SBI70RSU4780876,82,30,29,1,1
SBI20FEX9602831,72,22,16,6,1
SBI29RAN1854328,84,18,10,8,1
SBI47DIC2802568,82,25,16,9,1
SBI96YIX1016768,69,22,13,9,1
SBI54FYY5427427,86,23,13,10,1
SBI21OGH7976727,77,27,18,9,1
SBI31JAZ9554977,24,20,16,4,1
SBI15ZGZ1108088,71,28,24,4,1
SBI38HWT7881479,97,34,25,9,1
SBI86DJK3920402,61,18,10,8,1
SBI19JBG4457362,97,20,12,8,1
SBI54QBD0100779,93,17,13,4,1
SBI55DBT4363443,67,16,11,5,1
SBI84ITW3752464,98,22,19,3,1
SBI21STJ3192514,82,21,11,10,1
SBI80GYA0243474,85,19,12,7,1
SBI19GKT2431364,24,20,16,4,1
SBI31LGC9524382,97,18,10,8,1
SBI81OXM3554372,76,26,17,9,1
SBI50JQB2140436,25,26,14,12,1
SBI94JNG1158451,70,34,20,14,1
SBI74UGO3699571,74,25,23,2,1
SBI10FRI2166955,69,21,20,1,1
SBI50WJW1131080,19,29,22,7,1
SBI79UXM1267552,90,24,17,7,1
SBI45YYS0199467,78,19,18,1,1
SBI98RUO5695817,76,21,13,8,1
SBI40SAI9237504,92,28,24,4,1
SBI00XUJ2685002,22,30,26,4,1
SBI21ZSH5415768,74,34,30,4,1
SBI57EHS8116375,77,17,16,1,1
SBI21FAK5519957,93,21,13,8,1
SBI37OMS7057909,63,27,19,8,1
SBI74CRF9301477,18,19,10,9,1
SBI58AXX1179790,94,23,13,10,1
SBI07KQD5142099,23,28,21,7,1
SBI65IBQ5784790,67,28,15,13,1
SBI67IQF2719931,23,27,18,9,1
SBI51GHD6478053,93,27,21,6,1
SBI96WJC3439910,75,17,13,4,1
SBI05QHR6714563,81,25,23,2,1
SBI09ZWS4515314,86,33,23,10,1
SBI42IYM9017106,75,30,16,14,1
SBI64ULM1414275,70,22,16,6,1
SBI04FCJ3079743,99,32,19,13,1
SBI19EIX4887665,81,26,20,6,1
SBI58JJE7808913,73,29,25,4,1
SBI68XSR5598350,89,28,27,1,1
SBI81JND9251167,80,12,10,2,1
SBI15NRK3526774,86,32,26,6,1
SBI31FXP4473865,76,20,13,7,1
SBI25BML1847636,97,23,20,3,1
SBI52DYH1970670,69,22,14,8,1
SBI15CUV0917440,87,20,13,7,1
SBI47DDY3452241,22,16,15,1,1
SBI73BSF5575784,98,14,10,4,1
SBI28SXV0679237,73,21,20,1,1
SBI60CTO5059667,63,15,8,7,1
SBI99FUN0158483,83,26,22,4,1
SBI35WVA4402824,23,22,14,8,1
SBI06IBV9552400,88,29,15,14,1
SBI45KME6964849,95,15,11,4,1
SBI08XUV8490984,78,24,20,4,1
SBI89FTV9033485,66,26,19,7,1
SBI83BKX3683538,78,17,15,2,1
SBI64KRY3731933,24,31,17,14,1
SBI62CQA1095520,86,19,12,7,1
SBI82FIY5601796,95,28,26,2,1
SBI61QNT0908782,81,23,18,5,1
SBI22GUT1522649,75,26,20,6,1
SBI15CAC8824810,81,25,23,2,1
SBI45SSL2579231,20,25,20,5,1
SBI68HII4133398,69,29,18,11,1
SBI74YGN4716721,62,29,25,4,1
SBI30MDG1031197,98,26,23,3,1
SBI90XGI2054398,92,32,21,11,1
SBI67APQ7547767,87,27,17,10,1
SBI77XQB7766343,19,24,15,9,1
SBI52UPV6423964,71,30,20,10,1
SBI79ZVX4119336,21,28,20,8,1
SBI54WFJ3875998,94,27,19,8,1
SBI82HNX6317338,80,26,17,9,1
SBI73OTU3671259,99,32,17,15,1
SBI37TXF2502117,23,21,18,3,1
SBI28XGI9961964,80,25,20,5,1
SBI30FWE1327713,98,22,16,6,1
SBI02PRZ6789533,24,21,20,1,1
SBI00LUD8484948,20,20,17,3,1
SBI50GZM6044189,66,32,24,8,1
SBI43SOP8555027,21,34,32,2,1
SBI48ZNZ2963432,21,27,26,1,1
SBI67JRA1497989,18,33,27,6,1
SBI10HWX9663373,76,32,23,9,1
SBI01FXT3401622,82,26,24,2,1
SBI34SRI9411918,66,22,20,2,1
SBI79ZZY8622746,79,28,19,9,1
SBI43RBU1973710,20,23,19,4,1
SBI65TLA7562233,93,23,21,2,1
SBI52XMN9899622,61,33,17,16,1
SBI11ISY0770815,65,24,21,3,1
SBI27TQO8825483,81,26,17,9,1
SBI65DYN9835406,24,33,24,9,1
SBI30EHK9453022,63,21,11,10,1
SBI57MRY5391752,84,30,24,6,1
SBI46AQQ6924594,75,29,22,7,1
SBI61NCG6414344,63,20,18,2,1
SBI86RPK7239497,87,29,21,8,1
SBI96PTR6195741,65,23,17,6,1
SBI15FNY7769780,21,27,25,2,1
SBI81PXN5292142,69,18,15,3,1
SBI37CFO7763802,62,28,18,10,1
SBI79NRT0390406,19,26,22,4,1
SBI62YYP7040662,72,30,19,11,1
SBI11EME0979606,77,22,21,1,1
SBI79UVT9779444,66,23,12,11,1
SBI37HHK1791435,73,26,18,8,1
SBI21VRR6722331,69,33,25,8,1
SBI89JRH1063269,92,32,29,3,1
SBI94VKY2487421,67,30,21,9,1
SBI10BJR5661474,97,15,10,5,1
SBI10YWV3746698,65,16,15,1,1
SBI59ECN4573394,80,23,16,7,1
SBI45EHK7369614,79,20,16,4,1
SBI80DNY3543293,62,22,12,10,1
SBI13GYD8707558,70,16,12,4,1
SBI04WXP2888410,62,23,18,5,1
SBI91WIC1193587,83,24,13,11,1
SBI01BKR6465982,65,28,27,1,1
SBI21CLP7103081,98,17,14,3,1
SBI60WVW6446071,68,24,19,5,1
SBI73VOZ8653337,21,30,26,4,1
SBI30EXK0360355,98,25,17,8,1
SBI79IQJ9681403,70,33,31,2,1
SBI62ZCM5958778,80,17,9,8,1
SBI55KMW1511832,82,18,14,4,1
SBI81OEC6344081,87,25,24,1,1
SBI92UGX9967556,89,28,18,10,1
SBI38LNF9935216,94,28,20,8,1
SBI70GVP1470724,97,26,25,1,1
SBI25NET0131137,73,27,19,8,1
SBI92AEZ6425610,74,31,23,8,1
SBI09HXJ9502442,89,20,12,8,1
SBI41GBR3824024,18,30,19,11,1
SBI54FCD2287373,68,31,29,2,1
SBI76RMZ9830549,81,26,16,10,1
SBI01OIJ6679318,78,27,23,4,1
SBI77GZN1824081,18,28,20,8,1
SBI98JVQ6450332,60,29,21,8,1
SBI22QBB7482422,85,30,21,9,1
SBI46DLV8920086,18,30,19,11,1
SBI60OAC1056495,99,23,19,4,1
SBI12OLN5915158,88,28,17,11,1
SBI11SZK6858060,73,23,13,10,1
SBI04CDG8885810,99,35,31,4,1
SBI45LIG7027809,82,27,14,13,1
SBI77PYF7980428,73,31,23,8,1
SBI39IWY6611769,89,25,22,3,1
SBI68YEL9301255,21,29,24,5,1
SBI21LBZ7702595,25,16,12,4,1
SBI68REQ0561314,21,27,19,8,1
SBI17QOL3833848,73,23,19,4,1
SBI67AYR7763620,60,25,20,5,1
SBI67KVI4493666,74,26,19,7,1
SBI83IYR0605291,62,21,12,9,1
SBI29TWE2890391,62,22,20,2,1
SBI72QWX1568965,90,24,21,3,1
SBI19TKW6231412,92,31,28,3,1
SBI58JZQ1354939,74,37,28,9,1
SBI42KLA4299359,82,19,11,8,1
SBI71KTN9385917,64,16,15,1,1
SBI24LFQ0757722,62,22,19,3,1
SBI10IOZ8430181,74,23,13,10,1
SBI46EWG2139425,87,10,8,2,1
SBI76UDP8404854,21,26,16,10,1
SBI78IWN5482333,99,25,22,3,1
SBI96DLZ4036025,89,18,12,6,1
SBI63ZKA8899209,73,26,23,3,1
SBI77JAU0826108,73,32,28,4,1
SBI25UMR2816633,65,16,11,5,1
SBI63MBO7436511,75,26,14,12,1
SBI38MVE4709365,81,25,13,12,1
SBI14BKK0196077,24,21,16,5,1
SBI28BHW3569325,63,19,12,7,1
SBI97HWW6519819,61,27,19,8,1
SBI38RMU0209527,62,32,18,14,1
SBI33NHG7821802,83,14,11,3,1
SBI47QBY6033157,67,23,14,9,1
SBI08MUN2927751,74,32,19,13,1
SBI26VGY2837726,73,25,14,11,1
SBI44IQX3838069,83,23,14,9,1
SBI20AXI9194583,94,28,19,9,1
SBI50FLY5102913,79,25,18,7,1
SBI55HAG1115599,83,15,9,6,1
SBI05TLI5557489,77,26,19,7,1
SBI96GHW0247224,18,21,12,9,1
SBI76YLJ4204539,82,24,21,3,1
SBI74YIB7902433,61,24,14,10,1
SBI13ITB6684010,95,21,11,10,1
SBI42HWA6914226,75,27,22,5,1
SBI27UWZ5027387,65,19,11,8,1
SBI23TLS6484035,95,28,20,8,1
SBI56EGR9984576,60,37,20,17,1
SBI37CLY6464307,92,28,19,9,1
SBI63TFC3721876,94,31,18,13,1
SBI87WQK2615005,77,23,22,1,1
SBI32YWO0761249,88,24,21,3,1
SBI77VVA8220251,69,24,15,9,1
SBI53WMD6968803,23,24,16,8,1
SBI03ORV4120975,20,31,19,12,1
SBI62DGS4349504,82,24,16,8,1
SBI55REC9945692,61,29,23,6,1
SBI57CGX8662707,95,29,27,2,1
SBI65MRR4509538,24,28,16,12,1
SBI93ZOZ6141637,74,27,25,2,1
SBI47EDE6850200,19,22,16,6,1
SBI44BBH7619908,89,18,12,6,1
SBI98QYZ4419542,74,29,26,3,1
SBI53MPS6132447,92,23,21,2,1
SBI15JNT6878323,61,22,14,8,1
SBI95FHW0045418,79,13,12,1,1
SBI96LHJ4579113,18,21,13,8,1
SBI40PZY1484993,90,24,21,3,1
SBI77OFB6787476,92,22,14,8,1
SBI26TPW7594540,81,20,14,6,1
SBI25YWA8044027,74,15,9,6,1
SBI06WVI2413071,83,28,17,11,1
SBI95AUY4364926,98,25,14,11,1
SBI23ETU5211199,23,32,17,15,1
SBI19ILK5765312,93,18,10,8,1
SBI88FGK5348611,74,24,23,1,1
SBI52CQT1907882,69,29,17,12,1
SBI72HEW4951412,88,23,22,1,1
SBI00TVM6949971,23,26,24,2,1
SBI46YNF1827677,87,27,26,1,1
SBI52OQQ1939782,21,12,10,2,1
SBI27BVG7314904,99,23,21,2,1
SBI06DDQ7918939,73,21,16,5,1
SBI05ZWW2421668,73,27,14,13,1
SBI16GPI6566291,92,12,10,2,1
SBI09PFU8200250,61,28,17,11,1
SBI09IKL0475555,90,25,20,5,1
SBI80ZNC1834002,97,33,23,10,1
SBI91SXH5861736,66,27,15,12,1
SBI97TFH0858917,71,29,15,14,1
SBI22JTB9009297,80,21,16,5,1
SBI74XUT0471144,76,27,16,11,1
SBI23PFK6913569,66,24,22,2,1
SBI27RGV5459945,77,23,14,9,1
SBI42KSF8581596,81,20,18,2,1
SBI93MCM8320017,88,26,20,6,1
SBI22HLU4048317,94,21,13,8,1
SBI19BGZ5581579,21,24,21,3,1
SBI65MDK0554577,91,30,28,2,1
SBI43GUP5705067,94,20,19,1,1
SBI50EEI8288762,22,21,11,10,1
SBI01VOO6092727,69,34,33,1,1
SBI78TIL5835477,83,32,25,7,1
SBI18TWJ9736903,24,30,26,4,1
SBI85YDN2820459,97,28,17,11,1
SBI02JID9157871,93,29,20,9,1
SBI32MTF1560751,72,29,22,7,1
SBI84ARP0805411,60,34,26,8,1
SBI98WQK3353963,72,22,20,2,1
SBI23MKO7457376,73,28,19,9,1
SBI17QAP3790093,97,23,13,10,1
SBI30LWC0909203,24,16,15,1,1
SBI52WQO6991950,79,23,14,9,1
SBI07MNR6654204,88,22,13,9,1
SBI16NPA5971621,89,25,20,5,1
SBI39XNO2579412,69,28,26,2,1
SBI07UJN2613359,63,17,16,1,1
SBI03KRM0169582,90,24,15,9,1
SBI08RTL6490030,84,29,18,11,1
SBI51UNT5761263,21,14,9,5,1
SBI44EIW0440315,94,28,22,6,1
SBI56AAK7331490,88,30,22,8,1
SBI03UFH8975461,90,16,9,7,1
SBI60HHN1768618,24,32,29,3,1
SBI71XSX1791315,69,21,13,8,1
SBI60JNU1409059,21,24,17,7,1
SBI80XMB9889139,66,27,24,3,1
SBI40BCE8108937,20,25,20,5,1
SBI77OUH9656816,66,20,14,6,1
SBI84QGQ3573818,74,22,14,8,1
SBI43FQD1482240,90,30,28,2,1
SBI04IMN3677409,84,27,24,3,1
SBI52HTG1686126,91,33,25,8,1
SBI21JLB5875784,88,23,17,6,1
SBI47CVQ3262995,84,23,14,9,1
SBI37ZWS0390673,72,26,16,10,1
SBI40EJZ5564910,65,27,23,4,1
SBI11JBH4051192,63,24,17,7,1
SBI62WFR6123469,91,27,15,12,1
SBI52XYB6504195,84,31,17,14,1
SBI61ETT2628738,68,25,13,12,1
SBI57EOG0645030,22,22,13,9,1
SBI51BXV4764867,73,18,13,5,1
SBI53QUK9012453,91,25,15,10,1
SBI59ZHO7278066,84,17,16,1,1
SBI85NBW9561762,63,12,9,3,1
SBI63KAB1584739,72,24,14,10,1
SBI01DMH5732912,82,22,12,10,1
SBI88VDO8176638,91,26,17,9,1
SBI77JFZ1758553,69,23,17,6,1
SBI94LPY4690986,98,30,16,14,1
SBI49EBG2134624,73,21,16,5,1
SBI44ZZL8657521,25,26,17,9,1
SBI32MHB8920100,88,23,20,3,1
SBI36RCG9811455,67,28,22,6,1
SBI84HHK1818923,77,17,12,5,1
SBI02VLL4976236,22,22,21,1,1
SBI01WXA0642627,23,27,19,8,1
SBI91CVW4530927,82,21,13,8,1
SBI47DAY8227932,87,16,13,3,1
SBI86CJQ5548752,91,25,22,3,1
SBI86ROW4887791,78,28,21,7,1
SBI51QAE5683754,70,36,30,6,1
SBI64KEX9959224,62,17,12,5,1
SBI78EDD6279031,72,22,19,3,1
SBI61AWC1253723,90,27,17,10,1
SBI12DZU5561607,71,25,15,10,1
SBI02OYW0792352,87,32,23,9,1
SBI47JHZ1360795,19,25,22,3,1
SBI39PFR9036253,69,29,24,5,1
SBI21VPR3109193,24,20,17,3,1
SBI55PUL0677265,78,17,13,4,1
SBI97NLI6722049,82,24,17,7,1
SBI75SLQ0296742,83,16,11,5,1
SBI50YKR9100484,85,36,27,9,1
SBI75KKP3291178,82,25,19,6,1
SBI37CCG6847826,25,20,11,9,1
SBI96UBC3446411,24,24,22,2,1
SBI31NUP1463640,19,30,29,1,1
SBI94OCN2512269,94,26,25,1,1
SBI95TNP2921394,87,28,21,7,1
SBI80EYT4042533,91,27,24,3,1
SBI12PTK8960157,74,25,21,4,1
SBI13CKT4750075,62,32,29,3,1
SBI73GID8322171,19,32,29,3,1
SBI92JIL4630910,95,27,21,6,1
SBI29CMY1835880,72,26,15,11,1
SBI05PYQ4661124,85,30,20,10,1
SBI15HTV6598515,91,28,16,12,1
SBI80BLD7316269,76,23,21,2,1
SBI96AZG2124047,92,27,19,8,1
SBI07NZG5651079,90,22,20,2,1
SBI29FBR2085807,64,33,20,13,1
SBI80AIX2816153,75,21,16,5,1
SBI87YSK5468575,70,13,11,2,1
SBI01SAO9081679,99,31,18,13,1
SBI01JKA5563300,19,27,22,5,1
SBI66OFL5221079,65,24,17,7,1
SBI67MOL5939837,60,30,28,2,1
SBI73SAS1929932,78,27,26,1,1
SBI89JZT4579426,92,18,13,5,1
SBI66ZSH2402605,20,18,13,5,1
SBI29YYF2999374,25,25,16,9,1
SBI53LUY8890163,77,23,22,1,1
SBI35OCW1542144,20,13,9,4,1
SBI38TSM6124179,23,36,28,8,1
SBI62NTZ3184021,83,20,12,8,1
SBI40LKH9377693,62,22,19,3,1
SBI06XZG7577919,97,15,9,6,1
SBI41GWD9064462,60,34,29,5,1
SBI68AOR4347520,63,33,17,16,1
SBI58TZI8530136,66,28,21,7,1
SBI74CKZ1638390,91,27,25,2,1
SBI73LST6040521,64,27,25,2,1
SBI26NIT7400534,24,27,21,6,1
SBI78BZK2859202,69,27,14,13,1
SBI06RKD4703123,65,31,22,9,1
SBI16TJJ8550441,88,28,17,11,1
SBI79QTI3539391,64,15,8,7,1
SBI71QFM7027859,73,25,16,9,1
SBI83EPB9210257,84,29,17,12,1
SBI26IXH8428443,92,26,18,8,1
SBI27DAO3726963,68,21,19,2,1
SBI35JZY4651086,21,27,17,10,1
SBI22TLU7292996,23,19,16,3,1
SBI62OWE7822212,61,31,19,12,1
SBI34YFT2155294,93,26,17,9,1
SBI43LEI8452806,98,20,19,1,1
SBI42DCF9605474,75,24,18,6,1
SBI82DLJ7167357,61,23,22,1,1
SBI76FEP9131321,22,22,20,2,1
SBI85LQL3229453,70,26,25,1,1
SBI25HTZ1030882,20,20,12,8,1
SBI13DTN6602694,91,33,30,3,1
SBI25OUF1923976,62,28,24,4,1
SBI83XKK0291723,93,29,18,11,1
SBI02FEX9763566,78,16,12,4,1
SBI31PBA3690016,74,22,17,5,1
SBI89VFM9241038,66,31,19,12,1
SBI29GIU1524645,20,26,20,6,1
SBI13WWM6664978,76,28,18,10,1
SBI73NSE4702461,98,21,19,2,1
SBI86ANR2011930,63,20,12,8,1
SBI97PFO3725492,74,31,17,14,1
SBI10XHH2050343,24,24,16,8,1
SBI70LIP9821963,84,20,17,3,1
SBI79QQL5041759,20,23,14,9,1
SBI00LCT0724151,63,33,20,13,1
SBI96TKT6926999,21,17,15,2,1
SBI23LMG9130097,74,23,22,1,1
SBI07IYJ5972331,20,22,20,2,1
SBI75NFZ9784326,25,27,25,2,1
SBI58BUI3164656,73,27,16,11,1
SBI23XHJ4453006,63,29,17,12,1
SBI23IRK9138096,82,28,19,9,1
SBI99RGD7458889,68,22,16,6,1
SBI43MWH5381002,63,25,20,5,1
SBI63KNU8118458,92,20,11,9,1
SBI20OLL8596670,84,21,19,2,1
SBI48JGW5622786,90,18,10,8,1
SBI77YYB2055424,74,28,27,1,1
SBI31FZC2420789,90,26,14,12,1
SBI19FGW2765249,25,22,13,9,1
SBI76AYV6333906,86,21,13,8,1
SBI59THC5852860,96,25,19,6,1
SBI69SNF4911480,80,25,23,2,1
SBI53BUN0961612,64,21,19,2,1
SBI92LOU5004575,24,19,11,8,1
SBI05DNW0652090,24,21,19,2,1
SBI27YFP9359430,89,22,18,4,1
SBI34JFK2450255,21,26,19,7,1
SBI24GFZ1917333,76,29,23,6,1
SBI43CSI2073483,92,24,22,2,1
SBI76YLJ8001469,93,27,25,2,1
SBI90LAX5633085,94,20,16,4,1
SBI14SOA4431560,73,17,10,7,1
SBI75ZVP4734286,69,30,16,14,1
SBI87ERO7748309,21,26,21,5,1
SBI97AZD5212794,69,17,16,1,1
SBI37MUE2780397,91,29,20,9,1
SBI28VEN5219198,89,26,22,4,1
SBI35LSZ5466950,92,27,15,12,1
SBI24TZB7859111,66,18,15,3,1
SBI89MIH9010376,79,29,26,3,1
SBI38BNB5343389,73,18,14,4,1
SBI80WSI9373731,78,29,17,12,1
SBI21TKZ5451082,66,23,16,7,1
SBI54CDA8017368,19,22,18,4,1
SBI52EDL6327132,99,26,17,9,1
SBI70BGN2958626,92,28,26,2,1
SBI26AWI2855317,89,33,28,5,1
SBI23FZD7208235,84,19,11,8,1
SBI66EXA6597576,65,20,18,2,1
SBI82OGL9377208,61,31,20,11,1
SBI67HYW2554883,67,24,20,4,1
SBI39PCM9041136,90,20,18,2,1
SBI02TFJ2718582,77,23,22,1,1
SBI39DZY7279938,21,29,20,9,1
SBI97FHU1961103,24,28,21,7,1
SBI11IAP8928415,20,22,14,8,1
SBI23ATM0752660,94,23,18,5,1
SBI58KWM6471145,99,29,19,10,1
SBI21VEU9119455,19,20,11,9,1
SBI14SSS7723155,76,22,12,10,1
SBI68IFO6087554,18,30,25,5,1
SBI07YTD7811421,83,26,23,3,1
SBI24OBP2123243,22,33,26,7,1
SBI64ZUA3171047,73,24,22,2,1
SBI15MDQ5088189,96,23,14,9,1
SBI45FRM0170707,66,23,14,9,1
SBI26JAD1591995,84,33,21,12,1
SBI64TBA1851850,97,20,12,8,1
SBI23KGV7369773,84,26,14,12,1
SBI47RWD8060352,88,27,22,5,1
SBI71LUJ4709396,19,28,26,2,1
SBI13SDO3642855,86,33,28,5,1
SBI63CVB4592968,97,29,28,1,1
SBI15MQS6059329,81,29,17,12,1
SBI47PJE4283378,20,23,14,9,1
SBI35FSG3219259,87,29,21,8,1
SBI40RQK8920427,64,40,30,10,1
SBI50WOH1984388,67,31,19,12,1
SBI54SZB8241851,92,23,22,1,1
SBI06ESA5914353,84,28,24,4,1
SBI79FEN7496061,66,21,18,3,1
SBI60YQJ4528032,25,22,14,8,1
SBI70INU9603606,80,20,16,4,1
SBI75HNH0736447,88,23,22,1,1
SBI90WZA9833872,86,27,23,4,1
SBI88EVP8515689,80,31,29,2,1
SBI74GIV9763364,68,29,17,12,1
SBI89ULY0455562,77,22,20,2,1
SBI60GIC8514217,64,23,16,7,1
SBI32XCH5826859,21,36,33,3,1
SBI48CXK8850714,24,30,29,1,1
SBI54QTO5768961,21,22,15,7,1
SBI73KWE2207698,98,30,20,10,1
SBI82MFT0392005,20,31,18,13,1
SBI85UZZ7352818,98,29,22,7,1
SBI59HLK0606486,68,34,24,10,1
SBI93NST2918806,62,21,19,2,1
SBI06EYR8905680,93,31,30,1,1
SBI01PVV6503314,74,28,25,3,1
SBI29WZS8974083,24,19,18,1,1
SBI61COW8630352,63,23,14,9,1
SBI03IIO4952986,86,28,17,11,1
SBI45MAU3315330,78,28,21,7,1
SBI26WCY3516162,96,32,17,15,1
SBI39UIV4277292,19,25,21,4,1
SBI11ESW4514694,24,15,13,2,1
SBI05HMH0903540,21,18,17,1,1
SBI74LTH4198911,21,25,19,6,1
SBI08UOX8020789,93,29,21,8,1
SBI03ZHH3985339,93,28,16,12,1
SBI88VSV7632634,60,16,10,6,1
SBI70HEP6761886,21,21,12,9,1
SBI35MKQ7484420,92,25,20,5,1
SBI38FTD7165771,67,22,15,7,1
SBI35GOP5072650,79,35,32,3,1
SBI82GGL4116490,99,18,12,6,1
SBI63ZBJ9337693,23,29,20,9,1
SBI46UTX8998317,67,25,16,9,1
SBI00BTN3627568,66,28,24,4,1
SBI44LON1212580,63,27,21,6,1
SBI30YMK0693276,97,30,20,10,1
SBI56KBE0368322,89,19,12,7,1
SBI63TKS2031498,99,25,13,12,1
SBI19MOT5349846,77,28,16,12,1
SBI54HDU4090324,78,23,20,3,1
SBI55TOJ2662534,74,15,11,4,1
SBI18YWM1502788,20,22,19,3,1
SBI89OAI5996843,62,32,29,3,1
SBI63XRF4047045,71,19,11,8,1
SBI97ZQY9070837,74,20,17,3,1
SBI01MPG5920488,82,33,28,5,1
SBI50BEX5431843,66,14,12,2,1
SBI63YJU9609196,85,28,23,5,1
SBI03TMB0299241,92,19,13,6,1
SBI76WIE5390752,65,15,10,5,1
SBI33SFS5439342,79,24,23,1,1
SBI79CHO2349930,94,18,17,1,1
SBI10PAE7740698,25,25,23,2,1
SBI66ARN6471111,98,28,25,3,1
SBI89LKX6771790,95,29,21,8,1
SBI99PKR4436028,67,25,15,10,1
SBI04KQH2840265,23,29,26,3,1
SBI88WJN0511939,90,18,13,5,1
SBI96ZUZ0353050,75,26,14,12,1
SBI93QWU8397694,96,25,20,5,1
SBI15EEM3903960,98,27,21,6,1
SBI95TLY8928360,62,29,21,8,1
SBI57XQT0036420,72,29,19,10,1
SBI90QYG1309371,66,23,17,6,1
SBI00TWB7225779,99,22,15,7,1
SBI61DLH0451660,66,27,22,5,1
SBI19ILV7353221,65,23,16,7,1
SBI07GZW7336044,77,19,17,2,1
SBI02TKW4034943,19,34,29,5,1
SBI70FJN9639560,76,29,19,10,1
SBI28LOS5900235,73,26,20,6,1
SBI05RWM8272079,93,20,19,1,1
SBI99DQO2040316,22,28,22,6,1
SBI49SOG7385556,72,22,21,1,1
SBI68UBI5330936,72,27,21,6,1
SBI89XPB5646086,63,33,17,16,1
SBI23SIZ8437210,79,27,22,5,1
SBI73GJP9601338,73,25,23,2,1
SBI69NVJ9280668,67,32,31,1,1
SBI92TDS5234330,93,23,18,5,1
SBI78LRL4643533,19,31,30,1,1
SBI91FBW1807406,61,21,18,3,1
SBI23RJC6244625,60,22,14,8,1
SBI86JNS7062952,61,28,18,10,1
SBI81UVU9857822,77,18,15,3,1
SBI63GOR1997048,88,32,28,4,1
SBI21KKJ0610835,81,23,18,5,1
SBI01NBO8307472,69,18,11,7,1
SBI04DHL5307940,18,28,16,12,1
SBI50DXE1891501,82,26,14,12,1
SBI24KZQ2654827,93,24,17,7,1
SBI83YIU5471120,69,25,22,3,1
SBI16PUG0957153,98,30,24,6,1
SBI01ISO8163486,81,20,12,8,1
SBI57FXX4545819,62,15,11,4,1
SBI16XDS3021274,69,15,13,2,1
SBI45XFZ0026761,81,31,18,13,1
SBI46IYP0874564,25,29,24,5,1
SBI71UGE9851885,20,11,10,1,1
SBI41CEZ0007610,91,23,16,7,1
SBI89BQH1403189,64,30,25,5,1
SBI13YGL9698671,80,25,24,1,1
SBI82ICL2763233,94,31,25,6,1
SBI51LVE6784278,88,24,18,6,1
SBI37PHV8964934,91,25,21,4,1
SBI54UGI2468048,68,27,18,9,1
SBI89DKZ2406127,81,27,21,6,1
SBI48JCK2263210,95,18,13,5,1
SBI66AMS2085353,72,26,20,6,1
SBI50GMB3673468,97,21,19,2,1
SBI07NVG1734996,23,25,22,3,1
SBI96HHN5191579,71,28,24,4,1
SBI10BIL1631809,60,23,19,4,1
SBI56EIR4652760,25,26,23,3,1
SBI76DNG1565433,70,26,19,7,1
SBI02DMZ7183944,93,27,21,6,1
SBI48RAT1989275,94,23,13,10,1
SBI31CBM2543815,99,23,19,4,1
SBI15FZX2974321,65,25,16,9,1
SBI61DQP1390500,90,22,17,5,1
SBI27OEE5879580,77,26,24,2,1
SBI67HZH0601301,76,13,10,3,1
SBI71UFI1026899,67,22,18,4,1
SBI20AMA3674051,75,33,29,4,1
SBI75DTO7583864,20,23,13,10,1
SBI64LZJ2000714,73,25,22,3,1
SBI10YXD5664620,70,18,11,7,1
SBI01GIU6813657,73,31,25,6,1
SBI51PIN4664431,70,31,18,13,1
SBI81JEY7993538,89,28,26,2,1
SBI91UJX0781514,84,26,16,10,1
SBI10MPT8779218,71,26,18,8,1
SBI03TKN9215076,90,21,13,8,1
SBI78JYD9651231,61,28,25,3,1
SBI68YVX1975131,63,32,19,13,1
SBI60XRM3382547,87,17,12,5,1
SBI34YBK5657624,72,31,21,10,1
SBI64USM2283277,88,17,13,4,1
SBI33SJP9978322,95,27,25,2,1
SBI61YQT5630711,84,28,16,12,1
SBI07EPS0933590,73,19,18,1,1
SBI95DHE3957244,88,19,15,4,1
SBI17BMA9170031,78,16,12,4,1
SBI73HBD5305689,98,22,19,3,1
SBI68CGP0873030,66,28,22,6,1
SBI09WDL3642642,20,23,22,1,1
SBI67OBV2420600,89,28,23,5,1
SBI21IPJ6504739,85,22,18,4,1
SBI21LTS1603643,88,29,19,10,1
SBI41RBB7559300,60,24,15,9,1
SBI78GOD2766305,92,25,16,9,1
SBI28IZE6506154,90,27,15,12,1
SBI49JXP8143509,70,30,17,13,1
SBI70UGV0217428,24,23,14,9,1
SBI58LKP4061272,94,15,10,5,1
SBI26WIU2140790,77,38,34,4,1
SBI75FWX2680606,70,23,12,11,1
SBI46FEP8563648,81,18,11,7,1
SBI45LWJ8479554,76,25,24,1,1
SBI03LMF4185017,94,25,15,10,1
SBI77VUG8661600,71,24,23,1,1
SBI20IDW3871232,19,27,16,11,1
SBI23FMK6168206,61,21,18,3,1
SBI27BJZ7125022,20,27,22,5,1
SBI16UTF4416124,68,22,13,9,1
SBI18MDW2423976,72,22,12,10,1
SBI82RGY9786520,66,13,7,6,1
SBI09LJF2110807,97,26,22,4,1
SBI20FBK6799637,66,29,24,5,1
SBI49KHF6278312,91,18,16,2,1
SBI09ODS2548962,73,23,14,9,1
SBI86ZSP2773212,69,25,24,1,1
SBI49DYT5846130,85,18,11,7,1
SBI31PPM6808884,66,21,12,9,1
SBI37UAB2694884,77,22,13,9,1
SBI96YJX9714643,81,24,13,11,1
SBI55EWG6603897,76,31,29,2,1
SBI68LUW6854183,18,20,19,1,1
SBI42NYJ9266175,75,24,21,3,1
SBI19POD6553640,74,28,26,2,1
SBI60SKK1105228,90,27,22,5,1
SBI32COJ4407876,23,16,14,2,1
SBI94HGQ4156000,74,18,11,7,1
SBI36ZLM8541514,68,23,19,4,1
SBI74TBL1868444,86,28,20,8,1
SBI24TOZ0328387,25,30,21,9,1
SBI86HMF9819798,71,29,17,12,1
SBI40GGY9684680,85,22,20,2,1
SBI01GBB3978929,84,30,29,1,1
SBI08MXI9951537,60,19,11,8,1
SBI26AVG7745466,85,26,21,5,1
SBI53SZW6715119,98,23,22,1,1
SBI77MUH8301881,85,27,26,1,1
SBI66YCL2129085,63,29,20,9,1
SBI43BTO9641307,96,22,16,6,1
SBI69UDT9226493,67,22,17,5,1
SBI41TYT2213092,18,20,13,7,1
SBI82XVW6702130,94,23,19,4,1
SBI56LAY1054176,89,21,15,6,1
SBI68CBD3168849,72,23,12,11,1
SBI70VUX0598099,69,21,13,8,1
SBI64WMZ1538586,99,23,16,7,1
SBI44QNH8651831,78,31,21,10,1
SBI85BQU2407867,95,29,26,3,1
SBI31QEU7983938,94,34,33,1,1
SBI18QFC2943475,98,30,16,14,1
SBI73DZY8676458,18,32,24,8,1
SBI37VTV6632654,71,15,8,7,1
SBI28PKR3972763,79,27,14,13,1
SBI84FSS6466001,23,31,20,11,1
SBI95WWQ9172656,92,23,17,6,1
SBI12WDL0268051,89,23,21,2,1
SBI41BQL0433911,18,24,22,2,1
SBI14JRY5516336,69,24,19,5,1
SBI63ITF1176427,65,21,17,4,1
SBI24MDP0079204,61,22,13,9,1
SBI04JKH0668023,83,17,9,8,1
SBI42CFR9237612,25,22,14,8,1
SBI91XUR0594816,96,20,18,2,1
SBI05BRM8566990,72,27,23,4,1
SBI73PSD6907738,96,14,13,1,1
SBI79MKP5908311,90,25,19,6,1
SBI65TQO6421033,76,32,25,7,1
SBI99TJL4310202,19,24,16,8,1
SBI04OWS3049433,93,23,15,8,1
SBI27AGC9533945,61,19,12,7,1
SBI44MIU8216769,66,31,23,8,1
SBI72BVL0281658,74,34,31,3,1
SBI87TOY5566807,99,25,14,11,1
SBI48HOW3312218,60,30,24,6,1
SBI42TAJ1916607,21,29,22,7,1
SBI36KEU5746193,74,24,14,10,1
SBI68SAO2637130,99,23,16,7,1
SBI24MJG0249636,84,19,18,1,1
SBI84VMW1197512,70,20,16,4,1
SBI86BRE6393640,79,30,28,2,1
SBI44PPG6298201,85,26,20,6,1
SBI80LHU3053521,74,34,18,16,1
SBI92QHK0164951,78,23,22,1,1
SBI44WZF4838435,24,23,16,7,1
SBI09ENV3928972,78,17,14,3,1
SBI93ZML6208563,63,23,22,1,1
SBI10QFY8566806,25,22,17,5,1
SBI54TJP0213955,85,29,15,14,1
SBI90GFK4525701,69,17,9,8,1
SBI02RIH2525347,65,23,19,4,1
SBI69BXR4635138,22,25,24,1,1
SBI94VWG9110583,96,24,18,6,1
SBI05XIM0937797,80,23,21,2,1
SBI96ZRH4703254,24,30,21,9,1
SBI45OIV8875425,73,28,27,1,1
SBI77VYB5659278,18,30,17,13,1
SBI29GGQ9677504,73,40,30,10,1
SBI84LRG6477111,99,15,12,3,1
SBI75PSI1842928,98,15,11,4,1
SBI76GNP3242596,75,37,19,18,1
SBI51PME6173536,97,29,18,11,1
SBI29GEJ9683575,95,23,12,11,1
SBI15PNA4536268,22,29,19,10,1
SBI93FAO5526799,78,20,18,2,1
SBI74ZJI3434110,77,27,24,3,1
SBI15NYS0854540,67,31,24,7,1
SBI83ZMN2325273,63,30,29,1,1
SBI29DKA6309111,21,19,10,9,1
SBI97URP2058015,65,27,18,9,1
SBI01LYU5232504,80,20,12,8,1
SBI62WQQ4930474,60,16,9,7,1
SBI61QGP5694078,67,27,17,10,1
SBI47WJO4919541,97,22,16,6,1
SBI77KAQ8002054,84,15,10,5,1
SBI22JTH3661476,94,22,20,2,1
SBI58KUA4270333,86,26,15,11,1
SBI43EGA4061504,23,28,17,11,1
SBI64MDM4229881,22,23,18,5,1
SBI73QFP6449181,71,35,26,9,1
SBI77IAU3287834,71,22,14,8,1
SBI77KXL6182802,68,28,24,4,1
SBI61KXC5654335,25,26,23,3,1
SBI92BCI9281791,61,23,19,4,1
SBI71SZA9601102,96,24,23,1,1
SBI18KFN9031172,93,30,16,14,1
SBI76IXK5376582,19,29,22,7,1
SBI18AIT7673212,68,22,17,5,1
SBI22ZBB7150369,61,21,11,10,1
SBI28WJG5226869,64,28,20,8,1
SBI11BJI9836464,89,20,18,2,1
SBI85IZX6952125,68,18,15,3,1
SBI23PSD7323524,96,24,23,1,1
SBI58LNY2732506,68,29,28,1,1
SBI28FNJ5057591,70,25,24,1,1
SBI46HAW2322071,66,18,17,1,1
SBI31XIG7210538,87,26,14,12,1
SBI67RFT2456127,74,33,22,11,1
SBI06OFO4917358,64,20,16,4,1
SBI08EYS2301126,82,21,14,7,1
SBI48XEZ5179647,70,13,9,4,1
SBI54XZQ5156370,71,24,23,1,1
SBI69SME1898752,77,27,21,6,1
SBI88EQM1676432,76,31,30,1,1
SBI97BKW7140942,62,32,23,9,1
SBI06JFV5242429,63,17,13,4,1
SBI58OWZ5578005,82,28,15,13,1
SBI87TKT2277921,73,28,27,1,1
SBI50WDH6449300,71,25,22,3,1
SBI54YEB9996658,24,30,20,10,1
SBI24GJY3709418,94,28,16,12,1
SBI62VZV1274421,91,29,17,12,1
SBI65QZR3816751,80,29,25,4,1
SBI85FGF9350636,60,28,20,8,1
SBI78GDK1240193,97,25,13,12,1
SBI30YIC1068541,98,20,18,2,1
SBI98TCP0829959,86,19,16,3,1
SBI02PAX1826242,23,24,16,8,1
SBI21TEX9795349,23,33,31,2,1
SBI90SHE6456051,94,19,13,6,1
SBI70PHO7399091,94,24,17,7,1
SBI43WOO4501710,75,19,11,8,1
SBI75DCF3956375,84,27,19,8,1
SBI40YYR1799963,88,18,10,8,1
SBI36YZB2257823,85,36,23,13,1
SBI24UVP0525539,87,27,26,1,1
SBI12VLC7336010,72,23,13,10,1
SBI63UPZ5154596,84,20,16,4,1
SBI95VSW5326438,97,14,9,5,1
SBI60WAQ0600892,92,20,17,3,1
SBI41QQM5706069,19,21,20,1,1
SBI11JTE9324567,87,26,18,8,1
SBI68CLZ6372109,82,25,14,11,1
SBI52WPC0537245,80,33,20,13,1
SBI59YIN5803837,75,27,23,4,1
SBI50XHO0214655,62,22,21,1,1
SBI38FWK2805769,75,20,13,7,1
SBI82XSN9720722,99,21,13,8,1
SBI40OCY1990394,66,21,19,2,1
SBI72USO7089481,68,23,21,2,1
SBI30EQV8416344,74,26,16,10,1
SBI85IDR9546320,91,29,26,3,1
SBI55OOT6994933,80,15,13,2,1
SBI10IDB2139667,96,24,17,7,1
SBI74BIO5079795,68,34,31,3,1
SBI21UJY7098701,75,23,14,9,1
SBI31TOU7652498,66,22,13,9,1
SBI41UCM0398108,77,31,19,12,1
SBI86TUY7544351,79,23,17,6,1
SBI00ILQ5221643,74,31,27,4,1
SBI43NXA7168901,83,22,19,3,1
SBI21ZBL6599390,79,30,29,1,1
SBI47FBZ9040566,61,19,13,6,1
SBI13DKH7899811,75,28,22,6,1
SBI90IUW0824840,89,19,14,5,1
SBI36UAF7935019,92,28,21,7,1
SBI07IXU3018735,61,13,7,6,1
SBI00SIM7914484,69,35,18,17,1
SBI08WPL5690671,64,25,17,8,1
SBI47CLA4333576,67,29,22,7,1
SBI15FRP5405524,94,11,9,2,1
SBI76DXG3324641,87,21,19,2,1
SBI63KLK3596469,19,26,22,4,1
SBI39FQW1924772,76,27,15,12,1
SBI27KEC4258892,79,25,13,12,1
SBI45BTO9899290,60,23,19,4,1
SBI90VZG7063083,98,30,28,2,1
SBI62OCM3709971,80,21,14,7,1
SBI04QKY6181022,19,18,15,3,1
SBI92QFZ1069094,68,23,18,5,1
SBI61KSV9121849,97,25,15,10,1
SBI95HAV9478269,95,16,12,4,1
SBI36FCN1434941,18,28,22,6,1
SBI88UUO8964338,95,27,18,9,1
SBI91MEJ9631964,63,15,12,3,1
SBI98BWM0319706,68,15,11,4,1
SBI47IKZ5219638,68,30,17,13,1
SBI90YMW4537665,77,24,16,8,1
SBI14WOU8203909,94,25,13,12,1
SBI94MLA4359848,71,27,15,12,1
SBI43BEN8467382,91,23,13,10,1
SBI98JAN4535796,86,18,12,6,1
SBI24KHO3680423,74,20,18,2,1
SBI83NKQ2801969,81,30,19,11,1
SBI34WBK9515416,64,25,21,4,1
SBI38OOQ4496445,71,31,25,6,1
SBI92QVU9576323,73,17,13,4,1
SBI28UFF9322215,96,18,11,7,1
SBI94MLM8990042,80,22,20,2,1
SBI53JSN0262827,20,30,24,6,1
SBI96RBG2411204,74,25,18,7,1
SBI80LIZ0803934,97,30,28,2,1
SBI87RJP4619236,70,24,21,3,1
SBI13UKP5837894,94,23,13,10,1
SBI18CBT7211267,80,22,14,8,1
SBI37WCK4383244,60,25,18,7,1
SBI85RJC0228075,71,33,17,16,1
SBI94FWR5736469,74,24,19,5,1
SBI84WCY5092982,21,25,19,6,1
SBI93BRN8128366,20,36,24,12,1
SBI81ZKO5792744,98,27,21,6,1
SBI79STV7710305,74,17,14,3,1
SBI07ENX3074525,84,25,14,11,1
SBI61CNT1851661,66,24,21,3,1
SBI82SDJ6103399,81,28,23,5,1
SBI09RRA3431536,91,19,12,7,1
SBI67WVK6691935,69,21,19,2,1
SBI46ZKI4823889,65,23,21,2,1
SBI36YIE7346704,68,31,25,6,1
SBI32AKA2629624,67,26,25,1,1
SBI58FDI3361501,21,19,12,7,1
SBI31ZBW1452820,66,19,13,6,1
SBI87HRG0991444,82,32,19,13,1
SBI22MAY0105033,97,34,27,7,1
SBI53NXR3188413,90,29,26,3,1
SBI22SBG8139895,80,26,18,8,1
SBI81PGR4833798,98,17,11,6,1
SBI21TME6403743,76,23,19,4,1
SBI71YAW5444866,62,19,11,8,1
SBI13DGW0269079,70,26,23,3,1
SBI11ENS9385322,79,31,18,13,1
SBI82TZG9968256,68,23,21,2,1
SBI63UHU3774965,69,24,17,7,1
SBI98UZW1082574,92,31,26,5,1
SBI86NYP6242889,22,23,15,8,1
SBI24CDY3107261,72,25,16,9,1
SBI16LDW7890115,64,26,18,8,1
SBI48UCU6642060,77,27,26,1,1
SBI95YJW9503672,82,22,17,5,1
SBI77PRP1159417,19,32,18,14,1
SBI16HBN3670290,65,24,21,3,1
SBI14CZP3293969,64,15,11,4,1
SBI61BBK9560807,69,28,16,12,1
SBI66LXF2122927,68,21,15,6,1
SBI33QQZ1521429,71,25,24,1,1
SBI79OIB5596570,91,18,14,4,1
SBI31JYI3642235,88,19,16,3,1
SBI48CJG0426293,83,19,13,6,1
SBI05VGO1198158,97,27,22,5,1
SBI72XNC0889384,20,26,14,12,1
SBI48IXS7615990,71,24,15,9,1
SBI06CYS5144456,94,21,11,10,1
SBI08RSH4980859,89,23,22,1,1
SBI40MGP1817736,67,28,22,6,1
SBI27SMZ1205532,78,27,26,1,1
SBI29ZOL2743540,65,27,24,3,1
SBI60PWB5608721,19,27,17,10,1
SBI16YGN0681893,24,26,15,11,1
SBI52LCK9819165,74,27,18,9,1
SBI36IJS2008852,76,22,17,5,1
SBI91ITO0022408,63,27,17,10,1
SBI80OOJ3723071,98,31,20,11,1
SBI35VLB0304090,19,21,16,5,1
SBI80ISE5473562,19,21,16,5,1
SBI51LSJ2189620,80,17,9,8,1
SBI90AIU1263842,18,27,15,12,1
SBI95UMY0482826,23,18,12,6,1
SBI14XMI6477862,98,16,10,6,1
SBI05CIR0982265,93,24,19,5,1
SBI01GIE3738615,91,23,19,4,1
SBI11UKR5598064,63,21,19,2,1
SBI85QRR7173401,76,34,20,14,1
SBI99VBC0010125,20,27,14,13,1
SBI49LDL0330236,94,20,11,9,1
SBI76JCJ8003041,83,15,14,1,1
SBI98ZXW4505223,96,23,12,11,1
SBI51SMW1754927,90,32,29,3,1
SBI84YGV1268876,89,27,20,7,1
SBI95WET9592429,84,26,20,6,1
SBI08EXB9366835,96,27,15,12,1
SBI83NTH4386556,91,30,23,7,1
SBI60HNK5099250,21,24,22,2,1
SBI87FFJ9634663,80,33,19,14,1
SBI78YTK8040169,82,22,13,9,1
SBI70KAF3706665,94,25,22,3,1
SBI45XWL6887235,96,30,29,1,1
SBI08AML7905217,90,22,12,10,1
SBI91CRT8551094,99,18,12,6,1
SBI50UDD4985241,73,28,22,6,1
SBI54EXR7737873,69,31,29,2,1
SBI46XZG1257241,88,27,26,1,1
SBI30GQD7695561,62,22,21,1,1
SBI40RCY4167766,93,25,15,10,1
SBI57VWK8873074,76,28,15,13,1
SBI27XWJ2983957,87,23,16,7,1
SBI95MGP1018093,99,25,17,8,1
SBI50SVK2273413,90,18,16,2,1
SBI79BTC7214878,63,25,20,5,1
SBI09SBG0324477,61,23,13,10,1
SBI38WSW5016788,86,36,29,7,1
SBI21OTM1957186,82,31,24,7,1
SBI48TOL2556441,99,21,11,10,1
SBI86CJJ7054642,72,12,8,4,1
SBI10OYR8541395,75,28,23,5,1
SBI01EQT7412245,86,23,12,11,1
SBI14AZS7057434,24,29,22,7,1
SBI49ALX6467282,96,23,17,6,1
SBI11FYB9579083,69,25,17,8,1
SBI45GGQ4774013,89,28,19,9,1
SBI82IKW6199327,95,30,19,11,1
SBI12BIL2285694,92,28,17,11,1
SBI55WPJ6328853,66,21,19,2,1
SBI60SPX6623582,60,22,12,10,1
SBI57BRR1935515,76,24,22,2,1
SBI47DZX3567613,86,19,16,3,1
SBI19CYJ4585838,63,24,13,11,1
SBI88LBW6490638,73,27,20,7,1
SBI55KFQ8272987,83,23,22,1,1
SBI86RFT4919248,69,28,17,11,1
SBI61XRN1462143,21,35,23,12,1
SBI86CEU4246905,20,26,24,2,1
SBI40VXT6925563,67,32,20,12,1
SBI68PCB7952221,69,17,10,7,1
SBI98DYD5767545,78,22,21,1,1
SBI33DCD5993629,82,22,16,6,1
SBI49AQR1575056,97,38,26,12,1
SBI18GNP2805043,60,25,21,4,1
SBI55JIM2455537,69,17,9,8,1
SBI28WFS8559763,97,23,18,5,1
SBI52UWD1199385,98,26,17,9,1
SBI19IGE4891400,64,29,16,13,1
SBI39SWH5294217,60,24,21,3,1
SBI14FXX4658330,85,32,24,8,1
SBI07DUJ5506136,22,23,12,11,1
SBI88BXU9014549,76,19,11,8,1
SBI85ZLR4888580,23,20,15,5,1
SBI51NEU5067212,65,22,12,10,1
SBI40SCA8275189,22,19,12,7,1
SBI49RNH9046347,99,36,31,5,1
SBI38SGN5107757,25,22,21,1,1
SBI80KLZ6798228,78,27,25,2,1
SBI10VYF5097901,19,25,14,11,1
SBI40EDY3782277,72,24,19,5,1
SBI18JEE0547965,76,31,27,4,1
SBI55WNK8176943,92,32,27,5,1
SBI80WWF7298531,99,29,24,5,1
SBI06SBY4223872,70,19,16,3,1
SBI45TWV8613502,85,17,16,1,1
SBI70LVS9073715,93,25,13,12,1
SBI00ERH2895967,81,24,19,5,1
SBI47VTL0837685,23,28,18,10,1
SBI64AFT8354441,73,23,15,8,1
SBI44BHW2620736,92,26,23,3,1
SBI07KES2223807,71,21,16,5,1
SBI66JWB9697279,19,30,19,11,1
SBI70RNI0474506,89,23,16,7,1
SBI69ZHC4659484,71,24,14,10,1
SBI62JFR4958377,68,26,15,11,1
SBI32GMD3792825,20,23,20,3,1
SBI60CLT4625139,99,24,20,4,1
SBI29PYL5874548,71,22,14,8,1
SBI79RHH2670415,67,23,15,8,1
SBI74HXK4189169,65,22,20,2,1
SBI07KKZ7082421,89,27,26,1,1
SBI83GNY4570454,88,26,19,7,1
SBI02XKX5220744,63,29,20,9,1
SBI16EHM7655014,73,24,23,1,1
SBI53WXW4430631,78,11,8,3,1
SBI61ZUF7320856,83,21,11,10,1
SBI65SKI3302014,82,24,22,2,1
SBI48LKH7375829,82,27,22,5,1
SBI10NJC6795081,18,25,16,9,1
SBI47XPQ5917090,71,35,18,17,1
SBI98JZB2988847,67,19,11,8,1
SBI59CUA3149798,89,26,23,3,1
SBI75LMA0943641,70,26,21,5,1
SBI34CHJ9104515,64,26,15,11,1
SBI12GME4718381,76,25,22,3,1
SBI71GUX4314402,81,27,26,1,1
SBI04PQL9742856,61,20,15,5,1
SBI74PJC6161832,78,21,12,9,1
SBI66PZQ3689013,78,31,19,12,1
SBI46TGQ4048929,85,26,23,3,1
SBI08ANJ5360614,84,28,24,4,1
SBI05YCD8518052,79,22,16,6,1
SBI03UKH9105208,68,38,28,10,1
SBI20ZGP9768290,93,26,22,4,1
SBI53QJO4713987,65,28,26,2,1
SBI39DVC2236509,81,25,15,10,1
SBI34PZN4295853,20,35,22,13,1
SBI30UJV3663279,64,28,16,12,1
SBI21TWH8453937,80,18,12,6,1
SBI49ERD2524217,76,18,15,3,1
SBI87OAT3552276,64,25,20,5,1
SBI83YSD1316993,89,25,24,1,1
SBI82PIH2358120,19,16,13,3,1
SBI37XJF5055461,87,35,29,6,1
SBI36TZS7738470,92,31,28,3,1
SBI78DIS1110331,64,22,20,2,1
SBI81ODO3813865,90,33,18,15,1
SBI65JPH7696636,65,24,19,5,1
SBI61CIE7082097,88,22,13,9,1
SBI10DRD0476006,78,24,23,1,1
SBI44YFK5638913,99,29,22,7,1
SBI02IRK3571567,82,21,19,2,1
SBI85CUT7294541,19,25,23,2,1
SBI92RLD7247408,84,28,21,7,1
SBI35IGG6115032,84,20,17,3,1
SBI67DMU6750070,62,35,32,3,1
SBI64VSP3380706,71,18,10,8,1
SBI02YDC5452763,67,18,13,5,1
SBI66IHK2073222,81,25,16,9,1
SBI01BLX7084112,73,32,29,3,1
SBI50KZN2230333,60,33,30,3,1
SBI89EVD4606521,90,34,18,16,1
SBI53DIS3172707,23,25,20,5,1
SBI75STW7557597,25,29,25,4,1
SBI53NPM5371448,76,28,18,10,1
SBI92XSX9088729,85,26,22,4,1
SBI35QNK6962717,79,23,17,6,1
SBI37LJU4572437,69,25,14,11,1
SBI58FUC5382826,25,27,23,4,1
SBI26LAB5962282,82,26,23,3,1
SBI77CSS4853053,18,21,18,3,1
SBI29JWP4474236,77,19,10,9,1
SBI27RJR3251336,71,22,13,9,1
SBI15MTY4162568,98,20,16,4,1
SBI26DOH6837966,93,28,24,4,1
SBI64UQL7629839,21,21,16,5,1
SBI85HMT7790719,72,32,19,13,1
SBI73FHH5738904,24,31,17,14,1
SBI03AOE8407100,91,24,13,11,1
SBI68UFO2509713,97,30,29,1,1
SBI40MYX0071426,87,29,26,3,1
SBI28MOP5092108,69,28,27,1,1
SBI37BLS3376754,97,23,12,11,1
SBI66IHA4241401,61,23,19,4,1
SBI20PSJ3801490,19,25,21,4,1
SBI80NRB0413098,80,26,14,12,1
SBI62YGC5973913,80,31,24,7,1
SBI14PBK7145775,76,23,16,7,1
SBI29DDE7992329,94,20,11,9,1
SBI55ITG1510163,61,29,15,14,1
SBI44DSV0690553,96,19,17,2,1
SBI76GCH5723813,96,21,12,9,1
SBI92DLN0452030,68,27,26,1,1
SBI22JVQ1921277,63,17,15,2,1
SBI50ZDE4787649,75,34,19,15,1
SBI94API3702384,78,24,19,5,1
SBI88ZTO2812775,62,19,10,9,1
SBI63BKB5389244,19,26,24,2,1
SBI85UTC7772570,96,22,18,4,1
SBI98CXJ5379702,87,25,23,2,1
SBI98UZT5898095,92,22,18,4,1
SBI74RKM3588420,70,26,15,11,1
SBI04HMK3455863,20,23,21,2,1
SBI44UWZ7310300,62,17,14,3,1
SBI14IQF2106744,78,26,17,9,1
SBI77DZG6827207,88,20,16,4,1
SBI66MAS1426121,65,30,26,4,1
SBI97DSD6096946,89,17,10,7,1
SBI20CZD7910081,92,24,23,1,1
SBI22XIB4773788,92,18,16,2,1
SBI59LMY7601041,83,26,17,9,1
SBI08KQF6980528,82,31,27,4,1
SBI98LHC4344681,25,25,13,12,1
SBI20MXX4333973,95,23,14,9,1
SBI63ILW8959881,90,21,12,9,1
SBI99OQR4777428,22,25,16,9,1
SBI43OQM3536525,18,28,25,3,1
SBI02UOT8823961,85,26,16,10,1
SBI63ZDU7928875,22,20,13,7,1
SBI04GLN8679029,99,33,18,15,1
SBI15BGD5394344,84,18,17,1,1
SBI43ETV6475857,96,21,15,6,1
SBI76BDU5914632,20,20,12,8,1
SBI90HDG2312842,87,26,19,7,1
SBI81RCI4427321,66,31,18,13,1
SBI32EDS7454117,95,29,28,1,1
SBI05MEQ2515384,80,23,17,6,1
SBI69NML8688487,72,19,12,7,1
SBI95VTL0789250,65,23,15,8,1
SBI26GNQ8903789,73,24,18,6,1
SBI64GXU3966969,68,28,25,3,1
SBI50YKA9004026,85,26,19,7,1
SBI19MAD4949418,97,24,23,1,1
SBI94NND6399673,88,24,18,6,1
SBI61GVY6366705,81,32,20,12,1
SBI81XLR6971425,64,31,19,12,1
SBI95HAU1575488,24,24,23,1,1
SBI72RHV6829440,84,30,20,10,1
SBI71FHS0721139,82,28,18,10,1
SBI19VKO2636462,92,35,21,14,1
SBI12OFR7113750,87,22,13,9,1
SBI80PJU8001955,19,25,23,2,1
SBI23OEM2124782,88,21,13,8,1
SBI88BNP1485147,91,26,18,8,1
SBI65ELR7403200,72,29,23,6,1
SBI67MCU2470841,18,33,19,14,1
SBI55KSF1483437,85,31,21,10,1
SBI88HED5702908,73,35,30,5,1
SBI92EFL8051676,81,28,19,9,1
SBI57FKI6922898,70,27,22,5,1
SBI96VXC2006438,82,18,12,6,1
SBI67OFG2698168,62,17,15,2,1
SBI59DEV4127768,78,22,15,7,1
SBI49XRD1990981,65,34,18,16,1
SBI10EIW7989486,23,23,19,4,1
SBI52YGZ2029331,24,23,20,3,1
SBI95HRZ3055991,96,24,15,9,1
SBI05AYY2832334,71,28,17,11,1
SBI84IZO7972506,22,27,23,4,1
SBI90BQE9442410,60,15,13,2,1
SBI57QLJ0885569,76,26,24,2,1
SBI56VGO7293061,85,21,12,9,1
SBI40JGX1239388,68,19,18,1,1
SBI83KIN3187449,84,35,33,2,1
SBI45GSC3877025,19,14,11,3,1
SBI76VPK4692898,20,26,25,1,1
SBI85TBB1259032,78,34,29,5,1
SBI63COH5819568,96,25,16,9,1
SBI73TJG3904007,72,33,30,3,1
SBI32SDA6522920,99,19,15,4,1
SBI64LBM9426169,18,26,23,3,1
SBI91GEX9118427,65,21,13,8,1
SBI95NDA3101941,20,30,25,5,1
SBI64YZE0472658,66,31,17,14,1
SBI05IIV3089105,70,28,18,10,1
SBI62UQT6502349,74,23,13,10,1
SBI57KAJ8138977,63,23,22,1,1
SBI93CII1248763,88,24,14,10,1
SBI66SXB7905541,67,27,22,5,1
SBI66BUX2979138,78,24,14,10,1
SBI66UIK6650872,80,27,17,10,1
SBI80TFI0904852,80,18,17,1,1
SBI36PXD9343988,23,29,18,11,1
SBI65DHL2784033,23,18,10,8,1
SBI21IXB3231892,89,18,10,8,1
SBI79PHH6666113,60,34,25,9,1
SBI70LTJ5540391,86,21,14,7,1
SBI47VUO8430848,19,27,16,11,1
SBI06QIA6578586,92,30,25,5,1
SBI11EBD4080190,77,22,15,7,1
SBI27WQF4966882,25,23,16,7,1
SBI44NST8777463,85,25,14,11,1
SBI05ZZC6957014,69,23,22,1,1
SBI93LMS3180798,87,30,22,8,1
SBI69QWG1843442,74,25,22,3,1
SBI87DXQ3155331,24,25,21,4,1
SBI60ALR7397360,60,26,15,11,1
SBI65IFN7596918,65,26,23,3,1
SBI73ILC4961076,93,18,16,2,1
SBI64XGU0091889,74,11,9,2,1
SBI41MRX8227310,72,24,21,3,1
SBI29GOM2663626,98,26,15,11,1
SBI90QPY0855042,89,20,17,3,1
SBI24JUF4793180,69,22,12,10,1
SBI05VUT6587845,97,31,16,15,1
SBI29GPC5302863,81,28,15,13,1
SBI76QZU4007693,86,25,18,7,1
SBI24EEB0294068,84,26,22,4,1
SBI50VWQ8238564,60,25,21,4,1
SBI94BFN3272168,86,32,21,11,1
SBI53VDV8732743,87,25,24,1,1
SBI58RPN8017434,81,26,18,8,1
SBI33JNH2912030,79,18,11,7,1
SBI63UWF2927999,99,26,15,11,1
SBI74QRS5370514,91,23,21,2,1
SBI95BFQ3074991,72,31,20,11,1
SBI80ICE3669321,74,20,14,6,1
SBI33RVT1020208,82,17,13,4,1
SBI67RJC3266041,66,19,18,1,1
SBI39RMB5933471,99,28,26,2,1
SBI19RXI6146614,25,23,17,6,1
SBI29BNW3771283,71,22,17,5,1
SBI23CSB6904605,23,37,19,18,1
SBI49TTR0527269,20,28,17,11,1
SBI93NVT7202430,82,26,23,3,1
SBI71ZWS9385989,73,26,14,12,1
SBI28QKX6118030,69,23,18,5,1
SBI97BOO8849915,18,24,17,7,1
SBI65FNK2130160,96,27,16,11,1
SBI03UEF4912207,91,29,20,9,1
SBI12OKB8851609,89,27,16,11,1
SBI95XDT4614209,66,26,19,7,1
SBI96IHG8947700,65,33,28,5,1
SBI02MFB4415414,77,25,22,3,1
SBI95SNR7059217,24,28,24,4,1
SBI43SAD1728344,60,25,22,3,1
SBI92TQU9215975,63,25,22,3,1
SBI65FUF5704870,86,22,18,4,1
SBI49WLF8177813,99,20,19,1,1
SBI36AST5775670,20,20,14,6,1
SBI45ZWE2992348,73,23,13,10,1
SBI30FZU8744536,87,27,23,4,1
SBI79FXQ1707235,60,20,15,5,1
SBI29LKT3772343,60,32,29,3,1
SBI11KKR9026624,98,18,12,6,1
SBI69NKJ2783412,18,28,21,7,1
SBI22JBT2729499,77,29,18,11,1
SBI43TGQ0989968,90,20,14,6,1
SBI03XPE4674756,95,23,19,4,1
SBI49VLR9064474,74,24,22,2,1
SBI71KXV5900238,71,23,16,7,1
SBI91NYH9496011,83,19,11,8,1
SBI24ZNH7101435,87,29,16,13,1
SBI87TBM9853846,84,23,18,5,1
SBI57VAX0066075,21,33,17,16,1
SBI17DXG2422525,67,32,27,5,1
SBI80FJS3424184,92,32,21,11,1
SBI05SWC1695325,63,25,16,9,1
SBI59JTC6173781,60,18,14,4,1
SBI48XJL4805109,19,32,25,7,1
SBI95VGD5941357,96,12,7,5,1
SBI42NUW1659164,97,24,20,4,1
SBI80OJB7685790,63,20,13,7,1
SBI51OQN8479842,81,30,28,2,1
SBI25FIW2792572,81,23,14,9,1
SBI74WIV5371141,83,23,19,4,1
SBI18DRJ1597952,19,23,14,9,1
SBI55MLM4825085,18,22,18,4,1
SBI91GIH5100243,19,21,20,1,1
SBI49WRV0613868,92,20,17,3,1
SBI66BBA5355837,87,32,19,13,1
SBI20EQN5889104,86,30,22,8,1
SBI72TKP5099092,88,12,10,2,1
SBI76PUR2358895,63,22,18,4,1
SBI56MJO0355473,84,28,19,9,1
SBI91JFJ0737812,19,22,20,2,1
SBI19XUN1982515,22,29,16,13,1
SBI07IAA9061604,81,32,21,11,1
SBI15KHY3559247,95,27,20,7,1
SBI35OFS2110822,64,24,17,7,1
SBI53QKF8609774,70,25,19,6,1
SBI57VLQ2968995,95,27,14,13,1
SBI31FQO9589446,63,21,15,6,1
SBI89TNM7670113,21,22,15,7,1
SBI04PLJ2754657,18,21,19,2,1
SBI67DDJ5545564,73,23,20,3,1
SBI65LBS0329377,86,30,21,9,1
SBI31AYQ4976814,82,24,17,7,1
SBI54RHN3593149,84,30,24,6,1
SBI08VOW2857742,93,29,22,7,1
SBI12NCK7036236,66,13,12,1,1
SBI06GCM4994323,73,27,14,13,1
SBI61KFE9747290,64,28,22,6,1
SBI88ZOU0873901,67,22,14,8,1
SBI77BCF4605725,23,27,15,12,1
SBI41ABH5953973,80,26,21,5,1
SBI20RPN9607789,60,30,28,2,1
SBI20EVO2314754,84,19,18,1,1
SBI68JSL1856052,23,31,28,3,1
SBI15LCM2859642,91,25,24,1,1
SBI03QUR4464650,22,21,13,8,1
SBI63HYA6442361,20,24,22,2,1
SBI15WNU3953679,77,12,11,1,1
SBI58CLV5868481,96,22,16,6,1
SBI64UPG1540579,73,17,16,1,1
SBI70LUP9700574,94,15,9,6,1
SBI85RWX3356898,79,30,28,2,1
SBI62MON0328359,83,19,17,2,1
SBI55AOP8162519,79,16,10,6,1
SBI09IJB4962893,86,20,15,5,1
SBI22RJT2150605,91,22,19,3,1
SBI11UQT6411698,73,21,20,1,1
SBI51TIT2824269,24,29,24,5,1
SBI18WEY7846017,75,24,14,10,1
SBI00SKJ5570341,68,19,16,3,1
SBI21HEA3998971,67,24,14,10,1
SBI05UUE3338837,22,26,21,5,1
SBI93KSA6692314,98,20,13,7,1
SBI36QOD0106122,60,22,15,7,1
SBI92GTJ7878385,72,16,13,3,1
SBI65TIS1063600,89,25,16,9,1
SBI60CWM8877176,83,15,9,6,1
SBI01YJE3555266,76,26,25,1,1
SBI43RQM6953517,87,30,21,9,1
SBI36ICQ9927838,94,34,32,2,1
SBI79KNJ9248048,89,26,14,12,1
SBI57RLI4990212,77,26,25,1,1
SBI89GVH7724454,76,27,25,2,1
SBI07TUE4859829,78,21,18,3,1
SBI87YBR9262883,22,21,19,2,1
SBI01PMM4005764,93,19,10,9,1
SBI03TDB1157400,89,30,19,11,1
SBI99RBE1095522,65,29,17,12,1
SBI35CUG8579095,80,24,13,11,1
SBI40YZY3104373,84,24,14,10,1
SBI37CHO3557443,65,30,20,10,1
SBI12OLZ1001696,21,21,15,6,1
SBI72BMN3162907,25,21,12,9,1
SBI09WHL8685191,78,22,19,3,1
SBI97VRQ6073092,89,20,14,6,1
SBI62IYC5226854,71,22,13,9,1
SBI28QBE1284173,86,30,28,2,1
SBI39LAT3772815,67,23,21,2,1
SBI50SJG9182347,68,33,27,6,1
SBI74WPB7638475,91,23,15,8,1
SBI97EIT6245649,75,31,27,4,1
SBI17IVF7955872,72,23,18,5,1
SBI93ZLY0589563,20,30,28,2,1
SBI08KYJ8073200,96,22,19,3,1
SBI88QJL2253515,18,24,23,1,1
SBI16RIZ4367449,83,24,16,8,1
SBI50FNL7789031,62,29,20,9,1
SBI39JGG4325226,89,25,17,8,1
SBI43RJH4202264,84,23,12,11,1
SBI44TPU1257795,89,23,13,10,1
SBI11ZFC8175953,72,30,18,12,1
SBI36XDY9030163,24,19,15,4,1
SBI31MJQ1971911,92,27,18,9,1
SBI38JQB1653832,68,25,13,12,1
SBI13PDJ4040931,80,29,22,7,1
SBI95LDE0671287,88,23,14,9,1
SBI92DTU3270011,69,28,22,6,1
SBI26QVG2531988,22,24,14,10,1
SBI57QRA3677941,74,21,17,4,1
SBI60VMV4003201,78,22,18,4,1
SBI90NTB1956690,19,20,16,4,1
SBI20ACE8486924,76,22,21,1,1
SBI65YQS6374855,68,27,20,7,1
SBI96CVS5141549,21,23,14,9,1
SBI49INP1896074,99,17,14,3,1
SBI90FHX5572108,98,29,22,7,1
SBI86GKG2560203,73,25,18,7,1
SBI68WWT4300698,25,21,15,6,1
SBI19UHK5636225,70,30,27,3,1
SBI80UKC3355940,68,31,25,6,1
SBI89HDV5753868,85,26,17,9,1
SBI75HRP9955915,78,22,16,6,1
SBI72XTY0162426,83,18,13,5,1
SBI73JYF6102757,91,31,23,8,1
SBI53AES9798534,81,28,24,4,1
SBI84HJS9546084,18,24,17,7,1
SBI74ICY3958857,70,25,21,4,1
SBI67WXL9832793,99,29,15,14,1
SBI92FXX2025670,79,20,18,2,1
SBI19MRB1606824,63,25,18,7,1
SBI67VCA4571311,72,24,15,9,1
SBI34OXU3732048,62,24,21,3,1
SBI16KYJ6326924,95,12,8,4,1
SBI54GGT8021813,19,21,15,6,1
SBI06SGC6944737,66,12,10,2,1
SBI97VJV8630827,22,27,26,1,1
SBI25YOB3362497,68,25,14,11,1
SBI00MLS8980877,79,20,13,7,1
SBI64YOJ1312733,62,29,16,13,1
SBI04PSZ8486469,65,32,31,1,1
SBI12CPS2046558,90,28,17,11,1
SBI00NHM2653032,19,16,15,1,1
SBI85AKJ3861079,94,20,19,1,1
SBI43ZQV1722222,61,31,29,2,1
SBI43FQI1924196,77,23,13,10,1
SBI88YCO0709659,62,32,24,8,1
SBI88SYH7946590,19,27,16,11,1
SBI51PEO7199375,83,23,16,7,1
SBI32IHY9050449,79,17,16,1,1
SBI84IAZ8197102,97,31,22,9,1
SBI39FOO8440393,80,21,20,1,1
SBI06IEL4268153,63,25,15,10,1
SBI22FFR6792507,69,18,10,8,1
SBI92ZTD5756648,71,26,23,3,1
SBI39AMU7151195,84,27,21,6,1
SBI44KRD7980034,70,29,24,5,1
SBI78DAG6543969,77,16,15,1,1
SBI59OEX6676676,86,28,27,1,1
SBI35MMP7634837,25,28,27,1,1
SBI57ZWF8857844,76,19,11,8,1
SBI62PWU3306985,64,17,13,4,1
SBI72HTM5203400,19,21,12,9,1
SBI37TKY2319045,95,20,12,8,1
SBI09XWF7193345,82,19,13,6,1
SBI65TKR3610833,90,23,12,11,1
SBI66YYY2611456,20,28,19,9,1
SBI43MJS5926333,60,26,22,4,1
SBI54FNB3332393,23,27,20,7,1
SBI13NLB5666716,96,14,12,2,1
SBI60XVI7379006,94,26,15,11,1
SBI87KSC0352459,62,29,15,14,1
SBI89WDH9237448,81,24,23,1,1
SBI44ALD5130293,76,28,15,13,1
SBI86TQK3797129,25,29,18,11,1
SBI59DPR8924772,68,28,17,11,1
SBI37KOG2437967,72,22,15,7,1
SBI41NHI7668330,20,30,17,13,1
SBI57ZGJ6483312,22,23,16,7,1
SBI28NFT2005168,62,27,17,10,1
SBI32DXG3624061,77,23,14,9,1
SBI52LDE1789015,24,30,21,9,1
SBI80IMU0365673,23,31,21,10,1
SBI47BIG6027731,83,31,26,5,1
SBI99ZSI0829735,66,27,17,10,1
SBI90IVK2615986,84,27,26,1,1
SBI03ATB9880202,75,20,19,1,1
SBI22UVB8573205,96,23,19,4,1
SBI63NOH0962652,93,23,12,11,1
SBI22PFT1879583,19,29,23,6,1
SBI45MEG3825201,95,19,13,6,1
SBI34JYB6722050,76,26,15,11,1
SBI73ZXM4656332,82,20,12,8,1
SBI73EGX1738598,60,30,20,10,1
SBI73LNY5996074,82,21,19,2,1
SBI72CMK3278783,67,20,17,3,1
SBI65NZL6738941,18,25,24,1,1
SBI98KKT8172734,99,20,17,3,1
SBI76NMO1929096,88,16,9,7,1
SBI28CZE6138059,77,24,14,10,1
SBI56JQX8951711,19,23,21,2,1
SBI39UFK1815362,74,19,17,2,1
SBI83PIW6079933,91,29,20,9,1
SBI66MZB8426478,76,21,18,3,1
SBI44VFK3420906,73,29,27,2,1
SBI13IBU3981120,69,23,17,6,1
SBI52DNZ9503573,22,31,18,13,1
SBI83SQF2042007,70,22,16,6,1
SBI72JRF3164548,79,20,13,7,1
SBI20AUH8071075,72,25,15,10,1
SBI22UYX2742386,91,30,18,12,1
SBI48XEH5512838,65,20,14,6,1
SBI32YTM5207469,62,25,21,4,1
SBI74RIB9729850,81,20,12,8,1
SBI41ZWN5297025,19,18,12,6,1
SBI56JRF8861802,81,29,15,14,1
SBI90GJG8369947,60,18,16,2,1
SBI15NFM3751743,74,20,12,8,1
SBI90JFK3039593,73,19,16,3,1
SBI81DBH5106816,81,29,25,4,1
SBI62QVX3868389,77,24,18,6,1
SBI61DHE9412317,78,16,13,3,1
SBI89DML6457231,61,26,15,11,1
SBI58XLL1647429,60,29,27,2,1
SBI55NZM2851298,81,24,21,3,1
SBI89RUF2896960,86,35,22,13,1
SBI32HXS3747149,91,25,17,8,1
SBI41HPJ9370591,18,24,19,5,1
SBI31GQJ8993120,65,23,15,8,1
SBI88EFV0518766,96,30,22,8,1
SBI50TXG8739285,88,24,15,9,1
SBI42EST1456124,61,25,22,3,1
SBI47VVF2050702,21,19,11,8,1
SBI99OCJ9800001,62,18,10,8,1
SBI06QXU9201772,68,33,22,11,1
SBI32IFI9622500,65,26,14,12,1
SBI67PZE5324601,76,23,13,10,1
SBI28CPM3827954,72,21,13,8,1
SBI47GCQ2018323,91,24,21,3,1
SBI61SZQ7822272,25,29,17,12,1
SBI89SVN6911234,22,33,18,15,1
SBI74SPK1012268,93,24,16,8,1
SBI14AHI7850332,84,23,20,3,1
SBI67LES6064211,63,34,24,10,1
SBI65BQP2469159,85,16,12,4,1
SBI38XER2426609,74,23,22,1,1
SBI18GGH2726055,62,24,14,10,1
SBI34WVW9836231,79,17,16,1,1
SBI42SES1323331,90,30,16,14,1
SBI12SCI9062072,18,35,24,11,1
SBI09BBO5261907,21,23,14,9,1
SBI82AEL4206097,72,31,26,5,1
SBI78OKO3169582,65,24,13,11,1
SBI00BNF1321585,22,20,19,1,1
SBI11PWW0562963,75,21,16,5,1
SBI80MKR6039535,95,21,17,4,1
SBI35VBA5027744,78,25,20,5,1
SBI21OAE3339715,62,13,11,2,1
SBI75WNQ8974533,71,21,15,6,1
SBI82XON5214203,62,32,19,13,1
SBI84RKU1263139,86,15,8,7,1
SBI39SPW9061816,97,31,26,5,1
SBI48CCU4443371,66,23,16,7,1
SBI02NLW3346572,23,26,18,8,1
SBI61QVL8824227,83,22,12,10,1
SBI01MDL5628953,84,32,18,14,1
SBI58KVF6324409,94,22,16,6,1
SBI54NWY0851396,79,27,14,13,1
SBI31HZK1262791,94,29,25,4,1
SBI31SWO8347800,75,20,16,4,1
SBI37PTQ9850922,72,16,13,3,1
SBI57RRD9128276,97,29,23,6,1
SBI03EPX5024344,23,18,16,2,1
SBI15PPA9282900,69,27,14,13,1
SBI28RQK2298404,69,24,21,3,1
SBI91UAE2597075,96,27,21,6,1
SBI16KSF4207040,22,20,18,2,1
SBI85WBS1780380,25,26,21,5,1
SBI62EMA4578051,69,30,17,13,1
SBI02JPX5541953,62,25,17,8,1
SBI83KWJ1564394,90,26,21,5,1
SBI65VGR4865710,80,22,17,5,1
SBI17YIG3498596,67,34,24,10,1
SBI92DCG9598433,68,20,16,4,1
SBI89LJZ3666676,84,25,18,7,1
SBI83UUI9165543,62,32,30,2,1
SBI64IFN5698714,88,18,14,4,1
SBI67KFY0925219,66,22,12,10,1
SBI58KCA8504156,18,27,26,1,1
SBI09JYP4721968,82,26,23,3,1
SBI43SXW6460475,67,24,17,7,1
SBI74TVY0500881,66,20,19,1,1
SBI11XFF0813481,61,30,17,13,1
SBI94AVB3588298,21,20,15,5,1
SBI35ITW0368892,99,26,22,4,1
SBI16LHA5254965,25,21,20,1,1
SBI15JIF9190699,86,23,20,3,1
SBI53CZI8221198,97,21,11,10,1
SBI54XDO9616401,79,24,18,6,1
SBI81ZZB2570446,88,21,17,4,1
SBI34EBU2605600,93,25,23,2,1
SBI58CBG3630018,75,18,13,5,1
SBI43DZS9075606,75,31,19,12,1
SBI88IFJ6785088,65,34,22,12,1
SBI48QYT0208175,60,18,15,3,1
SBI29ATJ4968855,78,18,15,3,1
SBI47RFC1038354,23,17,14,3,1
SBI75RLT5105194,81,28,21,7,1
SBI26QHU1888938,71,20,13,7,1
SBI88FQA9119819,60,31,27,4,1
SBI72RHG7527014,72,35,20,15,1
SBI01UFZ7351075,75,27,16,11,1
SBI31VQJ1254359,82,19,13,6,1
SBI15BWU5129141,78,24,20,4,1
SBI24ETT4592224,18,20,15,5,1
SBI46TCH8416406,99,25,14,11,1
SBI55BBU2009306,86,21,12,9,1
SBI19JPD4984536,83,23,12,11,1
SBI30LWV8896373,92,21,20,1,1
SBI12NSK8770714,63,21,19,2,1
SBI67RFJ0596124,88,30,22,8,1
SBI08XII5489717,69,24,15,9,1
SBI21QVH1453226,90,31,18,13,1
SBI60JGQ6941586,83,29,26,3,1
SBI74OBU3261114,73,24,17,7,1
SBI46PEN5868160,76,26,23,3,1
SBI51WAD6438586,97,27,18,9,1
SBI55YKU4628852,72,24,15,9,1
SBI40DTG9177941,20,29,28,1,1
SBI41XUE3272955,25,21,12,9,1
SBI20XZO9955094,99,24,17,7,1
SBI93EUQ2662638,25,22,12,10,1
SBI19CAO6584722,77,23,17,6,1
SBI97UZE0278018,93,24,17,7,1
SBI95DHA8899569,76,25,13,12,1
SBI22ZRS6588318,91,30,18,12,1
SBI69ZJT7520087,65,28,16,12,1
SBI21PWK9873395,98,26,25,1,1
SBI27QLX5361222,69,25,15,10,1
SBI06YIB7749012,81,31,24,7,1
SBI99DRT5483396,86,25,18,7,1
SBI32NYI9343428,61,23,17,6,1
SBI08PBK8380086,60,19,17,2,1
SBI30TZS5078467,98,24,20,4,1
SBI42JYR3975721,85,27,20,7,1
SBI37MHO0724435,71,25,14,11,1
SBI80WOR2492480,73,20,11,9,1
SBI24EQI8883832,73,35,23,12,1
SBI01FCP3533695,70,25,17,8,1
SBI48JXN3351799,89,15,9,6,1
SBI11VZP6141595,78,27,19,8,1
SBI53DDD5332981,63,29,18,11,1
SBI20WHC6601200,97,23,20,3,1
SBI67APH2136733,99,31,20,11,1
SBI10MXG8755781,79,17,14,3,1
SBI11ROD3162680,91,31,17,14,1
SBI89EFJ9164789,25,18,17,1,1
SBI71EIA6053328,74,26,25,1,1
SBI23TJF4985599,79,26,18,8,1
SBI51YYV3471626,74,19,13,6,1
SBI50LZM9786723,22,22,12,10,1
SBI74OZU5338044,82,25,16,9,1
SBI95GMP4873930,75,22,12,10,1
SBI57YKN8068770,83,23,14,9,1
SBI00GDU5023065,98,25,17,8,1
SBI68QUZ1391464,23,30,23,7,1
SBI02TBO8738488,94,17,14,3,1
SBI36GEW4059138,94,18,10,8,1
SBI46SGE1393709,76,27,21,6,1
SBI54NIQ4119351,82,12,9,3,1
SBI77BZN6090364,69,21,16,5,1
SBI40LVH5619129,81,19,13,6,1
SBI49IVD0793244,79,19,18,1,1
SBI09JHP2986343,85,19,17,2,1
SBI39STM3356697,67,21,16,5,1
SBI67LRB9212141,87,30,26,4,1
SBI28TJJ7088242,61,20,17,3,1
SBI50OSL6043049,82,18,13,5,1
SBI12IUE1205042,83,14,10,4,1
SBI25KKP8474009,73,19,11,8,1
SBI51VAQ0149087,65,20,18,2,1
SBI56BGN1599828,23,27,26,1,1
SBI50VKB8361620,88,23,17,6,1
SBI71INS9051061,78,26,22,4,1
SBI23KTX4707327,74,19,10,9,1
SBI74ZHB9327744,78,19,13,6,1
SBI45YWN5342186,84,20,15,5,1
SBI58BQR1328774,76,32,23,9,1
SBI25KWJ3436416,20,25,24,1,1
SBI94IXS6117558,18,24,21,3,1
SBI26LFN1789579,96,33,18,15,1
SBI49GXG8332378,21,23,13,10,1
SBI40MJG6242605,21,16,15,1,1
SBI61PRM4796950,74,19,15,4,1
SBI47OEZ6446326,60,25,22,3,1
SBI70MKC6190756,69,18,15,3,1
SBI70UVN0715815,25,21,16,5,1
SBI90JRP7588926,60,22,13,9,1
SBI04CRW6095762,20,22,15,7,1
SBI66RGH4455213,78,21,19,2,1
SBI72MJF8118106,96,28,22,6,1
SBI75JOJ5161635,90,22,19,3,1
SBI05ZRJ1049198,19,27,19,8,1
SBI27GZG0173118,21,29,27,2,1
SBI63PFW8449137,80,24,23,1,1
SBI71OOD3498699,71,19,12,7,1
SBI76GDV8161697,18,26,24,2,1
SBI96EDR9530507,70,29,17,12,1
SBI09MOA5963889,97,27,19,8,1
SBI87BWK3863807,91,18,15,3,1
SBI70SRS9163991,21,22,15,7,1
SBI10AJS8594616,63,17,15,2,1
SBI00TML0653093,87,13,11,2,1
SBI88BCG4439661,79,27,22,5,1
SBI45ILX3298925,79,25,22,3,1
SBI86RSI7003659,75,21,16,5,1
SBI04CVU1260514,85,25,21,4,1
SBI04ICO4142773,60,27,14,13,1
SBI72HPK7188853,63,25,20,5,1
SBI05TUL7772039,19,31,18,13,1
SBI82TOM9232868,63,27,24,3,1
SBI62IEI4449602,85,25,21,4,1
SBI60DIV9282915,90,20,15,5,1
SBI59UYC2441724,97,30,25,5,1
SBI57RFC8925236,21,18,17,1,1
SBI88OUQ6734607,98,31,16,15,1
SBI90QIM1481641,86,30,28,2,1
SBI43HAV3704909,96,29,26,3,1
SBI77CBB9076541,61,27,15,12,1
SBI82PTK9683192,60,23,20,3,1
SBI96CPT1195607,22,22,20,2,1
SBI23OAU2711304,66,29,27,2,1
SBI42YWK0404525,96,20,13,7,1
SBI92ISL4771527,70,19,18,1,1
SBI33ZSJ3161990,99,20,13,7,1
SBI37VIV6411094,93,17,16,1,1
SBI06IGK4786862,73,25,17,8,1
SBI09YDR7739780,84,24,13,11,1
SBI65NIF5739549,75,24,20,4,1
SBI01TJM5029588,89,23,13,10,1
SBI27SMI1436417,22,31,24,7,1
SBI80JOX6629125,62,27,21,6,1
SBI67UDE2804299,22,19,17,2,1
SBI28TTC5773081,71,17,9,8,1
SBI77ZDN5467482,87,20,15,5,1
SBI60IIM5776948,25,23,21,2,1
SBI74OVA3844560,74,20,19,1,1
SBI61ZOS7722311,72,21,17,4,1
SBI97EOY5867189,94,20,16,4,1
SBI80SDJ1295290,66,24,19,5,1
SBI34WDC5293679,82,30,26,4,1
SBI92JYH4678047,77,26,17,9,1
SBI37COR1732459,87,34,20,14,1
SBI85LVD3859356,76,26,19,7,1
SBI97PUW1180472,21,18,16,2,1
SBI94MPR5052332,71,23,18,5,1
SBI88BSM5850946,94,24,19,5,1
SBI81LSY9874136,81,28,18,10,1
SBI97PUI4483827,67,25,19,6,1
SBI82JGR9795974,71,25,23,2,1
SBI76ITK0093672,71,25,17,8,1
SBI07JDT4564843,23,22,13,9,1
SBI23BBA6067576,89,24,18,6,1
SBI31VMQ1978233,87,36,34,2,1
SBI67VTT5649547,83,23,22,1,1
SBI38UPB2123654,71,24,13,11,1
SBI00XZO4892002,86,31,16,15,1
SBI87ULK1044561,99,17,16,1,1
SBI70NMX3285529,23,19,11,8,1
SBI23PKK0031903,18,32,24,8,1
SBI98MLT8796245,92,24,15,9,1
SBI26TML3237924,74,27,22,5,1
SBI48WDK2664690,82,32,27,5,1
SBI20ATM0147372,93,28,17,11,1
SBI36PZC4718037,63,15,13,2,1
SBI91MAI5764371,83,31,17,14,1
SBI38MDL1670190,61,27,24,3,1
SBI31ENJ9393999,72,21,15,6,1
SBI27QBL5812335,91,26,16,10,1
SBI11NIH5791956,21,35,32,3,1
SBI90MGL7968897,69,29,20,9,1
SBI16BIW6739543,22,32,18,14,1
SBI43YFX3332058,61,26,15,11,1
SBI78OAZ0821104,95,24,15,9,1
SBI12ARE9326044,62,27,17,10,1
SBI45CDW7547336,91,27,20,7,1
SBI73PXB3236758,98,20,18,2,1
SBI23PVY0986701,69,21,16,5,1
SBI00DVT9807520,21,20,11,9,1
SBI00YDW5555336,61,35,30,5,1
SBI81GBA0612946,66,30,21,9,1
SBI98OUK3549335,61,15,10,5,1
SBI41OHI8177030,95,17,15,2,1
SBI85HFZ1016641,98,25,24,1,1
SBI55UGD6486957,80,19,12,7,1
SBI32RBK2577598,63,31,25,6,1
SBI22UDG6686925,20,26,22,4,1
SBI53RLI6971161,22,21,13,8,1
SBI00VSG3766547,20,29,16,13,1
SBI07YFG6982711,20,36,31,5,1
SBI53JRZ2723041,64,22,18,4,1
SBI17FTX8124569,25,26,14,12,1
SBI33FUE7862415,97,20,16,4,1
SBI95FLQ3170253,18,19,17,2,1
SBI00SHB0169204,95,31,26,5,1
SBI04OXP4625700,62,32,20,12,1
SBI87LIU1091849,25,33,29,4,1
SBI84ETZ0566758,18,29,28,1,1
SBI37QYG5425159,73,33,29,4,1
SBI63ORR4504149,92,25,24,1,1
SBI09TWL1186940,61,33,23,10,1
SBI28RUX3217430,66,27,20,7,1
SBI31HXC1521842,85,27,18,9,1
SBI56IHK4456304,88,22,15,7,1
SBI73UFM9336277,67,22,13,9,1
SBI87BMI6181752,94,27,23,4,1
SBI34RQS6071890,94,29,24,5,1
SBI87HLW0802132,87,28,18,10,1
SBI84JMW3030494,96,30,25,5,1
SBI26DJV7295222,23,23,15,8,1
SBI60FGU3272059,22,21,15,6,1
SBI17IXT5659552,62,21,16,5,1
SBI50ZAX8463043,60,18,14,4,1
SBI80AGK0227851,86,23,19,4,1
SBI37BPN2806021,96,22,20,2,1
SBI36ZHO6492276,25,21,14,7,1
SBI84SXV2964481,95,34,29,5,1
SBI31EEW9028280,78,29,26,3,1
SBI59WLT6482420,88,21,13,8,1
SBI39AGB3607433,95,30,23,7,1
SBI84NET8588260,91,26,19,7,1
SBI23KRO2998099,74,22,21,1,1
SBI10CWD3441159,97,23,20,3,1
SBI16MBF6955983,93,27,24,3,1
SBI26JGX4295202,93,28,17,11,1
SBI62JWR3710859,94,23,17,6,1
SBI13WNV6834514,81,30,26,4,1
SBI55FCR6290670,95,20,13,7,1
SBI99RSQ8657417,63,19,11,8,1
SBI95GJA4279171,88,20,17,3,1
SBI04TSH1414094,74,24,16,8,1
SBI93ZTR2129037,19,28,18,10,1
SBI97PZF7622706,71,27,21,6,1
SBI71YAW9560455,86,28,21,7,1
SBI12BYU2409276,25,21,12,9,1
SBI58WJK5692637,92,23,20,3,1
SBI67WAQ2470693,24,18,13,5,1
SBI88WMV0106817,70,26,18,8,1
SBI91EQZ1769913,89,28,19,9,1
SBI34WAH0692752,69,23,17,6,1
SBI73JWG3938942,93,27,23,4,1
SBI88CCE4907453,86,24,14,10,1
SBI30BOO0827592,89,24,13,11,1
SBI66TCR0174744,95,28,16,12,1
SBI17XIG1216093,96,23,22,1,1
SBI21JMF6575055,78,28,24,4,1
SBI83PWO6393689,80,20,12,8,1
SBI10KYH6417770,81,19,11,8,1
SBI28GPB7641809,85,31,16,15,1
SBI51WDM3820431,73,22,21,1,1
SBI58GUQ0807869,19,17,12,5,1
SBI84QGY0862001,80,24,19,5,1
SBI89QZF1729664,88,23,13,10,1
SBI87CVW0569254,74,23,19,4,1
SBI24WSW3744217,85,33,27,6,1
SBI85FMV8153313,84,30,20,10,1
SBI46VTI2755646,22,21,11,10,1
SBI69NUJ9772127,78,19,15,4,1
SBI80WVH3455741,25,20,18,2,1
SBI52IFX6734106,93,29,21,8,1
SBI20EWR1251276,76,22,16,6,1
SBI69YRH8632832,87,27,26,1,1
SBI77DXK6340570,88,29,15,14,1
SBI28OXP3721552,90,22,20,2,1
SBI99FOY9507219,91,19,12,7,1
SBI99UJQ0763240,24,22,18,4,1
SBI41RFA0946626,96,21,14,7,1
SBI17SPE0928115,92,22,17,5,1
SBI57NWL1521835,71,26,18,8,1
SBI99HVD6110248,23,25,24,1,1
SBI11MZT7457847,79,29,19,10,1
SBI50COW6799554,79,22,15,7,1
SBI71SKP7940591,22,24,17,7,1
SBI31HAS2372986,19,15,8,7,1
SBI50ZMJ0767005,68,26,20,6,1
SBI08RDI7578028,25,21,19,2,1
SBI11BVG8484487,86,20,11,9,1
SBI67GRJ5406236,80,17,13,4,1
SBI77ECZ2931004,72,30,20,10,1
SBI46EVL0940180,98,24,20,4,1
SBI44EIJ1124536,83,35,33,2,1
SBI65MRR3961554,93,30,16,14,1
SBI88SOW6599352,99,26,22,4,1
SBI82PEN3190211,78,21,15,6,1
SBI27LRY3993115,60,32,26,6,1
SBI19EFO6400186,89,20,18,2,1
SBI42AGY5936839,79,29,22,7,1
SBI88DRI9933046,72,26,14,12,1
SBI10URY3099133,95,22,13,9,1
SBI90NLR4148503,61,27,18,9,1
SBI65OEE7925896,61,34,25,9,1
SBI19LZZ3715922,98,25,21,4,1
SBI74HQR1695961,69,18,12,6,1
SBI42RBB3408790,87,21,19,2,1
SBI09DKD3287682,75,30,22,8,1
SBI18XOZ5788613,96,28,21,7,1
SBI26WNI4992037,84,26,15,11,1
SBI26III6393407,90,30,25,5,1
SBI36MMF1755210,67,32,18,14,1
SBI91NCJ1454538,69,16,13,3,1
SBI15JCY2146581,24,29,20,9,1
SBI92YZH5967921,94,23,20,3,1
SBI71CVJ2662784,85,29,18,11,1
SBI75XEW6065245,90,25,19,6,1
SBI37ANF1562737,81,25,23,2,1
SBI90HEN0686112,66,18,16,2,1
SBI85HRW3017951,19,13,9,4,1
SBI32PUF4922783,64,25,22,3,1
SBI32QLY8751848,73,31,23,8,1
SBI11BNR6109941,89,25,19,6,1
SBI63UII9557034,82,17,10,7,1
SBI70JEG6132370,93,33,21,12,1
SBI07WRT6302612,84,13,12,1,1
SBI59JIM4693471,88,32,20,12,1
SBI12OIZ7555478,94,26,22,4,1
SBI36FJF4166283,92,26,15,11,1
SBI87JYM3735464,80,24,16,8,1
SBI12QOT1172016,87,25,15,10,1
SBI34YPO4853577,18,34,22,12,1
SBI80GET5016813,82,24,20,4,1
SBI44RIU2122653,97,25,14,11,1
SBI13ULP2517496,23,25,13,12,1
SBI06CIU5356763,91,14,9,5,1
SBI43NDQ8937335,60,19,10,9,1
SBI89SMV6148587,95,17,12,5,1
SBI69ICH0231875,19,29,21,8,1
SBI49IMR0583555,85,26,16,10,1
SBI51FPI2989640,71,18,14,4,1
SBI09TXD9244834,83,17,13,4,1
SBI61MXU4533421,18,22,18,4,1
SBI89NYL0485940,96,23,19,4,1
SBI00TDJ9633182,76,21,15,6,1
SBI61GSI5526187,91,16,11,5,1
SBI09TCL0748025,83,18,15,3,1
SBI15CVB0696297,92,32,22,10,1
SBI15HCL4667276,96,30,21,9,1
SBI10THA4656431,74,26,22,4,1
SBI57SNB9457414,21,22,16,6,1
SBI74XUD9534458,64,29,23,6,1
SBI70CNE7704975,65,19,10,9,1
SBI86VDC8256339,78,17,9,8,1
SBI52VZX0761550,76,18,13,5,1
SBI62FRR0928830,80,27,20,7,1
SBI84CQC3869560,83,22,13,9,1
SBI84PMS6017334,96,21,13,8,1
SBI24ZPZ1756345,70,21,12,9,1
SBI56NSU6402783,92,28,17,11,1
SBI20OAP4963011,20,24,21,3,1
SBI65IWS9539443,73,24,22,2,1
SBI41GIL3384028,97,26,25,1,1
SBI03CDA6101869,78,23,19,4,1
SBI00LTH8734152,81,23,13,10,1
SBI15FSM3864915,75,24,23,1,1
SBI11UEK0057550,86,32,30,2,1
SBI08NYA3424858,68,26,15,11,1
SBI44OCR8407600,68,29,28,1,1
SBI01RWW8299102,96,25,23,2,1
SBI97CJT8725292,77,27,26,1,1
SBI08NOJ3888721,89,23,13,10,1
SBI70KYQ3574456,96,25,24,1,1
SBI61LDF5242049,25,24,22,2,1
SBI07WEU7432486,93,31,26,5,1
SBI71CJO5398668,22,29,15,14,1
SBI17EBW5973070,88,26,20,6,1
SBI87RCS6694362,86,14,13,1,1
SBI42ITC8098973,71,22,18,4,1
SBI67ZBI3745090,78,26,25,1,1
SBI50HAN7454266,66,19,15,4,1
SBI98HMG3450288,85,19,17,2,1
SBI04JLZ6229976,20,16,14,2,1
SBI02XPZ1698828,65,28,15,13,1
SBI82FHR1797815,86,18,15,3,1
SBI75YFG8429003,21,21,19,2,1
SBI31IPZ7886482,62,20,14,6,1
SBI65GFK5747084,82,34,32,2,1
SBI00MGZ3978105,73,29,17,12,1
SBI97BJN0560475,70,19,10,9,1
SBI02ANR4337524,67,29,19,10,1
SBI25SRA5596042,69,19,10,9,1
SBI81HTG2646759,89,18,10,8,1
SBI92MWW3466682,68,20,17,3,1
SBI89CQX6285097,67,21,16,5,1
SBI27UZS8080300,88,34,33,1,1
SBI84SJT5984267,21,32,20,12,1
SBI18XMS2685784,74,31,16,15,1
SBI20EIQ1084786,21,22,18,4,1
SBI25JSX4104582,65,23,18,5,1
SBI35NNV3398834,23,26,21,5,1
SBI54EYW1822294,86,22,13,9,1
SBI10PFQ9192239,81,28,24,4,1
SBI41XVQ1313923,88,21,15,6,1
SBI29REF3661727,91,24,19,5,1
SBI30YSO7109258,83,19,16,3,1
SBI13QOA9864972,91,33,25,8,1
SBI43YXM0736267,25,26,19,7,1
SBI78OVJ8518505,75,27,21,6,1
SBI05MFZ8428306,97,24,16,8,1
SBI23GSR9906187,83,24,20,4,1
SBI50DYL6435420,83,23,15,8,1
SBI95GTI4557530,84,26,22,4,1
SBI17HDQ0265532,94,29,17,12,1
SBI32BNB6353977,92,23,15,8,1
SBI78HUH9625569,66,20,19,1,1
SBI86BLA5538903,86,25,15,10,1
SBI78CCZ4347833,24,28,24,4,1
SBI13SNK9796272,72,25,24,1,1
SBI21VOF8644138,76,27,19,8,1
SBI77RLI4287235,96,21,15,6,1
SBI09ZLI8134474,73,28,27,1,1
SBI14TJM9980811,89,23,18,5,1
SBI09ZSM5346807,87,17,11,6,1
SBI52WPT3474450,65,28,15,13,1
SBI20HCJ6253570,67,27,23,4,1
SBI33MBS1869528,96,25,18,7,1
SBI85OEU9567402,90,20,19,1,1
SBI45NCW6006231,19,23,20,3,1
SBI52BZL6699539,88,23,20,3,1
SBI84IIP6567199,23,21,18,3,1
SBI49RGR7459431,85,25,18,7,1
SBI95DVZ9689834,84,23,18,5,1
SBI18WKM5250896,96,23,21,2,1
SBI77PXO2132292,20,21,17,4,1
SBI88HGY3009054,81,25,15,10,1
SBI04LHK3094898,98,29,19,10,1
SBI45THA7363181,98,34,24,10,1
SBI01OZZ9713080,18,30,22,8,1
SBI53LIQ1249383,89,24,21,3,1
SBI93PBU8422509,66,22,21,1,1
SBI89EDS0619565,87,21,17,4,1
SBI43ZEL5631922,75,26,14,12,1
SBI02ANS4466480,88,28,17,11,1
SBI59HXN5188871,62,32,22,10,1
SBI57GRT4458226,90,21,11,10,1
SBI39LQK9418552,22,24,18,6,1
SBI63BXC6000695,72,21,13,8,1
SBI17KCR7219410,74,27,26,1,1
SBI47BRP2884454,25,27,21,6,1
SBI37VMF9293798,93,24,15,9,1
SBI28DHX2332288,82,21,18,3,1
SBI76EFO3880033,25,26,20,6,1
SBI83NJF3330739,77,28,21,7,1
SBI95RBR8939407,75,34,25,9,1
SBI79XHU6843446,86,33,23,10,1
SBI93ACS5254601,80,16,14,2,1
SBI65DOF4083971,20,16,11,5,1
SBI48PYK3966005,61,34,21,13,1
SBI35CEW7821546,23,31,21,10,1
SBI12ZYO3057423,79,18,10,8,1
SBI53SEJ0485625,22,18,10,8,1
SBI12NOD7457659,66,29,23,6,1
SBI91LUA6543676,68,19,10,9,1
SBI97TXR8227432,73,21,14,7,1
SBI83KIZ0181297,99,23,21,2,1
SBI20AXW7079626,19,26,16,10,1
SBI65LCK7287578,87,34,24,10,1
SBI45UGT6841487,89,33,17,16,1
SBI16OPX5468461,85,20,11,9,1
SBI49BCZ5995945,88,22,12,10,1
SBI89GEM0583138,98,27,18,9,1
SBI91JNB7287425,21,18,17,1,1
SBI44OTO7580801,95,17,9,8,1
SBI25NRG0215163,87,28,24,4,1
SBI86GTL8346405,73,32,27,5,1
SBI48UED0771302,91,26,16,10,1
SBI35JKV9623757,75,25,22,3,1
SBI42MHD6840251,96,20,11,9,1
SBI63GRT8897926,72,30,25,5,1
SBI53DCC0079541,89,20,17,3,1
SBI78TRX4981114,63,17,10,7,1
SBI99KDW1041817,65,29,27,2,1
SBI23JOV1681592,87,21,15,6,1
SBI42GAD9777982,23,22,18,4,1
SBI98MHI2681216,20,26,20,6,1
SBI42YSL0279209,64,22,15,7,1
SBI50FGH6184087,62,26,20,6,1
SBI51RGF5790399,90,20,17,3,1
SBI95OVK0743524,80,23,12,11,1
SBI44PYY6965244,20,23,22,1,1
SBI23QEB6909725,21,31,24,7,1
SBI56IAL2892255,82,29,23,6,1
SBI95KHO3446418,65,28,27,1,1
SBI46CUD4694696,64,26,24,2,1
SBI30KGA7801622,85,27,23,4,1
SBI29NTJ2959088,77,19,13,6,1
SBI08AXI3148055,22,22,12,10,1
SBI92LLW8549321,79,27,15,12,1
SBI14ODH5859810,97,26,22,4,1
SBI60NYU6800613,25,19,12,7,1
SBI10TYV0315738,76,27,17,10,1
SBI04GUV8847670,94,32,28,4,1
SBI66TUG1376248,89,24,13,11,1
SBI30MFX3587645,79,23,22,1,1
SBI05EJT2800664,88,23,15,8,1
SBI61KEJ6605787,96,21,17,4,1
SBI72EFU2068030,73,24,13,11,1
SBI53SEY7885167,86,21,19,2,1
SBI37YAX5836272,62,24,20,4,1
SBI59HZL6406602,75,29,26,3,1
SBI73KYL8364468,93,22,20,2,1
SBI43NLP3770578,94,23,19,4,1
SBI12MCU4013061,92,28,22,6,1
SBI73NLC3599578,91,23,18,5,1
SBI83SHX6024075,90,24,21,3,1
SBI13AZX9036590,63,26,19,7,1
SBI77KLI1673276,73,33,20,13,1
SBI84YVA6559249,24,17,12,5,1
SBI22DFS3070446,92,21,20,1,1
SBI88UEQ9300709,92,36,25,11,1
SBI21PID8427034,22,37,27,10,1
SBI34ZBS3637521,91,31,20,11,1
SBI90AUZ9066818,63,18,17,1,1
SBI09XXK5016341,75,20,15,5,1
SBI82FHC4889593,63,24,14,10,1
SBI92DDF0316803,99,24,13,11,1
SBI84DPI9430015,61,20,18,2,1
SBI33MKC3401339,64,32,21,11,1
SBI63YMQ1232109,87,27,15,12,1
SBI34QRH9758273,84,23,13,10,1
SBI90ZWR3596187,69,24,17,7,1
SBI43YBQ8195767,79,32,29,3,1
SBI95USO5540919,86,14,13,1,1
SBI86EGC3560043,19,24,23,1,1
SBI73JRK3224774,81,23,22,1,1
SBI08JRB9084681,83,19,17,2,1
SBI84TAB9434263,19,26,20,6,1
SBI82FJP6882086,69,30,25,5,1
SBI55QWV1749607,76,19,15,4,1
SBI75SRG4206510,97,20,15,5,1
SBI96RPW1092905,60,19,11,8,1
SBI14OHL8198256,71,23,18,5,1
SBI74VFN6519159,65,23,14,9,1
SBI27ZPW0653352,63,21,13,8,1
SBI42GIZ5710923,23,22,14,8,1
SBI97MBC8605358,67,29,17,12,1
SBI33HEO3262123,93,16,12,4,1
SBI80GFP3269176,97,22,15,7,1
SBI30YBV7821170,91,26,20,6,1
SBI11WIO7192378,70,26,19,7,1
SBI22UOJ1819502,69,17,11,6,1
SBI24LAF6303555,87,26,25,1,1
SBI57CPM8294151,94,25,20,5,1
SBI91CFX5978390,86,21,15,6,1
SBI24GDA3860632,77,20,13,7,1
SBI49KLR2217650,21,30,19,11,1
SBI39RFT2233864,20,24,15,9,1
SBI78WVN0929407,64,29,28,1,1
SBI62CXD9142540,99,15,8,7,1
SBI39HFY2064462,23,18,11,7,1
SBI74HFG5703195,81,29,19,10,1
SBI35VHP5806846,79,22,20,2,1
SBI82OTU2468755,68,27,16,11,1
SBI32PVA5383081,20,27,20,7,1
SBI37EBY3081565,70,20,12,8,1
SBI56QFE4442897,25,21,18,3,1
SBI46HEE7654610,65,26,23,3,1
SBI20SPD2464181,20,26,20,6,1
SBI63DGA8030832,92,22,15,7,1
SBI75UZM9306187,89,35,34,1,1
SBI68NRF0835107,99,29,22,7,1
SBI38FRP2623633,18,23,21,2,1
SBI51QIU0005478,69,20,12,8,1
SBI68CWP8313654,99,20,19,1,1
SBI90PRC7638251,95,19,11,8,1
SBI82WPD7751899,85,22,18,4,1
SBI52CUZ0167335,93,29,16,13,1
SBI39XEB6197317,67,26,20,6,1
SBI69KXB5220881,21,31,16,15,1
SBI88CUP3313686,87,19,17,2,1
SBI96RWD3083301,21,16,15,1,1
SBI31XME1166757,71,18,16,2,1
SBI30HEB5937127,71,31,27,4,1
SBI39MFN3271191,99,23,14,9,1
SBI03IEO0870390,85,19,14,5,1
SBI92YAB2118781,22,28,27,1,1
SBI51HZE3068733,74,28,19,9,1
SBI63NGP6671122,82,31,21,10,1
SBI96PVW8242751,86,29,19,10,1
SBI21AAP7752715,99,18,15,3,1
SBI08MPX1859217,78,27,16,11,1
SBI39GVL9826568,18,19,15,4,1
SBI08HXE6731531,74,30,21,9,1
SBI75CQO6634415,92,21,12,9,1
SBI82UNX3212463,83,37,31,6,1
SBI42JED0666364,64,11,7,4,1
SBI89KZY9020189,85,15,9,6,1
SBI34VOU0658976,81,17,14,3,1
SBI06YIC7132527,93,21,11,10,1
SBI03ZKU1400754,20,28,16,12,1
SBI14LXJ8775897,97,23,16,7,1
SBI44WJP6502786,74,19,14,5,1
SBI90YPT1034394,88,21,12,9,1
SBI72TZP2674009,82,12,11,1,1
SBI60DKU4032379,69,24,18,6,1
SBI39IHD0178541,25,27,21,6,1
SBI56CMU7256488,77,26,18,8,1
SBI78XZJ1648685,24,33,21,12,1
SBI15FLF2053471,21,20,15,5,1
SBI39WAY2679965,67,16,12,4,1
SBI27GIG7869805,62,21,12,9,1
SBI17LXC6543913,24,26,21,5,1
SBI27NNN4255525,64,21,18,3,1
SBI03HLK3378111,67,26,21,5,1
SBI45JHI6919943,24,21,15,6,1
SBI32WRI1307961,93,31,16,15,1
SBI32LFF7668994,80,24,18,6,1
SBI15BUJ6731582,66,21,17,4,1
SBI19GGJ9753878,88,23,19,4,1
SBI56FHF5810726,25,23,16,7,1
SBI88AAO3973676,89,21,13,8,1
SBI40EFO6725746,93,28,19,9,1
SBI06UIC2616869,91,23,18,5,1
SBI64OSX6661104,88,26,24,2,1
SBI44SQK3249158,86,28,23,5,1
SBI65BRP3368570,69,30,24,6,1
SBI40FFI1948317,77,31,18,13,1
SBI47EOF4235250,63,29,23,6,1
SBI27UAD3475266,25,25,24,1,1
SBI37OPT5388740,83,22,21,1,1
SBI65FWT6468006,21,25,17,8,1
SBI58ETQ9238393,83,31,24,7,1
SBI94ACK0312202,72,17,12,5,1
SBI30LQS3251800,23,25,22,3,1
SBI27FGT0570161,22,24,14,10,1
SBI56XLS7662112,80,30,27,3,1
SBI44DTX5908835,20,37,32,5,1
SBI62JCX8338346,72,27,16,11,1
SBI00IYR3400982,94,23,22,1,1
SBI00EAY7304363,76,26,20,6,1
SBI18JPF1095640,19,30,29,1,1
SBI34NXT7055540,82,30,17,13,1
SBI39VEU0977616,76,21,12,9,1
SBI16YSN7714239,79,28,24,4,1
SBI61CIA7491427,69,22,13,9,1
SBI98YBG7101878,98,23,12,11,1
SBI04UZI9361986,96,22,19,3,1
SBI98OOA6377274,68,33,25,8,1
SBI12BNJ7385737,66,24,17,7,1
SBI73FXE4065710,94,12,10,2,1
SBI16FKW6275052,89,28,15,13,1
SBI59MNU5879718,25,22,16,6,1
SBI35YHG4984819,19,13,11,2,1
SBI18SXZ0050954,90,21,14,7,1
SBI01CTT8309875,69,31,26,5,1
SBI16NHH4414956,62,30,25,5,1
SBI41BDQ4917191,18,19,18,1,1
SBI57IDN8334723,94,32,23,9,1
SBI06XIH0081122,66,34,23,11,1
SBI16EKI7437486,85,22,12,10,1
SBI27KGJ2152203,73,19,11,8,1
SBI70YUH7178688,25,15,14,1,1
SBI92HXM8403605,73,20,18,2,1
SBI08HVG7270727,88,40,27,13,1
SBI20YVU3636459,62,37,23,14,1
SBI50BPQ3442442,64,21,19,2,1
SBI07TYX6074751,82,25,16,9,1
SBI68GFU2551460,80,21,17,4,1
SBI06BRX0886320,75,17,15,2,1
SBI45FXQ0104767,96,26,15,11,1
SBI53CBW7145811,20,19,10,9,1
SBI30ZQP8969751,89,29,16,13,1
SBI04IRP5354792,89,24,19,5,1
SBI06RSE1532043,88,24,17,7,1
SBI73MDC6773053,95,19,10,9,1
SBI90UYI1245060,68,26,20,6,1
SBI50FLY7987077,70,21,18,3,1
SBI24DWT4439321,62,18,10,8,1
SBI51GLK6781282,64,33,26,7,1
SBI23NZN9899239,64,21,19,2,1
SBI10LSE6610666,96,20,13,7,1
SBI41FAN4336275,99,20,15,5,1
SBI92JUY5640313,64,28,16,12,1
SBI92VMS7471102,83,21,13,8,1
SBI36FHR6111737,73,29,18,11,1
SBI00ZBX4511631,83,25,15,10,1
SBI64SKG4316960,64,33,22,11,1
SBI29JYV4064906,74,30,21,9,1
SBI32BZJ9471181,18,30,19,11,1
SBI48SPV9388652,93,21,16,5,1
SBI90VSL3817975,65,21,20,1,1
SBI69IRJ6134554,22,17,10,7,1
SBI20EMQ2244419,77,27,17,10,1
SBI56EKX8904340,83,19,11,8,1
SBI73CLI4799720,61,27,19,8,1
SBI47KLL4244357,21,31,24,7,1
SBI81WKG4522369,19,18,12,6,1
SBI78SAI5239250,95,25,15,10,1
SBI68MRU0378033,75,15,8,7,1
SBI56TIF3801732,88,27,14,13,1
SBI43NFU1195476,63,26,18,8,1
SBI76HQF0083543,24,18,13,5,1
SBI51JHM6837609,73,25,20,5,1
SBI96EBP4671789,67,22,21,1,1
SBI05LXF5312065,62,16,12,4,1
SBI78OBH3359122,85,28,27,1,1
SBI62UGH5111593,61,25,24,1,1
SBI81ELW7597757,24,34,27,7,1
SBI06IZO6358946,21,21,12,9,1
SBI92VJX3109287,77,24,17,7,1
SBI38JYY9207893,93,25,14,11,1
SBI68QPG5318897,90,29,27,2,1
SBI23WNN2584115,94,24,21,3,1
SBI55KZR8116844,74,32,28,4,1
SBI98NUH7880657,99,28,22,6,1
SBI57CFQ8572785,93,31,25,6,1
SBI57FIF4586814,98,23,17,6,1
SBI77TEL7623269,70,22,21,1,1
SBI91UUF6825277,70,28,18,10,1
SBI81EIR0944490,19,28,24,4,1
SBI17JCC3558606,23,25,24,1,1
SBI74MME0582462,22,24,19,5,1
SBI69GXI3718650,99,26,18,8,1
SBI64PQT2866584,86,30,21,9,1
SBI23DMG6639983,23,17,15,2,1
SBI54DYD8215860,77,21,15,6,1
SBI23WIP7727057,86,16,15,1,1
SBI22QTO0856537,95,23,16,7,1
SBI90IFT8152306,84,20,15,5,1
SBI69EUW5436160,65,30,23,7,1
SBI42SAY6046634,92,25,18,7,1
SBI41WDQ9400735,23,27,16,11,1
SBI43BED8513706,79,28,21,7,1
SBI23VHQ8602294,84,33,17,16,1
SBI33KDF6007864,79,24,14,10,1
SBI58LSA5302553,94,17,12,5,1
SBI80TQN4070710,95,28,16,12,1
SBI77EAK9535775,24,31,26,5,1
SBI52ANB2824693,66,31,22,9,1
SBI62MGH0756400,68,20,18,2,1
SBI85JJC0507675,66,20,12,8,1
SBI04MOF2249026,73,22,16,6,1
SBI97DYM0261232,91,34,25,9,1
SBI23VAG6738660,77,21,11,10,1
SBI10EHQ1219254,65,33,22,11,1
SBI25STX5619563,23,19,10,9,1
SBI20BSP7609197,63,21,20,1,1
SBI95TEG4599926,18,22,18,4,1
SBI85KMX9526475,91,21,16,5,1
SBI32LOI6554126,87,23,15,8,1
SBI10BKV7661651,80,19,13,6,1
SBI90FDL5384534,66,20,13,7,1
SBI66LLH3710271,95,28,22,6,1
SBI89VWF8335891,81,30,24,6,1
SBI46TXQ6640595,77,28,27,1,1
SBI06AQY4733176,85,25,17,8,1
SBI68ZAD2812523,24,34,21,13,1
SBI29DJJ2796193,77,26,17,9,1
SBI75SVD6246169,95,24,19,5,1
SBI75FLD8576959,71,22,15,7,1
SBI50KBO9560360,64,16,15,1,1
SBI53WMK6247842,66,29,26,3,1
SBI11ZSI7065635,79,26,14,12,1
SBI96DUF8540960,95,22,16,6,1
SBI14CJC1688792,61,29,23,6,1
SBI38BXK2375126,88,27,17,10,1
SBI08BFD3202678,95,25,17,8,1
SBI68LMH8108366,72,33,21,12,1
SBI56QKG0220035,63,28,25,3,1
SBI55NTR2425511,23,23,14,9,1
SBI75MJS0149786,86,28,26,2,1
SBI06QOE4115713,95,29,21,8,1
SBI40YXU2695892,90,21,11,10,1
SBI30BKU1718857,18,18,17,1,1
SBI46JGK8096518,66,21,14,7,1
SBI63GWH7742674,68,24,13,11,1
SBI60VME4369701,99,19,13,6,1
SBI17XOW2795561,81,33,25,8,1
SBI81GPF1648577,84,26,15,11,1
SBI41ZAP1060958,94,20,17,3,1
SBI25NPD9153920,81,22,21,1,1
SBI77DFL2033514,93,18,17,1,1
SBI92ULW7239788,77,30,25,5,1
SBI95XXQ3331174,19,25,16,9,1
SBI27KDK3350200,93,24,15,9,1
SBI92YDX4649169,91,20,18,2,1
SBI32CXB0989864,83,29,26,3,1
SBI40QRV7947605,69,23,12,11,1
SBI69JCX3217335,78,28,21,7,1
SBI16GIA9196997,23,23,17,6,1
SBI08WMS4624666,98,24,21,3,1
SBI79ULB3042122,18,22,14,8,1
SBI45RYQ5587061,88,23,19,4,1
SBI89GKO9621408,87,21,15,6,1
SBI25ZEM7206756,74,41,36,5,1
SBI10HAJ9027879,85,25,21,4,1
SBI15EAB1154968,18,22,21,1,1
SBI76GLP0000988,60,11,7,4,1
SBI98EQV3449102,21,25,15,10,1
SBI48YOW3079874,88,27,14,13,1
SBI50UOA5597218,73,23,13,10,1
SBI41QVU6356260,24,22,13,9,1
SBI14HBX5618589,81,20,12,8,1
SBI92ZWD6222700,21,25,14,11,1
SBI25JBI8486076,62,31,23,8,1
SBI04FLM8189755,62,27,21,6,1
SBI41ENA8067984,65,26,22,4,1
SBI07QDS0560227,72,29,26,3,1
SBI69BMY7970785,83,20,15,5,1
SBI88BHO5771192,87,22,19,3,1
SBI24XIA0150106,65,27,21,6,1
SBI04FUK0270212,24,14,8,6,1
SBI52UOL6017665,23,23,15,8,1
SBI24ITQ6632327,20,25,24,1,1
SBI50QAU5359187,70,23,17,6,1
SBI31WZQ3253001,25,26,22,4,1
SBI28ILE7587409,87,15,14,1,1
SBI85YGI1943357,64,30,28,2,1
SBI19FYQ4993049,85,30,21,9,1
SBI70JSS4575520,74,25,22,3,1
SBI00CAD1742057,81,24,13,11,1
SBI34STL5249346,18,19,15,4,1
SBI49XQM8880725,99,20,19,1,1
SBI17OWS9615825,96,24,14,10,1
SBI75AMZ0369595,69,28,21,7,1
SBI13CQR3220553,21,23,22,1,1
SBI07EZO6703238,70,28,17,11,1
SBI63YCB4079485,72,20,14,6,1
SBI72JUV0332199,64,20,14,6,1
SBI88DMZ4544711,77,26,16,10,1
SBI72UZW0322250,19,20,11,9,1
SBI33VAG4649821,23,18,16,2,1
SBI24LQI8222162,60,21,15,6,1
SBI06YZB1523080,21,17,16,1,1
SBI68IXX6632109,78,16,9,7,1
SBI97AEW7681434,63,30,28,2,1
SBI00COZ2627563,72,28,18,10,1
SBI77OXR7127825,61,25,21,4,1
SBI97BAG8674183,79,23,15,8,1
SBI59XCY5943030,65,18,15,3,1
SBI39EHI7510756,73,31,20,11,1
SBI27YOQ4694519,99,26,19,7,1
SBI41HMB2132425,77,18,16,2,1
SBI82IND3865222,73,29,27,2,1
SBI17QOP8735154,20,37,19,18,1
SBI08AJB2913603,99,26,22,4,1
SBI83QAK9126903,97,25,23,2,1
SBI95TZZ5610237,61,22,19,3,1
SBI14XIZ4996720,73,28,19,9,1
SBI60JKF9191617,76,29,24,5,1
SBI91KHR5474886,88,23,16,7,1
SBI16KER1891719,98,24,22,2,1
SBI97MFT7403688,63,29,24,5,1
SBI38VCI7003890,83,19,13,6,1
SBI69TUI4190307,86,26,25,1,1
SBI33CDS0173117,86,22,15,7,1
SBI84OQE3856586,79,20,13,7,1
SBI73RYV7839405,21,19,14,5,1
SBI10CXN1383632,95,22,20,2,1
SBI65UIF9739402,93,27,14,13,1
SBI94ZVZ1679052,21,28,17,11,1
SBI68WXQ7014826,68,20,18,2,1
SBI42UQF1192125,19,22,12,10,1
SBI89OLB4059986,19,26,25,1,1
SBI87UIG4716842,67,23,22,1,1
SBI51TBT1914205,64,21,14,7,1
SBI98CUX9920317,74,23,21,2,1
SBI08HJE6414302,69,20,16,4,1
SBI90KSW0324197,96,22,21,1,1
SBI70BED6878469,21,17,13,4,1
SBI48CFB3441886,99,17,13,4,1
SBI37QKO2893597,76,22,15,7,1
SBI78LHU9729889,79,28,18,10,1
SBI26YZU0376321,83,20,15,5,1
SBI91DJE0976582,86,25,18,7,1
SBI56SXW5874737,62,27,22,5,1
SBI94BLE6315507,92,31,25,6,1
SBI17TRS5808142,66,17,15,2,1
SBI62AUN1657227,78,21,12,9,1
SBI04VAW9700285,71,19,18,1,1
SBI35MWM2912671,89,18,14,4,1
SBI85QQX0657911,20,23,13,10,1
SBI38FCR9372366,78,18,11,7,1
SBI13IVL8833570,22,24,15,9,1
SBI42VDV9409793,84,23,20,3,1
SBI17SZU1018812,19,25,24,1,1
SBI96TXB4180426,60,29,15,14,1
SBI66PUL6103742,18,29,23,6,1
SBI34VIN6938685,65,24,18,6,1
SBI68JAU8633148,76,18,10,8,1
SBI47JYJ4920104,69,26,24,2,1
SBI53SFT7938733,82,22,13,9,1
SBI24UJX8032329,99,34,28,6,1
SBI62VTQ1992314,77,13,11,2,1
SBI08MAZ4487504,65,18,15,3,1
SBI27MSY9402170,84,33,28,5,1
SBI10QTO6679135,20,19,11,8,1
SBI68MIK6159214,90,27,18,9,1
SBI38YBN5392672,65,32,25,7,1
SBI33EGY6923831,20,27,25,2,1
SBI32MPT0301034,93,22,12,10,1
SBI01MVZ1515495,90,22,18,4,1
SBI55XAQ0942604,82,33,20,13,1
SBI84PAV9695794,74,24,18,6,1
SBI51TGR5790953,18,26,20,6,1
SBI97NBN0768765,64,28,25,3,1
SBI00CNW2348771,66,30,17,13,1
SBI40UPH5915274,21,23,16,7,1
SBI07RED1320246,86,28,21,7,1
SBI58OMM6695199,88,28,23,5,1
SBI00QRM1984869,25,22,18,4,1
SBI96ZTY3664802,19,25,21,4,1
SBI55DOJ4530020,69,28,16,12,1
SBI42JIP9362739,77,29,20,9,1
SBI09VLG1072976,74,33,29,4,1
SBI67ODS7532626,62,26,19,7,1
SBI91HWU6981920,78,20,19,1,1
SBI05LUU6422120,69,24,17,7,1
SBI93ADC7605072,93,26,15,11,1
SBI06HBB1056122,81,29,19,10,1
SBI41JNF1815889,63,25,16,9,1
SBI32HKG3773340,74,17,16,1,1
SBI49RDD2747432,69,22,20,2,1
SBI93OUL5101854,70,22,18,4,1
SBI50WFU6944655,63,23,20,3,1
SBI99UBA9971867,72,28,18,10,1
SBI69BFD0474402,75,21,18,3,1
SBI34QRN4827986,96,18,13,5,1
SBI48QYQ9103133,89,25,22,3,1
SBI71QAM9585264,77,29,26,3,1
SBI24VIM6613906,79,25,21,4,1
SBI48YWM7583680,83,23,18,5,1
SBI63MGI6357019,67,10,9,1,1
SBI24UDS1246150,94,20,19,1,1
SBI96JBK7608001,74,26,22,4,1
SBI62XHO9834629,89,27,20,7,1
SBI54GZP4907141,92,18,12,6,1
SBI05WHV6718514,84,24,20,4,1
SBI99RBR5784689,63,29,19,10,1
SBI26QFG8787020,90,23,12,11,1
SBI91LVO5572304,91,28,27,1,1
SBI55AUH7385031,86,27,24,3,1
SBI81XMA0988590,22,26,19,7,1
SBI83OET0183991,23,17,10,7,1
SBI89KFT4990817,63,22,20,2,1
SBI43SWS8921929,76,25,21,4,1
SBI57IBX2724642,86,30,18,12,1
SBI51XGX2225402,76,29,19,10,1
SBI08MKC9044251,84,16,15,1,1
SBI34LWP2081440,97,22,18,4,1
SBI02JEI6380165,87,29,18,11,1
SBI60JRG1436350,22,23,22,1,1
SBI35NQD1507324,76,23,18,5,1
SBI72WML1827572,66,22,21,1,1
SBI50QFE5853515,69,23,13,10,1
SBI51IJC5874479,91,24,15,9,1
SBI36HLJ3680124,78,34,32,2,1
SBI77KFY4263252,88,26,19,7,1
SBI30RIW5126322,79,28,22,6,1
SBI03QGC0243374,20,32,23,9,1
SBI27YHS4514856,75,18,13,5,1
SBI04UKE2105412,60,23,22,1,1
SBI72JKG8568397,21,29,16,13,1
SBI05HKC8304980,86,18,16,2,1
SBI23JTB9113644,87,25,22,3,1
SBI27RIX5668843,23,27,19,8,1
SBI14HBQ3432816,75,28,21,7,1
SBI95QLD8709814,95,28,21,7,1
SBI62MJC1922776,70,28,23,5,1
SBI36LPC8692363,23,23,20,3,1
SBI17DMD6735083,20,17,13,4,1
SBI99WMN9106779,70,35,29,6,1
SBI51OED1688709,84,18,16,2,1
SBI56VCG9991604,84,25,17,8,1
SBI65KZA0598757,72,25,14,11,1
SBI05PMO4768104,83,28,19,9,1
SBI57ONA0137294,22,25,20,5,1
SBI81CYL1913644,92,18,16,2,1
SBI86YYO8681410,68,19,16,3,1
SBI26WTM5915669,85,31,30,1,1
SBI52CCZ8819543,75,17,16,1,1
SBI89LCP7805868,90,21,14,7,1
SBI34DLE2518741,71,15,10,5,1
SBI14JTO4469693,64,26,17,9,1
SBI47WVN9796746,20,24,17,7,1
SBI03EBD2671817,62,24,17,7,1
SBI20IYX0684684,96,34,27,7,1
SBI12AWI2522629,93,17,12,5,1
SBI18ESW7217736,75,11,7,4,1
SBI12EVG6683548,69,17,14,3,1
SBI67RSC1572210,24,21,15,6,1
SBI17ZZW7443947,24,27,26,1,1
SBI37EWO9051220,68,32,17,15,1
SBI21QCU1777017,90,21,17,4,1
SBI81PAJ5517193,92,22,21,1,1
SBI30NIH1008836,62,28,26,2,1
SBI80SQT3928215,88,21,20,1,1
SBI85IYT3198201,99,23,17,6,1
SBI49FMG5628687,23,25,19,6,1
SBI25HJO9883262,71,21,18,3,1
SBI42GXZ2358036,94,32,27,5,1
SBI03TNX4525307,93,19,14,5,1
SBI26TVX9531353,60,32,18,14,1
SBI31BAQ4365068,94,27,24,3,1
SBI98TVR2195123,84,25,24,1,1
SBI24QYP3381269,76,30,22,8,1
SBI98BOM1865273,90,17,11,6,1
SBI29VYM5336222,88,18,16,2,1
SBI85ZWN9954094,64,16,9,7,1
SBI94HDC3609380,95,24,17,7,1
SBI86ROY2984187,83,27,20,7,1
SBI17MAS9276007,87,20,14,6,1
SBI54RTW1767405,63,23,14,9,1
SBI49YSB6625554,65,24,16,8,1
SBI05JXJ9540076,24,27,18,9,1
SBI54NVY6105586,20,24,17,7,1
SBI55QSG3015913,87,20,19,1,1
SBI43ECX3110132,19,23,17,6,1
SBI89RBM5617912,72,29,23,6,1
SBI31HGV4647956,95,24,20,4,1
SBI53RDL6783706,95,24,23,1,1
SBI76WRF1928492,87,15,12,3,1
SBI59CGX4918021,68,28,15,13,1
SBI38DPK0767428,95,31,17,14,1
SBI70DUZ0515715,78,25,22,3,1
SBI04YOR9079719,66,28,20,8,1
SBI43MFJ1534719,24,30,24,6,1
SBI03JLM5415295,95,27,19,8,1
SBI55BUS0071899,71,21,15,6,1
SBI85YZS9922061,80,14,8,6,1
SBI66RNN0416928,25,15,9,6,1
SBI71DCK7782384,77,24,21,3,1
SBI98WIS2138584,64,19,16,3,1
SBI85VTG0327674,64,30,19,11,1
SBI91KNG2488893,62,23,21,2,1
SBI43DJO2481538,69,23,22,1,1
SBI32ACO5817786,66,18,15,3,1
SBI46DJX6793341,82,30,21,9,1
SBI87BMH8446452,85,22,21,1,1
SBI76FGI8264879,76,12,8,4,1
SBI68IKS6760438,95,31,22,9,1
SBI98INO9115235,19,15,13,2,1
SBI65HUK8738231,74,16,11,5,1
SBI55UKU6882707,25,18,16,2,1
SBI23FXX2960683,70,18,15,3,1
SBI76AYG2480934,97,26,21,5,1
SBI65YRB3469998,68,24,13,11,1
SBI64JMG6540284,71,24,23,1,1
SBI77OIR5582152,77,20,19,1,1
SBI84BTQ5042653,94,23,17,6,1
SBI49FGG9717683,60,27,21,6,1
SBI13QGD8283433,78,25,18,7,1
SBI73VRU7933778,76,32,26,6,1
SBI89JXX7289033,78,22,17,5,1
SBI13PEM3689024,89,23,12,11,1
SBI12NXV9091021,61,12,9,3,1
SBI65NBH2218675,73,18,13,5,1
SBI99NLJ5173986,65,19,18,1,1
SBI25ZQL4289384,93,22,12,10,1
SBI67SIY4752765,73,17,11,6,1
SBI16KBT9530135,62,19,14,5,1
SBI58WVY7050607,21,19,16,3,1
SBI44WRY8279621,79,24,23,1,1
SBI91LCU6718820,84,24,16,8,1
SBI76AVB5677315,95,23,20,3,1
SBI83FPJ2183081,94,23,15,8,1
SBI80AKJ6433867,92,18,15,3,1
SBI94QPS2680399,70,26,22,4,1
SBI44HIH2626594,62,17,11,6,1
SBI91TXB1528947,76,20,11,9,1
SBI00ILS3782352,79,16,12,4,1
SBI38JCY7935878,64,21,13,8,1
SBI92IDJ8196519,76,15,8,7,1
SBI82TMZ8828704,70,19,18,1,1
SBI38KJU1187732,89,22,13,9,1
SBI76SNH2004053,73,34,32,2,1
SBI48GQL1763786,19,35,20,15,1
SBI12SLO7071505,23,28,27,1,1
SBI04FNA2616159,97,25,17,8,1
SBI48VMN4403776,64,31,16,15,1
SBI66EAQ6357824,23,22,21,1,1
SBI17TMB9320474,89,25,13,12,1
SBI31NMM1819611,68,31,24,7,1
SBI78TRJ6410226,18,31,24,7,1
SBI09LGP8964906,75,25,14,11,1
SBI15CYR2506018,81,17,16,1,1
SBI83CMC6565975,19,22,16,6,1
SBI58YNN6165594,87,23,19,4,1
SBI50LRI1827454,85,21,15,6,1
SBI93MVC1695437,82,30,22,8,1
SBI79JFE1269552,64,18,17,1,1
SBI35SSQ4870854,70,24,21,3,1
SBI08IVZ1749687,66,19,17,2,1
SBI28VCA2481197,93,29,17,12,1
SBI10WCQ2653262,76,22,13,9,1
SBI40WKD9320608,91,27,15,12,1
SBI85YTN8594359,78,22,21,1,1
SBI05WOZ6505544,83,29,22,7,1
SBI00RTT7037210,18,29,21,8,1
SBI62YNP5220584,93,21,13,8,1
SBI08TQS4955983,67,25,13,12,1
SBI48WHY8277805,83,28,15,13,1
SBI68RGW3382189,82,25,17,8,1
SBI79QNY4651991,93,26,15,11,1
SBI08ZSQ3019607,79,27,16,11,1
SBI79URM4716479,22,18,12,6,1
SBI40FXA6430769,22,24,22,2,1
SBI55XTW3051175,88,26,17,9,1
SBI97VNE3077537,66,28,18,10,1
SBI58IID3793658,87,20,18,2,1
SBI53QYF9144276,20,21,15,6,1
SBI90TIG3264162,95,29,24,5,1
SBI26RAB8651967,75,25,21,4,1
SBI75SUM1504408,61,27,23,4,1
SBI83WPW8904849,80,23,14,9,1
SBI89LZX0168247,83,33,25,8,1
SBI78WRT6884018,61,12,8,4,1
SBI84QGJ9174668,22,20,12,8,1
SBI25MXA8014545,90,25,24,1,1
SBI48GXL0640958,85,33,26,7,1
SBI00EPU0959111,64,20,14,6,1
SBI35TIE4741519,18,20,12,8,1
SBI96NOD7386154,92,15,10,5,1
SBI64FFW5627480,86,22,19,3,1
SBI70NCV6362669,65,18,14,4,1
SBI89NIL9231059,91,26,19,7,1
SBI72BKK2727069,91,13,7,6,1
SBI63OTU7831332,65,31,27,4,1
SBI88WSJ3542682,22,23,21,2,1
SBI89THV8350362,95,26,18,8,1
SBI27HSO7481272,60,23,16,7,1
SBI03LFU2619678,92,22,19,3,1
SBI51WWE5308582,69,27,18,9,1
SBI70FDC7956799,80,31,23,8,1
SBI03UFB1587261,77,17,14,3,1
SBI15YXD1586636,80,30,27,3,1
SBI71ADO8577488,99,19,12,7,1
SBI60HEN9261914,66,27,14,13,1
SBI32YJR2528836,66,23,12,11,1
SBI42NPW8850535,77,20,16,4,1
SBI76BWS9714714,93,19,12,7,1
SBI11SNN4750513,79,34,30,4,1
SBI85KPH4721115,23,24,19,5,1
SBI92CYN4957021,83,26,21,5,1
SBI72UJP2475971,80,21,19,2,1
SBI23RZE2921128,24,25,19,6,1
SBI84YZN6541105,97,24,15,9,1
SBI16FTC3062784,77,27,14,13,1
SBI93UWN6217772,68,26,20,6,1
SBI65EGL7461676,91,17,9,8,1
SBI04VJN8261467,82,29,24,5,1
SBI60QPB3414180,92,25,13,12,1
SBI18BQY8021823,78,23,13,10,1
SBI63DRD9583215,24,31,29,2,1
SBI53UGU5990496,70,25,16,9,1
SBI79JUL0031715,78,24,17,7,1
SBI36MIM8811559,20,19,14,5,1
SBI61UDI8490055,86,29,24,5,1
SBI37EZX8713067,23,34,31,3,1
SBI30FMZ3568068,72,23,15,8,1
SBI54SEI4435675,80,15,12,3,1
SBI85OMM9960384,69,35,32,3,1
SBI20DME2109757,87,23,14,9,1
SBI13HNF6325512,91,13,12,1,1
SBI57PSE6180127,20,24,16,8,1
SBI19AJT6063197,21,21,15,6,1
SBI03PBJ3999512,69,25,15,10,1
SBI78LXJ1090772,95,27,15,12,1
SBI24BNU4368712,69,15,10,5,1
SBI09FLT5327325,84,30,16,14,1
SBI37EXQ2282558,93,23,21,2,1
SBI51OQL9435183,68,32,31,1,1
SBI10QJT9473537,97,21,12,9,1
SBI43DJV0560494,81,32,28,4,1
SBI36LDW0373002,80,25,23,2,1
SBI88VEH5110179,90,28,27,1,1
SBI97VSR5386457,90,25,23,2,1
SBI53PEY8127920,84,24,18,6,1
SBI26CNU8785191,68,23,19,4,1
SBI52SJI5163220,94,31,18,13,1
SBI57JPM6219214,66,26,24,2,1
SBI88VVF3867391,25,22,19,3,1
SBI21LYE9550346,73,27,26,1,1
SBI48AHE8437622,69,19,15,4,1
SBI03QPM7239933,94,31,21,10,1
SBI65ZRG7810131,86,22,18,4,1
SBI12RWA4471656,67,24,20,4,1
SBI08CYO7097873,96,24,22,2,1
SBI85QKX8376403,66,13,11,2,1
SBI01NGO5833765,20,29,26,3,1
SBI65PMD4521381,76,21,12,9,1
SBI23TXH5941576,75,31,28,3,1
SBI85HAD4452214,81,30,27,3,1
SBI98BAM8536354,22,25,17,8,1
SBI24ZLJ2397236,99,18,12,6,1
SBI70UVY3619383,24,27,21,6,1
SBI23PTL5083965,83,25,24,1,1
SBI70MRB3330812,76,23,18,5,1
SBI42ULK3936702,18,29,17,12,1
SBI07TKJ4336910,61,25,19,6,1
SBI10ZEG8849786,81,18,15,3,1
SBI73GCK8610918,86,32,28,4,1
SBI58EVN4147442,78,25,21,4,1
SBI71LGV4823942,69,28,19,9,1
SBI56NVZ9197368,98,31,19,12,1
SBI41BJF3488245,99,21,19,2,1
SBI07ZWF2058296,97,27,19,8,1
SBI08JPR5968507,96,22,20,2,1
SBI28MNI8097787,60,29,18,11,1
SBI31NCI4945491,91,20,19,1,1
SBI66TVG2752622,94,27,21,6,1
SBI08MBP8497248,23,31,25,6,1
SBI49NHQ6171674,87,19,10,9,1
SBI43RZE1389453,61,18,13,5,1
SBI05GRV5239174,64,25,23,2,1
SBI45ERZ2949445,61,23,20,3,1
SBI52WKA6588203,69,23,14,9,1
SBI40YVF6634080,19,27,16,11,1
SBI87ZGF3202470,84,26,18,8,1
SBI98BJG6805597,96,24,21,3,1
SBI29UTH5081940,97,20,16,4,1
SBI40TKN8924533,84,27,26,1,1
SBI99KMP2338486,67,21,16,5,1
SBI17HGO1658875,85,23,12,11,1
SBI89ECP6122214,93,20,15,5,1
SBI06DNF6479982,97,17,16,1,1
SBI58UJX4280985,64,27,18,9,1
SBI29GLM3646124,94,27,19,8,1
SBI87BAD0883699,91,20,14,6,1
SBI09PVR4924259,71,24,17,7,1
SBI85GLD7349137,21,25,24,1,1
SBI31XLD2523555,97,17,10,7,1
SBI49ZQO4031227,99,24,22,2,1
SBI24FFZ8840511,68,27,21,6,1
SBI35FNY5151115,64,25,18,7,1
SBI34PYE4315767,82,23,21,2,1
SBI97WBG9451865,63,21,13,8,1
SBI56GOQ5419785,84,23,15,8,1
SBI76TQH7854269,25,32,22,10,1
SBI93EFB3547030,65,28,19,9,1
SBI54AEN3157440,21,22,21,1,1
SBI53BRX3261784,84,19,12,7,1
SBI85JBW2912496,19,29,18,11,1
SBI55SZF0438892,78,21,16,5,1
SBI59OUG0915848,98,23,17,6,1
SBI96BCX6173474,84,27,17,10,1
SBI41MFQ7279210,96,17,15,2,1
SBI24FIC5606611,86,22,19,3,1
SBI71WFG2509830,64,18,14,4,1
SBI95CMN2403956,92,29,15,14,1
SBI53GQL3420580,20,25,15,10,1
SBI07EBR0595558,21,17,11,6,1
SBI98IPK0380574,76,30,20,10,1
SBI07JKK0288807,82,27,25,2,1
SBI59CBY4974085,75,25,17,8,1
SBI97CMN4866465,24,30,20,10,1
SBI36HRO6464566,76,24,21,3,1
SBI21NDX1099961,72,32,29,3,1
SBI93AFE6546382,94,36,32,4,1
SBI18AFT7403702,21,32,25,7,1
SBI72PTB9365662,72,25,20,5,1
SBI33YCL9977306,79,27,16,11,1
SBI09UAZ3159179,87,27,17,10,1
SBI11IOC5603994,19,29,19,10,1
SBI22LTM3492130,91,18,16,2,1
SBI75QNG2764350,77,31,22,9,1
SBI31VHL1342465,77,26,24,2,1
SBI63CNV9201124,22,19,14,5,1
SBI58IEE0623646,68,27,21,6,1
SBI62ZUK8141021,65,22,14,8,1
SBI79VDC4796345,24,37,32,5,1
SBI81NXR3876716,99,20,11,9,1
SBI45TQS2755361,97,26,16,10,1
SBI02ZKR7540106,79,17,10,7,1
SBI95WXZ3896315,22,24,14,10,1
SBI59RAT1890299,80,19,16,3,1
SBI88FEG3975006,25,17,14,3,1
SBI56XCC3643201,74,23,18,5,1
SBI90KCH8090857,62,28,16,12,1
SBI05RLZ0005533,75,20,18,2,1
SBI22TQZ5951657,95,26,15,11,1
SBI17KOU2778810,81,25,21,4,1
SBI28FIT0893129,83,18,12,6,1
SBI57GRH1607337,97,34,24,10,1
SBI62OYK0091465,86,25,14,11,1
SBI29AVL5774354,66,19,14,5,1
SBI10ATX7395978,86,21,13,8,1
SBI33UJP9685921,97,23,18,5,1
SBI50SMU1917566,20,29,25,4,1
SBI96BMY6812787,25,26,16,10,1
SBI50CLF8921351,99,17,10,7,1
SBI31YOE9497147,73,10,7,3,1
SBI75GRU3242014,63,21,11,10,1
SBI41YXR3057588,98,25,20,5,1
SBI80FTP0886028,81,20,14,6,1
SBI02SVM2922134,23,25,22,3,1
SBI78YGS1694670,75,21,12,9,1
SBI54MML3960369,90,20,16,4,1
SBI36EAD2372680,96,29,20,9,1
SBI19VSI0670147,88,31,25,6,1
SBI57MQJ7410082,76,28,17,11,1
SBI31TGR9947597,98,29,21,8,1
SBI35SAR5612484,22,19,18,1,1
SBI48HLC0655684,24,26,19,7,1
SBI93TFX0093401,73,23,15,8,1
SBI44TGL1648737,60,22,13,9,1
SBI80FYV4711607,65,24,23,1,1
SBI87BDI2270858,96,20,17,3,1
SBI19JXR5715150,77,21,19,2,1
SBI76JPW9471877,82,20,18,2,1
SBI69CSR9084288,22,23,19,4,1
SBI65XSA8154710,69,20,17,3,1
SBI62WMP8570439,84,19,10,9,1
SBI88DFZ6176501,81,26,23,3,1
SBI22GVS3921368,75,26,23,3,1
SBI33UAT9486313,79,23,12,11,1
SBI85PSP5253457,65,28,27,1,1
SBI11MUF9316021,67,27,23,4,1
SBI36PJZ7462653,76,19,11,8,1
SBI21VFP5377482,75,30,17,13,1
SBI07OQW2343668,89,20,13,7,1
SBI63JOT4517117,81,23,15,8,1
SBI30HNO0347803,83,28,19,9,1
SBI82UFF7448653,67,19,13,6,1
SBI07OHE3619626,18,15,13,2,1
SBI03NAG1577162,25,29,25,4,1
SBI03NUG8390843,22,28,19,9,1
SBI19MTS3870610,81,30,16,14,1
SBI76TXP8234518,86,21,13,8,1
SBI89QFO0210462,75,18,14,4,1
SBI88XOG1384815,79,22,21,1,1
SBI78KLY2024280,85,23,22,1,1
SBI64EYI0010231,64,24,13,11,1
SBI44LDP1655988,76,18,14,4,1
SBI90PIQ2561394,69,24,21,3,1
SBI67QXI2367074,78,15,14,1,1
SBI70QDF2391658,88,18,13,5,1
SBI95OIN8306069,84,21,19,2,1
SBI33EFC1257135,65,32,30,2,1
SBI84ECF3170247,64,25,19,6,1
SBI20BYT2677278,96,23,17,6,1
SBI82ZEF0156376,62,20,15,5,1
SBI68EKF8878393,79,24,19,5,1
SBI13NXD3253156,87,19,14,5,1
SBI28EJS7723068,81,20,11,9,1
SBI35DZP4202906,67,25,24,1,1
SBI86ZLF7687890,88,20,15,5,1
SBI14GOQ6623020,63,31,26,5,1
SBI61ZEF8359239,65,21,15,6,1
SBI77KDR9330244,87,14,13,1,1
SBI56JDV2876949,24,29,16,13,1
SBI67TSU3237813,72,29,27,2,1
SBI65VLT2371188,90,24,19,5,1
SBI13LDR5730788,97,26,20,6,1
SBI13VNQ8529007,24,24,16,8,1
SBI30FBF7302673,79,21,20,1,1
SBI52QSR8852211,91,26,20,6,1
SBI00NSM7945910,71,32,17,15,1
SBI92PKI6087363,66,17,13,4,1
SBI68SYX1555083,63,9,5,4,1
SBI11ZTU2966676,67,28,25,3,1
SBI86GWJ1449251,89,27,16,11,1
SBI87GLZ2621426,70,29,19,10,1
SBI83FLC7364632,67,25,21,4,1
SBI60CQW3419913,25,23,15,8,1
SBI30VOK7396213,81,26,19,7,1
SBI44IRA5484591,87,24,16,8,1
SBI35CKD1482876,63,27,15,12,1
SBI89AAZ2107733,78,24,17,7,1
SBI75MRN7737156,79,28,21,7,1
SBI35NVG9108182,74,21,17,4,1
SBI32XEI9272325,25,26,18,8,1
SBI66LTT0047642,25,23,16,7,1
SBI81DMA6812556,71,23,22,1,1
SBI01QOJ8266185,20,29,20,9,1
SBI85VXA3371637,69,26,19,7,1
SBI96NCF8415219,78,19,16,3,1
SBI62MNY4864108,62,18,12,6,1
SBI87EAR4237858,98,27,15,12,1
SBI57WUY8024222,65,19,13,6,1
SBI96SKI8919481,88,30,27,3,1
SBI11ODO4974545,80,13,11,2,1
SBI83VHU2549423,62,24,21,3,1
SBI67IEG7159217,69,36,32,4,1
SBI69NSW9607761,86,23,19,4,1
SBI89DEZ8460203,19,18,17,1,1
SBI01RUL9038457,65,28,21,7,1
SBI71CUV1377160,66,28,19,9,1
SBI66AFE7316326,60,15,13,2,1
SBI79AKA5134541,64,23,15,8,1
SBI64LOT6131477,66,31,30,1,1
SBI76PFF4987561,90,16,9,7,1
SBI43XHU3588640,65,23,17,6,1
SBI05JDW2424675,69,14,11,3,1
SBI57PKR8318405,86,25,17,8,1
SBI82IBM7079920,81,28,24,4,1
SBI85VFX2678709,61,16,13,3,1
SBI99VKC8910844,88,13,7,6,1
SBI53ASC2067348,74,18,11,7,1
SBI51FPL4591839,84,32,20,12,1
SBI13IJB1407676,78,17,15,2,1
SBI37CYG7457576,19,26,22,4,1
SBI08OLU5705137,80,32,17,15,1
SBI15HRK7798002,21,29,22,7,1
SBI41ASJ4710223,86,27,25,2,1
SBI93CSJ2077712,93,29,17,12,1
SBI61IOW0395421,19,25,17,8,1
SBI41JGX9148121,75,24,22,2,1
SBI08BGK7048009,25,21,15,6,1
SBI86YNR0783267,60,21,18,3,1
SBI55VSN0770412,80,18,14,4,1
SBI76KNC5327811,79,19,16,3,1
SBI64NJW0688227,21,33,24,9,1
SBI39IRE8970891,79,25,14,11,1
SBI37YYX5502108,78,27,20,7,1
SBI81CPH3317011,74,19,12,7,1
SBI83PVC9194504,98,27,20,7,1
SBI28IFM4053819,22,26,20,6,1
SBI15OVH5353972,86,18,10,8,1
SBI15UPL6277604,21,28,24,4,1
SBI97QWB0998747,92,22,14,8,1
SBI14BXK3021263,67,28,20,8,1
SBI08KCZ4505586,83,22,20,2,1
SBI71PXK1657634,19,22,17,5,1
SBI52KEZ6361505,75,24,18,6,1
SBI39XMY1099579,98,27,21,6,1
SBI75ATQ2153327,83,27,20,7,1
SBI27FLY2826725,87,33,30,3,1
SBI10KJA3783113,63,31,23,8,1
SBI45PEX5000366,77,21,13,8,1
SBI44XXD1067523,67,23,18,5,1
SBI98RSQ4432422,93,16,9,7,1
SBI44TFU9255349,64,20,16,4,1
SBI72JOL0096498,61,24,23,1,1
SBI78WTB8764409,91,29,17,12,1
SBI74ZYE9957524,74,21,17,4,1
SBI79JAM6972843,91,21,13,8,1
SBI09PDK9027487,81,32,19,13,1
SBI99JYO8003324,97,23,21,2,1
SBI12TKX8197408,25,24,14,10,1
SBI94PVJ2313417,68,16,9,7,1
SBI46LJO8140135,62,23,12,11,1
SBI93BDL1502582,89,23,20,3,1
SBI20PVI3597118,88,18,17,1,1
SBI30EPS8849515,79,29,21,8,1
SBI72BBV4754408,77,35,20,15,1
SBI95QVQ0362695,21,26,20,6,1
SBI87AQD8129416,86,32,25,7,1
SBI86NHN5603642,74,26,16,10,1
SBI01QNW8475902,75,29,16,13,1
SBI90GND3795000,96,30,18,12,1
SBI10YIK1860669,68,29,16,13,1
SBI75MWO5167266,90,34,22,12,1
SBI92NEZ9429714,78,22,13,9,1
SBI55OKV6057800,19,26,18,8,1
SBI64PVD3744297,79,19,11,8,1
SBI19WNH6073838,66,27,19,8,1
SBI12LEL8299356,76,25,23,2,1
SBI81ANN6966800,92,23,14,9,1
SBI18ITM3694188,92,25,20,5,1
SBI06YDH8999290,69,16,15,1,1
SBI19GVB7308478,89,23,22,1,1
SBI21OMH2132806,90,33,30,3,1
SBI42WDA5599662,87,24,18,6,1
SBI05CKL4753830,81,33,30,3,1
SBI12UZY0812434,75,23,18,5,1
SBI32NPX0697854,67,24,15,9,1
SBI88DUE2919262,70,29,26,3,1
SBI34AWJ1505644,78,26,22,4,1
SBI76EIX4906371,67,22,12,10,1
SBI66UPX8236633,71,33,18,15,1
SBI77CCP8364499,76,27,17,10,1
SBI57OYA4936616,25,28,25,3,1
SBI43QIK1611647,96,29,23,6,1
SBI58UDI5878043,60,28,15,13,1
SBI24WZV6849287,21,20,11,9,1
SBI54JJO9250782,93,29,24,5,1
SBI00UYD6206258,66,28,18,10,1
SBI99QLF3807399,25,29,15,14,1
SBI96UUA6725970,23,15,9,6,1
SBI87UOG1397755,71,15,8,7,1
SBI74SYF8083201,75,24,23,1,1
SBI38HRM1128646,88,16,13,3,1
SBI85JMN7631901,67,21,18,3,1
SBI31ZZS6460623,66,30,24,6,1
SBI49XIM8445629,72,31,26,5,1
SBI03AZA3165511,98,33,18,15,1
SBI31MJG0739727,23,24,21,3,1
SBI25OAU1909830,71,31,26,5,1
SBI54WIH2763231,64,25,22,3,1
SBI34RCG7437766,64,28,24,4,1
SBI53AGJ8394440,75,34,26,8,1
SBI53GZD3859633,60,19,14,5,1
SBI56JIF1851322,76,18,17,1,1
SBI12FVE5832426,91,15,11,4,1
SBI18FJG2761178,65,21,13,8,1
SBI87CID2870547,25,29,25,4,1
SBI17OFD9160777,85,26,14,12,1
SBI84UIE9347672,88,21,19,2,1
SBI79WXF5574662,20,28,23,5,1
SBI20VPG8970117,79,18,16,2,1
SBI94LCP8132257,90,32,17,15,1
SBI99EVF1984579,89,20,11,9,1
SBI14MVQ5660570,89,32,25,7,1
SBI20TCB0272141,72,24,17,7,1
SBI54CCC3947213,23,24,17,7,1
SBI74FRN6074541,65,14,12,2,1
SBI15ZEB2111678,99,24,13,11,1
SBI46PXL0136921,20,26,17,9,1
SBI77IEY7462065,22,28,23,5,1
SBI60KNZ7376030,97,13,7,6,1
SBI34ZCB9821720,80,28,26,2,1
SBI66TAE0564664,21,24,19,5,1
SBI62OPY7625615,71,26,20,6,1
SBI63UWK6167632,85,29,25,4,1
SBI51JCC5317112,90,29,28,1,1
SBI34XRU2936970,98,11,10,1,1
SBI18AJK2000294,83,30,25,5,1
SBI43ZYG1788717,77,22,13,9,1
SBI07LOP5374220,61,21,19,2,1
SBI06FCW7667581,74,32,31,1,1
SBI73ULR4842041,18,32,26,6,1
SBI40LLP0071700,94,28,21,7,1
SBI60EJE7680586,80,26,15,11,1
SBI90VUX6709810,84,19,13,6,1
SBI04OFA6448820,25,24,23,1,1
SBI99RBK5451584,60,30,28,2,1
SBI54CTS5377340,63,23,14,9,1
SBI59XKP8455886,73,21,17,4,1
SBI47BTN4104657,95,25,21,4,1
SBI15JZY9541244,74,33,25,8,1
SBI80XDH9780672,65,29,27,2,1
SBI28USI7501377,84,33,23,10,1
SBI53KXL5878348,65,24,17,7,1
SBI81HKT9528317,93,19,16,3,1
SBI99TCK9367371,19,21,18,3,1
SBI08CHD2726250,70,29,25,4,1
SBI23FIP8206350,77,23,18,5,1
SBI19ECO3352326,21,33,26,7,1
SBI09YSA5451111,21,28,15,13,1
SBI92VUI1841485,21,24,20,4,1
SBI24JMO5862894,20,33,17,16,1
SBI38ZLS8662547,72,24,16,8,1
SBI12BDW5398615,90,27,23,4,1
SBI73ORY7271735,22,23,15,8,1
SBI35RSF0926923,24,23,22,1,1
SBI33SSR0409232,19,23,12,11,1
SBI64AWW5410291,73,17,12,5,1
SBI88EBK4381872,75,30,21,9,1
SBI02GQF7570765,99,19,15,4,1
SBI33EEA3945105,20,24,23,1,1
SBI83DPQ4378290,98,18,14,4,1
SBI53EOH1358317,78,20,16,4,1
SBI04KLH0370655,86,31,20,11,1
SBI75ONN4666350,78,21,17,4,1
SBI87CZY2723073,61,28,21,7,1
SBI46FQF0093666,61,27,16,11,1
SBI30CUE8579083,72,15,14,1,1
SBI93YDT3086527,94,22,19,3,1
SBI35CYJ3892382,68,17,10,7,1
SBI95KCN0981495,73,30,23,7,1
SBI50AVN5834086,91,23,18,5,1
SBI55ENS7779184,68,24,16,8,1
SBI13TSI5086839,81,27,14,13,1
SBI54KOA8306307,19,17,9,8,1
SBI90ITJ9689804,18,23,15,8,1
SBI24ING0638125,70,23,16,7,1
SBI50PWO3662308,86,31,26,5,1
SBI06FGR0048214,88,28,21,7,1
SBI65IYI1686162,78,26,16,10,1
SBI13UOF6242044,79,27,16,11,1
SBI69AQR1047620,98,34,21,13,1
SBI76WXG4655516,97,18,14,4,1
SBI31ZAM6446639,86,25,19,6,1
SBI72MNX0648902,86,28,25,3,1
SBI03DIE6473185,69,24,17,7,1
SBI10WYL8907661,63,23,17,6,1
SBI09XOQ8557691,66,23,12,11,1
SBI88HQR5135265,68,25,20,5,1
SBI01NYX4126008,88,27,17,10,1
SBI11FSL5719956,24,23,22,1,1
SBI97NJS4753123,81,33,28,5,1
SBI16APK2657365,65,21,17,4,1
SBI92ZCL7494427,64,25,24,1,1
SBI83AEE9955291,62,17,15,2,1
SBI88QYI3921376,68,30,22,8,1
SBI03SWP9936858,83,28,25,3,1
SBI72KKA5647502,97,27,20,7,1
SBI66EIZ0311977,91,16,12,4,1
SBI93REV7335541,92,24,13,11,1
SBI50TXF1828013,72,21,19,2,1
SBI71HCF6254706,82,33,31,2,1
SBI51SWQ5601972,82,28,27,1,1
SBI42ITV7250453,71,27,20,7,1
SBI96FFZ3296228,23,24,14,10,1
SBI80UNH2486315,92,14,11,3,1
SBI72GKP6836413,86,26,14,12,1
SBI36RGP7626720,91,18,17,1,1
SBI96ARU6723174,95,22,17,5,1
SBI20VVW2612897,96,30,28,2,1
SBI00WIH2272335,96,22,19,3,1
SBI63UDJ0703102,99,27,16,11,1
SBI24RNC8066976,91,29,28,1,1
SBI61ESN6650866,61,31,17,14,1
SBI49SDB0614319,24,25,13,12,1
SBI03QZH7315734,68,24,17,7,1
SBI39CCZ7681099,75,32,23,9,1
SBI28DPI0418615,64,31,22,9,1
SBI72TCW3042876,21,23,19,4,1
SBI77ZPM4325839,85,27,14,13,1
SBI37KBL6195860,75,24,15,9,1
SBI21FTB6164100,93,24,20,4,1
SBI52RJJ6461756,21,27,23,4,1
SBI69DGY7419615,82,27,22,5,1
SBI07EOY7430018,21,17,13,4,1
SBI52IZL1423103,18,17,11,6,1
SBI19WXK0153680,92,20,14,6,1
SBI26HJD3015805,82,25,20,5,1
SBI91GBM7423642,23,27,21,6,1
SBI50HJI7165203,63,16,15,1,1
SBI05OUI1311820,77,22,13,9,1
SBI71QYZ3439127,67,29,20,9,1
SBI49GOV0186384,80,26,14,12,1
SBI89DZT2487781,61,25,18,7,1
SBI99NJO4801521,97,24,18,6,1
SBI23XZX7887149,96,19,15,4,1
SBI11TVS3322879,19,22,17,5,1
SBI73GHA4670982,97,22,21,1,1
SBI35QBK2063011,87,28,25,3,1
SBI20CHZ2875318,18,27,18,9,1
SBI76YDU8045676,80,29,24,5,1
SBI71RWA7211696,76,25,17,8,1
SBI43QLS8711335,97,27,21,6,1
SBI98HUJ3941111,66,26,24,2,1
SBI69XMU5807732,94,21,19,2,1
SBI96FUI6972130,89,11,7,4,1
SBI33HRI4835263,99,29,19,10,1
SBI38IXG3275735,64,19,10,9,1
SBI34TNQ7994951,95,21,15,6,1
SBI08GWZ1687738,67,23,22,1,1
SBI35UYJ4380027,96,17,10,7,1
SBI24FPB5233539,23,24,21,3,1
SBI11TYN2375426,86,24,19,5,1
SBI76CWW9476897,88,26,25,1,1
SBI94KIQ5672648,25,20,11,9,1
SBI19VSI4909410,77,22,14,8,1
SBI52EGL8914146,91,22,16,6,1
SBI83POR0350633,23,23,21,2,1
SBI43BJS1104275,94,24,13,11,1
SBI73UQJ3097095,70,21,14,7,1
SBI59OHK0779974,91,27,22,5,1
SBI97YLD3998182,83,29,15,14,1
SBI49PJF3653085,89,24,16,8,1
SBI81VPP7028795,68,24,23,1,1
SBI40RQR2455766,20,33,21,12,1
SBI58BUH7981845,99,25,22,3,1
SBI50KBR0230423,97,27,14,13,1
SBI52QEW6902833,25,23,18,5,1
SBI56FHZ3193508,22,25,18,7,1
SBI99EON0590911,86,20,18,2,1
SBI95FNF1368064,86,24,16,8,1
SBI69TYX7285898,87,17,15,2,1
SBI24PHF2059922,63,28,20,8,1
SBI73BVM0827787,22,20,11,9,1
SBI43MMM0926186,68,27,21,6,1
SBI07UAT6404144,18,22,13,9,1
SBI43GUO1882103,99,24,13,11,1
SBI81UJP6981721,93,24,17,7,1
SBI58VHX6287980,72,30,25,5,1
SBI20HOL2386522,85,24,15,9,1
SBI72DDZ2737753,82,25,23,2,1
SBI03DFZ6906602,84,17,11,6,1
SBI36SSX4012425,69,14,9,5,1
SBI51WPL6527953,23,24,16,8,1
SBI98JYH1850607,63,32,30,2,1
SBI66APM9486284,91,39,30,9,1
SBI64LHT5729489,95,23,20,3,1
SBI06KSD4037056,91,23,22,1,1
SBI78HVE5185971,89,27,17,10,1
SBI50GTZ7427355,71,26,17,9,1
SBI79TCQ7098119,98,18,17,1,1
SBI48YQR2787837,25,13,10,3,1
SBI77NOG1624732,68,28,15,13,1
SBI80CAF9296745,67,24,21,3,1
SBI72ZVZ4114447,71,31,17,14,1
SBI82UHQ9781138,77,16,13,3,1
SBI40VOJ2011643,20,22,20,2,1
SBI98CWV6041429,18,16,13,3,1
SBI03OCX5566230,73,27,24,3,1
SBI63FCP1518436,76,21,19,2,1
SBI30NII3320711,64,17,9,8,1
SBI27TVK7300027,60,29,19,10,1
SBI53ZOV0613913,79,25,24,1,1
SBI37UQY1022426,80,19,14,5,1
SBI56ZPO6675489,91,27,22,5,1
SBI02MLV0804050,65,22,14,8,1
SBI58VUV5107647,69,26,19,7,1
SBI31CYI6298418,73,24,18,6,1
SBI11LOR0959811,90,26,23,3,1
SBI17PYV0684182,25,23,13,10,1
SBI59JDE3582723,92,29,26,3,1
SBI12ESY6011610,67,27,16,11,1
SBI06CLU6191810,64,32,27,5,1
SBI88QGK3814671,75,21,11,10,1
SBI74LEC0488523,98,19,17,2,1
SBI01XZU1546488,75,24,21,3,1
SBI29NEY3941730,95,30,27,3,1
SBI17YWI1040450,67,25,24,1,1
SBI10EKX9142532,76,23,17,6,1
SBI82HDF1314363,73,24,22,2,1
SBI67OVV2304616,87,29,28,1,1
SBI20DGS5943924,86,27,25,2,1
SBI66PJD4422207,85,26,20,6,1
SBI42NZM8088349,75,37,32,5,1
SBI15KFW0511552,65,24,21,3,1
SBI83TEW3661696,72,27,19,8,1
SBI70BCR8667303,19,24,16,8,1
SBI80SDU3692121,91,26,16,10,1
SBI23PXY4535833,70,19,17,2,1
SBI37XQR6208986,93,20,13,7,1
SBI62HSI7722557,23,17,14,3,1
SBI30FPG7545117,20,14,9,5,1
SBI77XGR4532537,90,25,24,1,1
SBI87PEC1810179,87,24,18,6,1
SBI47JLY1442196,79,28,15,13,1
SBI33BOL2841962,98,16,13,3,1
SBI48DQG3676136,19,26,17,9,1
SBI89AUL1009147,86,21,17,4,1
SBI55KQN9669539,87,25,22,3,1
SBI24VLE5564664,67,20,13,7,1
SBI83WTG6509453,65,23,12,11,1
SBI15ITV0817530,98,18,17,1,1
SBI27XLX6671152,19,28,19,9,1
SBI85BXB2295459,78,24,20,4,1
SBI81PBA7364045,79,24,21,3,1
SBI43DYK5142117,20,16,9,7,1
SBI30ADN5523603,23,27,16,11,1
SBI27LDU5319094,84,32,31,1,1
SBI19PHJ0171251,71,22,16,6,1
SBI91PLP6639693,96,27,17,10,1
SBI69DLH3847430,85,26,18,8,1
SBI00WKW4866336,92,27,15,12,1
SBI32EMF6842949,20,24,20,4,1
SBI34NHI5514046,18,19,16,3,1
SBI43WZU7043324,25,20,13,7,1
SBI54VWF8858653,60,19,17,2,1
SBI62WAZ7594646,64,20,18,2,1
SBI92DDE2375760,66,22,13,9,1
SBI62VUM1130953,19,32,21,11,1
SBI32UXT7367412,97,26,24,2,1
SBI72XSM6221758,78,28,20,8,1
SBI00SVF8415928,61,24,23,1,1
SBI45BQT1832716,77,21,17,4,1
SBI29TDB4809764,66,35,21,14,1
SBI12NUP6804213,67,22,18,4,1
SBI65YPL2325340,93,23,12,11,1
SBI69MDD4631165,94,20,11,9,1
SBI58TRW9746247,62,20,11,9,1
SBI84CMT6858924,67,23,22,1,1
SBI05TSE2875641,94,17,9,8,1
SBI61WMV6778901,94,22,14,8,1
SBI58ZHC8364307,81,32,17,15,1
SBI80QYZ9026204,82,23,21,2,1
SBI80RMG4296081,78,20,12,8,1
SBI22GQY2379042,74,29,27,2,1
SBI93RVP9157634,91,22,21,1,1
SBI58IGK5335271,79,30,23,7,1
SBI22OOV1429975,94,22,19,3,1
SBI32LFB2047090,73,20,12,8,1
SBI90OBC2090291,21,28,18,10,1
SBI19PVY9822451,90,27,16,11,1
SBI32LKC7906310,93,20,14,6,1
SBI56DLV7257612,84,26,25,1,1
SBI53DWG2533452,73,20,17,3,1
SBI03GTQ3013324,98,21,18,3,1
SBI85AZK0999470,76,34,33,1,1
SBI58IRR5826263,22,22,17,5,1
SBI63RGO3784309,60,25,14,11,1
SBI33DXL0067668,83,18,14,4,1
SBI17WWI8112588,23,25,16,9,1
SBI82GYF9736164,66,19,15,4,1
SBI00MVR2944522,68,29,18,11,1
SBI04WLE2724636,93,30,28,2,1
SBI66DQR1434231,84,26,17,9,1
SBI24JZM3108494,98,27,14,13,1
SBI05UHL4857522,81,29,22,7,1
SBI54HTU0514272,61,22,16,6,1
SBI88SXY9055849,25,26,17,9,1
SBI39AAY4084851,99,27,17,10,1
SBI55YTN7432576,75,21,19,2,1
SBI57IQR5559381,88,31,16,15,1
SBI24GVS2458531,71,24,13,11,1
SBI39DRW8503436,96,23,22,1,1
SBI07HAA0070385,20,20,16,4,1
SBI81VDR1639208,76,29,28,1,1
SBI19BJK5731832,78,24,13,11,1
SBI94QAG0825023,74,25,23,2,1
SBI22DUN4822975,64,21,16,5,1
SBI91HFG7618157,89,24,23,1,1
SBI13VEH6404693,62,20,19,1,1
SBI31FVI9102229,93,23,17,6,1
SBI79PIM0262843,64,13,12,1,1
SBI07RCK3470785,94,19,14,5,1
SBI61LYH8174749,86,29,26,3,1
SBI99PIB4437361,79,27,16,11,1
SBI54GZE5526373,63,17,9,8,1
SBI56BRC0613952,98,23,15,8,1
SBI73EYU0695629,92,17,11,6,1
SBI94BPL2174713,18,15,10,5,1
SBI66ZXT5665678,95,30,29,1,1
SBI44KAM3844614,82,27,20,7,1
SBI35DEJ7534436,25,26,14,12,1
SBI25NZN4310508,19,17,9,8,1
SBI52YKA1116104,64,30,23,7,1
SBI89BFT9238434,99,29,18,11,1
SBI96HPJ7960762,18,25,24,1,1
SBI29SQB7863610,62,23,19,4,1
SBI00KKZ6770472,79,23,20,3,1
SBI36BBZ7174571,97,27,26,1,1
SBI34LTH5767242,99,24,15,9,1
SBI38SWP5364660,99,39,33,6,1
SBI67XUP2883492,77,31,18,13,1
SBI08ENG9012907,81,30,25,5,1
SBI20WUS5096167,21,31,18,13,1
SBI59PLT5843594,78,23,20,3,1
SBI41ZSG7204458,66,28,24,4,1
SBI65XGJ1630743,66,15,12,3,1
SBI43MPL8866288,90,23,15,8,1
SBI31FQB3898883,86,29,26,3,1
SBI02HWQ7703231,75,22,14,8,1
SBI74MDO5311966,97,24,18,6,1
SBI25BTU7709716,99,27,16,11,1
SBI98SEU7578664,20,23,19,4,1
SBI95DCC8650191,62,27,17,10,1
SBI71ZBV8008515,19,29,16,13,1
SBI44RBG3786219,67,30,25,5,1
SBI50DQC2491911,19,25,21,4,1
SBI39EKN8786579,91,34,29,5,1
SBI04WOK3768270,83,25,21,4,1
SBI90ZAL8969483,74,23,17,6,1
SBI77AOR3573930,85,28,24,4,1
SBI13QYF4423486,73,31,30,1,1
SBI21UDM6274174,78,30,29,1,1
SBI52GMU7851516,21,12,9,3,1
SBI65ODZ2374277,89,31,23,8,1
SBI39MHV6449191,76,23,20,3,1
SBI21OWM5241540,97,27,17,10,1
SBI35PHP0919869,67,22,16,6,1
SBI94LRK4115622,63,19,14,5,1
SBI91BIW5492111,97,34,26,8,1
SBI94VRX3228342,76,34,19,15,1
SBI56AWQ3716097,77,30,23,7,1
SBI85MXT6558184,79,28,20,8,1
SBI53MRP8361886,24,28,27,1,1
SBI27HZP1127809,21,26,18,8,1
SBI02MLJ6663444,89,24,23,1,1
SBI80JQU1416901,80,29,17,12,1
SBI29XUL0421579,21,29,25,4,1
SBI40XOG5886450,19,28,22,6,1
SBI80KEK4651051,60,20,15,5,1
SBI03OJQ6266298,18,18,10,8,1
SBI45BWL4572153,23,17,9,8,1
SBI90CSX5469854,62,18,14,4,1
SBI95RZP4317174,69,26,21,5,1
SBI04YNL2843510,80,20,19,1,1
SBI13BMF0728504,22,21,15,6,1
SBI41YME9489824,81,22,13,9,1
SBI01SLE2627079,23,20,19,1,1
SBI75FVH5904857,93,29,16,13,1
SBI41BWB3896793,78,31,18,13,1
SBI56YQJ1189421,19,22,19,3,1
SBI54QUM3256846,24,28,17,11,1
SBI67WRR6871322,77,23,14,9,1
SBI19QUQ4274243,82,20,14,6,1
SBI55KEN3307403,82,32,21,11,1
SBI09STA0380195,79,28,18,10,1
SBI31OFJ3486720,86,26,20,6,1
SBI56UTD1597267,96,16,12,4,1
SBI37MPK0809788,19,29,20,9,1
SBI06DBY3091287,86,30,18,12,1
SBI83DYH4067320,23,23,18,5,1
SBI96MQD5462449,98,37,19,18,1
SBI84CER7076087,80,24,17,7,1
SBI56RZB1804425,89,27,19,8,1
SBI16MPH2525548,84,20,14,6,1
SBI66JNA6325850,94,32,23,9,1
SBI85UOY8721371,67,17,11,6,1
SBI39UMK3929509,99,27,19,8,1
SBI11IJA9257977,61,25,20,5,1
SBI64ZDF0016649,92,24,18,6,1
SBI37QWM2226513,24,35,18,17,1
SBI03DQE8147319,25,25,24,1,1
SBI57QUM4206949,96,34,32,2,1
SBI49YJI0983803,96,26,21,5,1
SBI56OTM3589650,68,33,29,4,1
SBI58GQV3976448,19,34,30,4,1
SBI43SVS2903267,89,22,13,9,1
SBI02GXQ0004177,60,21,13,8,1
SBI49RDX8435578,66,27,15,12,1
SBI69VQZ9862958,21,23,12,11,1
SBI58ESE9539307,89,24,21,3,1
SBI85ODL3781474,73,25,17,8,1
SBI61UDF7981525,78,17,13,4,1
SBI82UDO8041334,96,27,15,12,1
SBI29OCO7500280,83,28,26,2,1
SBI65TQZ9963472,87,30,18,12,1
SBI10FTD8902956,18,15,11,4,1
SBI77EZO5410965,72,27,24,3,1
SBI73WOU9275018,68,26,21,5,1
SBI87TQP3516498,22,26,25,1,1
SBI38FLW9641203,66,28,20,8,1
SBI72QSZ4164904,72,24,19,5,1
SBI75CTO7793548,63,12,10,2,1
SBI52UPM0916809,86,24,18,6,1
SBI92ABF8959694,68,22,16,6,1
SBI25PBG8920178,69,21,16,5,1
SBI62AKV8454377,62,23,17,6,1
SBI23XXJ7593640,88,28,18,10,1
SBI71ZNT3084728,64,20,16,4,1
SBI61YCD6762694,95,22,19,3,1
SBI19CPW9343567,18,24,15,9,1
SBI88HSZ1908003,63,24,17,7,1
SBI78UUG4342512,76,21,14,7,1
SBI74IWM1962964,22,28,27,1,1
SBI43TXY6369399,95,18,11,7,1
SBI90TSV2290321,69,26,20,6,1
SBI04ZRF4968759,99,26,23,3,1
SBI17JTS0187412,78,18,12,6,1
SBI39BML6869932,65,24,15,9,1
SBI13TJX3164229,82,24,18,6,1
SBI03FPT6955697,66,19,15,4,1
SBI48EJN0400710,82,19,15,4,1
SBI22BGG5930062,65,29,24,5,1
SBI99SPU3412817,90,11,7,4,1
SBI40BVA4248694,63,19,12,7,1
SBI90OWU9268796,70,26,14,12,1
SBI18ULQ5354127,93,18,13,5,1
SBI36SIW3242098,25,29,22,7,1
SBI31BRH5851505,68,32,21,11,1
SBI60RYR6677847,62,13,8,5,1
SBI22ECO7977858,68,24,15,9,1
SBI22XIH7429533,89,33,25,8,1
SBI18LJG2451813,77,27,15,12,1
SBI21SXY5214186,25,28,26,2,1
SBI11CPB2699497,21,22,20,2,1
SBI46GFQ1486283,88,26,19,7,1
SBI98MAH9207417,72,31,22,9,1
SBI74TYG1940317,74,24,23,1,1
SBI30CQG4974789,90,25,19,6,1
SBI08FZP2821079,90,34,28,6,1
SBI42PCC4151978,21,20,19,1,1
SBI57RID3140440,81,31,19,12,1
SBI43FXU8351436,66,22,17,5,1
SBI58DZY5202864,21,19,18,1,1
SBI83IXW8334408,25,24,20,4,1
SBI04ISH0879079,20,26,22,4,1
SBI63HNX6171898,75,27,23,4,1
SBI94GVL7041641,20,28,15,13,1
SBI92EWI9346084,74,21,13,8,1
SBI06ZVB2745335,89,26,17,9,1
SBI45CLP3352968,90,30,24,6,1
SBI75RZE1657301,18,24,14,10,1
SBI75PRQ1679990,71,17,13,4,1
SBI61VBK5435583,79,24,18,6,1
SBI10HOD5939857,24,17,12,5,1
SBI32YNG9651847,23,30,25,5,1
SBI36CLO4207250,93,24,19,5,1
SBI98ZZD2104533,20,27,25,2,1
SBI88KKH6454230,97,19,18,1,1
SBI94GOH3162944,99,30,16,14,1
SBI28XZS0589678,65,21,14,7,1
SBI48QMM0748596,99,26,22,4,1
SBI25UMJ3751767,74,23,22,1,1
SBI57ZWA9076895,98,28,17,11,1
SBI00VMX3239811,80,21,11,10,1
SBI32LYA0874003,97,29,24,5,1
SBI33BZU0344508,84,28,27,1,1
SBI89HXL8205697,65,30,16,14,1
SBI41FDQ8030044,67,22,15,7,1
SBI46BMZ5613875,92,29,20,9,1
SBI20FVV8609998,22,24,14,10,1
SBI37HFZ7202558,20,15,14,1,1
SBI99GAH8793608,78,28,17,11,1
SBI39PBC4714700,65,23,13,10,1
SBI23QJT8617619,65,25,21,4,1
SBI15YIP2744439,21,14,11,3,1
SBI72KLK3087150,66,25,14,11,1
SBI03TSG1336863,91,24,18,6,1
SBI56XQS6772491,61,24,14,10,1
SBI42ZYJ0513268,78,26,16,10,1
SBI95ATY6574584,99,25,23,2,1
SBI35BYC0040777,96,27,16,11,1
SBI35HLS4410131,67,34,30,4,1
SBI96NDX5534281,93,24,21,3,1
SBI92DAD8095663,63,27,26,1,1
SBI14DRM5589153,95,22,14,8,1
SBI56UXY4114786,81,21,18,3,1
SBI32WCR5341536,96,22,13,9,1
SBI51AON0595433,70,31,29,2,1
SBI86FVR1948056,90,29,20,9,1
SBI97WLD3739705,95,29,16,13,1
SBI22MYL9112351,96,28,25,3,1
SBI38TRE5723187,21,33,29,4,1
SBI24BCF8521553,77,24,17,7,1
SBI60KNS6322236,93,27,25,2,1
SBI52AMO5299737,71,18,15,3,1
SBI82YOS9808059,68,20,13,7,1
SBI09WXJ6231582,68,24,14,10,1
SBI11GZF6526867,67,23,15,8,1
SBI96OIW0526956,83,29,24,5,1
SBI72PYC8521774,71,31,16,15,1
SBI92SFH1367938,78,24,19,5,1
SBI87JGS7324375,69,32,17,15,1
SBI91AOQ9259241,93,21,11,10,1
SBI73JHA8921667,82,24,16,8,1
SBI37JYO7226866,60,34,21,13,1
SBI68CTE0503192,70,31,24,7,1
SBI06IQE2649822,96,28,21,7,1
SBI51ZOL3357376,99,35,31,4,1
SBI85KPG8489727,95,28,15,13,1
SBI47CJQ3970709,96,32,28,4,1
SBI02WWK4901888,70,29,26,3,1
SBI80KFL8689359,65,28,15,13,1
SBI02RAG0542509,93,19,16,3,1
SBI01TGW1013553,18,27,18,9,1
SBI71EKE2197350,84,21,14,7,1
SBI47GXZ1833023,82,20,18,2,1
SBI40FKH3008538,67,36,29,7,1
SBI44VSI0771962,82,23,20,3,1
SBI78RDH3744339,86,31,20,11,1
SBI61UUW6572443,82,28,19,9,1
SBI95NHU6035937,72,19,17,2,1
SBI61XRI7588727,72,18,16,2,1
SBI67LWQ3839671,78,27,22,5,1
SBI80EHM0919421,93,19,17,2,1
SBI09OVN9167456,77,29,19,10,1
SBI85GYD5589718,73,21,11,10,1
SBI28LJV3449008,91,21,11,10,1
SBI11IFF5072615,18,23,21,2,1
SBI62EJD1347481,91,23,22,1,1
SBI08ALK1955770,74,29,25,4,1
SBI94WUV8453470,20,29,25,4,1
SBI99YHJ1581931,92,28,25,3,1
SBI72BQA1509699,75,25,16,9,1
SBI22EMH9064644,67,26,19,7,1
SBI59CDA0804895,68,30,22,8,1
SBI93JXT3315913,61,20,15,5,1
SBI50IYT0435462,76,22,16,6,1
SBI82RSZ3581926,80,22,15,7,1
SBI90STF2027579,78,25,13,12,1
SBI85CCJ5391848,96,30,25,5,1
SBI94WHG2662365,67,22,20,2,1
SBI07FLK7669113,70,32,23,9,1
SBI20OOP8516612,80,18,10,8,1
SBI33BKY1271492,97,33,29,4,1
SBI57KAO0925430,77,25,17,8,1
SBI12RUL9000898,69,30,18,12,1
SBI17ZPX3577078,75,23,21,2,1
SBI38IKV2095412,93,23,18,5,1
SBI89FYA8820935,98,26,23,3,1
SBI48FUE6305761,75,30,20,10,1
SBI23FCN9509732,77,22,16,6,1
SBI18ICO3147082,77,32,31,1,1
SBI54QTO6817478,76,26,16,10,1
SBI38IRC4292153,93,23,14,9,1
SBI01OJW4090241,86,27,26,1,1
SBI30AYM9036462,95,27,23,4,1
SBI28GFJ6884045,25,20,16,4,1
SBI66OHS8195113,65,31,22,9,1
SBI26VBT4731012,93,28,16,12,1
SBI44KUT1033322,88,16,14,2,1
SBI51JEA7350677,95,34,20,14,1
SBI63QVS3329951,92,30,26,4,1
SBI73GHG0768333,84,25,24,1,1
SBI39JCK1217637,70,27,15,12,1
SBI63WXZ4217412,92,20,18,2,1
SBI28YBG0410657,93,27,23,4,1
SBI83JXN8676602,68,22,14,8,1
SBI22EZM8676959,86,23,12,11,1
SBI10MHT4791445,23,29,17,12,1
SBI45AYA0885823,71,29,20,9,1
SBI20ECN6195912,86,29,27,2,1
SBI41VVU9134361,20,18,16,2,1
SBI71QYT8560981,92,30,28,2,1
SBI12UTZ9331140,68,23,13,10,1
SBI34UKW8813260,19,19,13,6,1
SBI22RVY4530660,73,29,20,9,1
SBI14YDU6895336,86,27,24,3,1
SBI50KYE4299355,94,25,19,6,1
SBI46EQW9755975,18,29,27,2,1
SBI95MQJ5151463,86,28,26,2,1
SBI74UEZ8051289,83,19,11,8,1
SBI27CDL9897794,65,29,17,12,1
SBI30BRC7525423,86,22,14,8,1
SBI81SWL5655118,68,18,12,6,1
SBI88LOE0704558,81,25,13,12,1
SBI79HYZ6358086,99,23,19,4,1
SBI46ODP0034741,92,21,20,1,1
SBI64UMJ7073331,94,24,17,7,1
SBI93KXZ5297312,72,30,23,7,1
SBI73USP7083777,79,21,12,9,1
SBI52RCR6164244,95,28,17,11,1
SBI46GVI6183877,18,33,24,9,1
SBI94SON0103551,69,32,22,10,1
SBI41ERR5065263,24,21,14,7,1
SBI82KCX8413441,78,19,10,9,1
SBI65TAX4836324,73,24,16,8,1
SBI12HBG2449246,24,33,28,5,1
SBI57TLE2236141,74,29,20,9,1
SBI50FZE3066739,71,24,15,9,1
SBI04GAI4521341,18,27,22,5,1
SBI33XWE3442896,65,28,26,2,1
SBI68ZYQ6939577,89,17,15,2,1
SBI89CYV2734600,85,25,23,2,1
SBI78NWW5557911,73,16,11,5,1
SBI64XHM0929487,78,22,14,8,1
SBI49PKA1548136,70,32,21,11,1
SBI80POQ8685342,60,27,19,8,1
SBI76IWS9070904,80,26,17,9,1
SBI72DAP1669385,81,20,17,3,1
SBI78MJI7803511,98,12,7,5,1
SBI38LZX4996859,77,25,17,8,1
SBI49ZZA4540472,82,16,15,1,1
SBI78MNT1840664,88,30,27,3,1
SBI89ULG0986868,71,27,22,5,1
SBI24XJY6543490,75,18,15,3,1
SBI99UBF7710014,62,32,24,8,1
SBI51EUK8467937,93,19,11,8,1
SBI04IWC8480003,75,24,16,8,1
SBI23ODP0929934,92,29,21,8,1
SBI86TOS3656155,21,28,15,13,1
SBI17XPA6415953,64,21,11,10,1
SBI95XIF4205572,73,28,19,9,1
SBI44QEW9683284,20,34,20,14,1
SBI34QUZ9001445,21,26,18,8,1
SBI81HIY0823962,21,23,12,11,1
SBI42GQE7896246,70,25,24,1,1
SBI77PND2965101,96,29,23,6,1
SBI16WQM7697327,23,30,27,3,1
SBI42CZR0256196,71,29,19,10,1
SBI57VVC3486087,76,35,28,7,1
SBI21QEQ4473215,63,28,27,1,1
SBI21FYJ3382290,95,25,23,2,1
SBI16KTE0143362,89,20,14,6,1
SBI42BIE8853356,66,22,15,7,1
SBI08ORA7147326,60,30,21,9,1
SBI59JGH8912594,89,22,12,10,1
SBI79BXW8312911,83,24,16,8,1
SBI14AEB6336051,24,26,25,1,1
SBI58PBN4306292,75,20,17,3,1
SBI62HVE9730521,66,21,14,7,1
SBI71FHC9906108,70,29,19,10,1
SBI52KLT6731970,68,24,16,8,1
SBI64HTV4405370,92,29,18,11,1
SBI26WNS4949270,64,31,25,6,1
SBI96HXR8011118,62,25,21,4,1
SBI86INA2273479,91,20,15,5,1
SBI50IOC2115524,61,23,13,10,1
SBI35KJD6105159,74,22,21,1,1
SBI19HAA2106415,98,29,18,11,1
SBI72VTJ4146895,74,26,21,5,1
SBI09RVN5252639,82,22,14,8,1
SBI37OQG2111605,74,28,27,1,1
SBI99WUV1301703,99,28,24,4,1
SBI19IXY7250575,73,33,17,16,1
SBI45SMU9593643,75,25,14,11,1
SBI67SKE6294375,19,23,19,4,1
SBI63GPF7235103,66,24,16,8,1
SBI66OKW7199369,63,30,23,7,1
SBI03MSQ4177640,72,24,14,10,1
SBI82NUP9744059,94,20,18,2,1
SBI56AXI7581703,91,25,18,7,1
SBI61XOH0618614,78,26,24,2,1
SBI79IIL7350180,20,18,13,5,1
SBI96ZBW6505532,90,26,14,12,1
SBI56FZL4226224,18,28,22,6,1
SBI33IRA3022846,61,27,18,9,1
SBI19LXO2009216,92,23,19,4,1
SBI81AEA2880682,80,24,21,3,1
SBI45WER4696097,81,22,16,6,1
SBI42HLI9770287,90,23,18,5,1
SBI04VGP3565563,88,34,32,2,1
SBI13HWH5082630,63,31,20,11,1
SBI30RDT7017849,84,23,18,5,1
SBI42FGK9843237,60,18,14,4,1
SBI22ZWU3155775,25,30,17,13,1
SBI80MHD7265494,82,20,19,1,1
SBI14TUB7227398,80,30,27,3,1
SBI84ZKD0423741,98,24,20,4,1
SBI40ODA7276168,21,33,32,1,1
SBI75IXJ4298019,60,24,23,1,1
SBI13STO0371565,72,30,29,1,1
SBI99UUO2616868,97,24,18,6,1
SBI20LHQ6269132,70,28,18,10,1
SBI21WVP3535250,98,12,10,2,1
SBI70BYT9168005,64,28,18,10,1
SBI48OSN2657580,79,23,19,4,1
SBI66GTZ7099959,24,22,20,2,1
SBI46IIH4749863,91,26,19,7,1
SBI35BWR4754990,69,15,14,1,1
SBI92DCQ6061204,61,33,31,2,1
SBI86ZXM6062842,66,22,15,7,1
SBI69FTS7112045,25,24,20,4,1
SBI34JDV3985271,85,22,18,4,1
SBI65CEY4514221,92,14,9,5,1
SBI85KLB7020831,75,29,24,5,1
SBI96PXH2761283,87,23,20,3,1
SBI84ABG2823704,65,29,25,4,1
SBI48JBM4786561,98,13,10,3,1
SBI02WBW6877413,76,27,14,13,1
SBI77HYA4630689,98,29,16,13,1
SBI11RJD5093041,20,24,21,3,1
SBI36UHY3434095,80,22,15,7,1
SBI38DXP0333249,75,21,19,2,1
SBI68OAP2095211,80,35,27,8,1
SBI65WMA9588139,68,30,22,8,1
SBI49QNK8305136,69,29,16,13,1
SBI41XDA1964652,69,22,19,3,1
SBI11TKT8695524,80,32,19,13,1
SBI87ZDN7178562,20,36,27,9,1
SBI66GNC6586431,96,22,13,9,1
SBI51WPI4930399,65,23,18,5,1
SBI22PWT8737344,63,27,21,6,1
SBI47SOP5043583,92,30,28,2,1
SBI79PRX2741066,71,21,20,1,1
SBI23FKO7570291,93,24,17,7,1
SBI26ZEE5110031,66,18,14,4,1
SBI15AHA5648417,21,31,17,14,1
SBI25QPN5497757,62,20,11,9,1
SBI97AVU0359847,66,23,19,4,1
SBI41YAN5537961,75,37,31,6,1
SBI00YMY8157212,74,32,26,6,1
SBI85ZOK4533554,71,17,15,2,1
SBI65PVP6093904,25,29,21,8,1
SBI48VZJ2290856,87,29,25,4,1
SBI42UHU0222606,72,21,11,10,1
SBI10KPL9259349,76,32,28,4,1
SBI64NZW1698258,85,28,25,3,1
SBI98RZN5611182,22,30,22,8,1
SBI77PPR1398924,65,26,23,3,1
SBI66URC0367985,91,22,13,9,1
SBI26TSF8180838,65,19,14,5,1
SBI01NLR5717490,95,28,20,8,1
SBI15CKL2653645,69,27,14,13,1
SBI20XBM6563671,83,26,23,3,1
SBI20MFZ4935089,79,27,14,13,1
SBI48UOW9048344,96,16,9,7,1
SBI87TXM5359486,66,32,21,11,1
SBI44MDF6111880,18,21,18,3,1
SBI50PMT2148391,76,25,19,6,1
SBI43WYA4838256,96,21,11,10,1
SBI70EMX8320244,73,24,17,7,1
SBI97SZC7994742,86,18,14,4,1
SBI07FGQ8190311,63,33,27,6,1
SBI33VIT4954273,89,17,14,3,1
SBI49KDD5056824,92,15,11,4,1
SBI54ERW9598995,85,21,16,5,1
SBI46YVA2663481,86,22,17,5,1
SBI97PNY0206414,61,20,19,1,1
SBI41QQR8594892,93,29,19,10,1
SBI65MOP1516278,61,20,14,6,1
SBI87OOI6877035,75,30,21,9,1
SBI24FKO6972505,86,26,14,12,1
SBI75CHY5575185,25,24,14,10,1
SBI71RBV4484270,87,15,12,3,1
SBI89PJG5408736,24,25,17,8,1
SBI94WXG0153870,84,26,25,1,1
SBI80UMK9149917,23,15,9,6,1
SBI01YUN5133053,76,37,20,17,1
SBI29ZJD3911889,68,25,24,1,1
SBI29HNF4995724,89,30,27,3,1
SBI55DVI4724596,76,17,16,1,1
SBI13PRV9309612,24,21,20,1,1
SBI47JFS8477146,24,26,21,5,1
SBI68JYM1969002,75,25,24,1,1
SBI68UCX8429473,69,18,12,6,1
SBI28WHA6500912,98,28,22,6,1
SBI46THV8466196,73,18,17,1,1
SBI24SPJ6489398,99,30,16,14,1
SBI07HPK7599577,80,23,19,4,1
SBI52IAB7601452,22,20,19,1,1
SBI29JWF6917710,89,23,22,1,1
SBI28ERR9079836,69,31,21,10,1
SBI68HMU8607814,97,33,23,10,1
SBI84JVB7115670,22,26,23,3,1
SBI13RUD4805733,97,21,14,7,1
SBI73JAA2577766,94,25,15,10,1
SBI98HBP1384256,89,20,19,1,1
SBI45SLY5297453,87,23,22,1,1
SBI34OVX9953617,74,26,17,9,1
SBI51RDO0565282,76,20,17,3,1
SBI92NEX1350527,98,22,20,2,1
SBI67VOZ7334602,97,14,13,1,1
SBI86UYL1187989,82,14,11,3,1
SBI09LFM2836070,21,16,9,7,1
SBI76FUP5028664,20,26,23,3,1
SBI40GHZ0807966,80,23,17,6,1
SBI17HTV6459923,19,26,25,1,1
SBI04NWM7380692,75,18,14,4,1
SBI14DTL2937690,70,30,18,12,1
SBI48QFF8311393,73,32,25,7,1
SBI74ERZ3270974,90,20,18,2,1
SBI69AMQ3398142,91,21,14,7,1
SBI93IKC5430065,20,29,25,4,1
SBI51SJK5451188,63,27,23,4,1
SBI76RSW1133716,97,23,12,11,1
SBI90WLH8166520,95,18,13,5,1
SBI09RCS1348324,98,28,18,10,1
SBI77JCT2255590,60,15,8,7,1
SBI61IOZ5588069,91,16,10,6,1
SBI17KZF3201203,76,21,16,5,1
SBI70WPL5612506,91,35,26,9,1
SBI89MAE3166511,73,18,11,7,1
SBI64NWX8783249,76,19,15,4,1
SBI74HTC6009213,79,25,24,1,1
SBI20ZYO1420981,70,25,16,9,1
SBI02RHN9155615,98,24,21,3,1
SBI71KZA7419240,98,23,14,9,1
SBI41KVN7734660,74,23,19,4,1
SBI56SBF6077636,88,31,26,5,1
SBI17CSO9605871,66,22,15,7,1
SBI14UNE9813789,87,20,19,1,1
SBI37NGQ4404007,99,28,17,11,1
SBI55MCB7993723,18,26,23,3,1
SBI75IMY0473535,63,22,21,1,1
SBI45NVU4460933,70,24,17,7,1
SBI66BAE3171720,21,26,19,7,1
SBI77QIF4492203,86,24,15,9,1
SBI27HIN7872018,92,25,17,8,1
SBI41OER9705131,82,35,30,5,1
SBI97KXV3138564,92,29,26,3,1
SBI86EJR5960146,65,29,23,6,1
SBI26CFT3142666,94,20,15,5,1
SBI12PQF6261581,20,21,15,6,1
SBI24IQV6346920,86,33,22,11,1
SBI78YVB8652948,20,28,19,9,1
SBI25LZN6814224,73,33,21,12,1
SBI31MXG2041901,60,31,30,1,1
SBI64ZTP6779928,22,26,17,9,1
SBI92HVU9620321,18,22,20,2,1
SBI05HEK3218126,81,33,32,1,1
SBI47IRN2979728,83,21,14,7,1
SBI97CKV3943747,91,21,12,9,1
SBI03BLX4938319,75,23,12,11,1
SBI83IAN7834711,73,27,24,3,1
SBI01KMI9730087,89,26,23,3,1
SBI09SFZ0164126,22,31,29,2,1
SBI32DVC5639972,86,25,18,7,1
SBI54CFH9366546,82,21,19,2,1
SBI46GAP8759110,73,16,14,2,1
SBI20PFW7403858,60,15,11,4,1
SBI72FWP8914424,87,28,17,11,1
SBI10GBA0454190,83,33,26,7,1
SBI74JCY1146326,85,29,26,3,1
SBI63GSG4228457,67,32,23,9,1
SBI91MNZ5217152,91,28,20,8,1
SBI40UKG2420625,21,31,17,14,1
SBI76TRH3839980,62,32,17,15,1
SBI92JRV2170244,99,26,24,2,1
SBI14WOS7359311,98,19,15,4,1
SBI71RKP3823597,96,26,23,3,1
SBI82WIK8836129,77,20,11,9,1
SBI75DRL0593012,61,33,31,2,1
SBI22RPH0658127,21,25,22,3,1
SBI21NDG8048180,81,33,20,13,1
SBI40OVV0941670,96,25,18,7,1
SBI83JSE4084792,94,21,18,3,1
SBI11ETE7429492,91,25,16,9,1
SBI14HQO5737992,77,30,27,3,1
SBI12DYR0560718,98,25,23,2,1
SBI11GSJ3259748,22,28,19,9,1
SBI68NXT1161971,60,24,17,7,1
SBI26ATQ5717703,84,26,15,11,1
SBI91YLN9220865,75,32,26,6,1
SBI34DDC5480854,81,28,25,3,1
SBI28MWO2231081,63,33,25,8,1
SBI65GWQ6190117,25,30,16,14,1
SBI23RVN4378224,80,21,11,10,1
SBI48SXF9166222,78,22,15,7,1
SBI43ICD8877057,79,16,12,4,1
SBI05CHW4918692,67,19,18,1,1
SBI32VMS7600625,22,19,11,8,1
SBI84RYO6857354,21,26,19,7,1
SBI75ELJ8799669,25,32,21,11,1
SBI78HXZ5499124,76,28,21,7,1
SBI05JSD0217097,62,21,14,7,1
SBI88RYU9234724,94,29,23,6,1
SBI13GKJ5161856,98,33,25,8,1
SBI13OHA0818560,68,28,20,8,1
SBI61OBD9524824,24,24,21,3,1
SBI38NUU3347158,78,20,18,2,1
SBI09FDO1880037,70,27,15,12,1
SBI29AAU3419001,68,25,17,8,1
SBI43DSS1075831,99,19,11,8,1
SBI59YBJ7089769,85,20,19,1,1
SBI43JCL5440149,88,23,15,8,1
SBI87FIL3195610,72,17,12,5,1
SBI01DZW0875948,64,38,23,15,1
SBI99QNP6145535,96,24,21,3,1
SBI85OVM4449290,65,18,17,1,1
SBI97KVN0675926,18,17,11,6,1
SBI55KDV1718637,82,21,18,3,1
SBI87WAI2800188,91,27,19,8,1
SBI67DCP8813728,67,29,28,1,1
SBI63QYS6062899,98,29,18,11,1
SBI03KRT7340129,86,22,21,1,1
SBI19LRE2818028,23,32,31,1,1
SBI23DYE1679079,84,29,28,1,1
SBI37WAZ5214190,81,32,31,1,1
SBI07OGI7673757,88,29,16,13,1
SBI11UWJ4057002,87,26,15,11,1
SBI05VKN6730042,88,21,11,10,1
SBI96XIN5851096,96,26,20,6,1
SBI52GVH1146785,88,26,23,3,1
SBI18PIR4349883,77,24,16,8,1
SBI97MAA0512525,22,22,16,6,1
SBI79FBG7035578,71,22,15,7,1
SBI25KBN3621617,70,23,21,2,1
SBI23YJM9335337,84,27,25,2,1
SBI04MQX0970008,71,30,21,9,1
SBI12XVC7759897,63,12,10,2,1
SBI48WYC2047387,22,21,14,7,1
SBI05WSJ8392250,65,28,22,6,1
SBI15NJI9276581,78,28,24,4,1
SBI30LDG8790619,21,16,13,3,1
SBI76CUX0403666,75,20,16,4,1
SBI30PDO0656252,62,26,24,2,1
SBI89GUP4199184,64,24,20,4,1
SBI49UFJ2363787,96,28,22,6,1
SBI86XRI0216884,73,27,17,10,1
SBI00CEI7765937,65,16,14,2,1
SBI96HBS3741031,79,28,24,4,1
SBI08DAX5335821,86,26,16,10,1
SBI80YVK6164780,60,23,15,8,1
SBI81IDR5395029,78,24,19,5,1
SBI23JNR3591276,71,23,14,9,1
SBI70HBZ5396923,79,23,17,6,1
SBI83XFX4516473,71,18,13,5,1
SBI83RKG5586028,21,25,22,3,1
SBI67HGK6131248,80,22,12,10,1
SBI19UXD6422908,65,17,11,6,1
SBI90XVU8085597,82,24,17,7,1
SBI57BVF0951082,70,32,28,4,1
SBI86UQX0396297,90,20,19,1,1
SBI30QIJ0675266,80,24,22,2,1
SBI16DMR6560247,99,21,17,4,1
SBI24WBV9393001,83,28,19,9,1
SBI68XSO1615985,98,30,16,14,1
SBI63NKZ9130983,66,13,11,2,1
SBI22AHL9646689,20,17,16,1,1
SBI92XBH6697276,76,29,24,5,1
SBI06HDE0013503,80,21,18,3,1
SBI18HWE7761070,21,28,17,11,1
SBI70QAJ8306820,60,26,24,2,1
SBI79RXM2201583,78,21,14,7,1
SBI49SVE7781390,87,29,23,6,1
SBI98PUL3724953,69,22,16,6,1
SBI88FJD6306566,96,26,22,4,1
SBI74ZWO7230138,81,27,15,12,1
SBI90XUS9879863,98,16,13,3,1
SBI17VHV8434665,99,25,19,6,1
SBI16EVN9115304,77,23,14,9,1
SBI56FYA1519269,87,29,16,13,1
SBI68TSU8183369,95,22,19,3,1
SBI02IOI2577186,84,27,20,7,1
SBI54RVE8263358,76,28,16,12,1
SBI81XIX3957230,22,28,26,2,1
SBI88TUS4190944,99,41,29,12,1
SBI89HZG2649594,90,25,21,4,1
SBI97EPK5744954,81,16,13,3,1
SBI57URK1768931,86,31,19,12,1
SBI04NJS0369378,94,21,20,1,1
SBI47LKG0967651,85,21,15,6,1
SBI35EEW0105326,88,34,25,9,1
SBI75YEN6586964,65,31,27,4,1
SBI67ZEX8763446,62,25,13,12,1
SBI51YFY7073256,87,14,9,5,1
SBI89OMQ3702072,99,27,26,1,1
SBI96YTC1809993,88,31,18,13,1
SBI15KXK1109748,18,20,11,9,1
SBI01KMT0589032,85,27,15,12,1
SBI94ELG1211668,76,35,23,12,1
SBI56DTJ7158210,68,29,24,5,1
SBI04NJY2947051,98,34,20,14,1
SBI78HGW3842236,78,32,25,7,1
SBI61CDZ4725635,60,28,23,5,1
SBI32DAY8236834,80,31,16,15,1
SBI61NHT9179617,94,36,30,6,1
SBI37XLD7713431,79,24,18,6,1
SBI06ERT8967425,87,27,14,13,1
SBI58PRD5692441,74,23,18,5,1
SBI09PHB7903008,21,26,24,2,1
SBI27SDC3954460,75,35,32,3,1
SBI22IOT9915720,61,33,23,10,1
SBI82APY6192346,91,24,22,2,1
SBI55PAX1474804,70,27,24,3,1
SBI65QXF6276107,74,19,16,3,1
SBI10XZU5666571,64,33,20,13,1
SBI09NJQ3081636,68,34,28,6,1
SBI82GWU1484770,82,24,20,4,1
SBI47JTP6192313,78,30,19,11,1
SBI92WTT9400265,86,26,17,9,1
SBI10RFN5668484,71,21,14,7,1
SBI46WAB6389649,61,25,23,2,1
SBI29XQE5834867,96,28,26,2,1
SBI95MBW2863090,74,16,12,4,1
SBI04GIW9438736,72,26,21,5,1
SBI37ZKO6330144,92,21,15,6,1
SBI39STR9761584,73,28,23,5,1
SBI99PXX3677889,60,31,20,11,1
SBI67XVR1383595,98,27,18,9,1
SBI80LIR6915048,21,25,16,9,1
SBI14RCY4793360,69,25,15,10,1
SBI13BHA7935328,63,23,17,6,1
SBI38GNT5262001,78,14,13,1,1
SBI45JOB0739216,19,29,16,13,1
SBI49SRP1898001,72,22,17,5,1
SBI30OAM2073718,22,21,20,1,1
SBI44JPN4598050,68,27,19,8,1
SBI39ZMK3224252,99,21,16,5,1
SBI52ZTN7709788,61,30,23,7,1
SBI18UHS0494808,77,21,12,9,1
SBI35UNF9253667,18,20,19,1,1
SBI26JDT9457738,89,23,17,6,1
SBI32MTK8903889,80,28,19,9,1
SBI71OIQ0438446,61,27,26,1,1
SBI70PQV8509864,96,24,18,6,1
SBI46GDM2734840,96,24,14,10,1
SBI25XXG5197777,22,34,26,8,1
SBI78JHS8143276,63,26,20,6,1
SBI89LIU4865714,69,24,21,3,1
SBI96MWD4092540,97,24,17,7,1
SBI47PZV2162685,67,26,21,5,1
SBI78PNR3492089,82,18,12,6,1
SBI34MRM6499119,77,28,26,2,1
SBI56JUC0774524,72,29,17,12,1
SBI15DTX2068855,68,24,19,5,1
SBI07OUA4417497,75,18,15,3,1
SBI81WQV2995561,79,28,24,4,1
SBI65FPG0023316,89,24,17,7,1
SBI40MOC5155843,90,24,17,7,1
SBI81AXQ9843620,90,21,11,10,1
SBI98GRX9662833,85,17,16,1,1
SBI00EBH3918902,76,28,20,8,1
SBI31JJY3078669,25,26,14,12,1
SBI96PQM2737863,70,25,23,2,1
SBI17VPY0126034,87,34,23,11,1
SBI57KRK4023009,24,23,15,8,1
SBI61XQU8372853,68,16,11,5,1
SBI21XZD6772198,85,32,17,15,1
SBI21AOJ6139245,86,26,22,4,1
SBI91YQW5650210,24,20,12,8,1
SBI24GBG6940569,19,24,15,9,1
SBI54MIG0012649,70,25,21,4,1
SBI60CZZ9152483,20,21,20,1,1
SBI72TLV8933218,22,15,9,6,1
SBI49EDP0723426,96,34,33,1,1
SBI57SVA3337329,70,30,21,9,1
SBI37ALR5379765,96,20,12,8,1
SBI53QKE2701161,71,25,22,3,1
SBI77WWR8161811,25,23,16,7,1
SBI20WNB3553604,86,30,19,11,1
SBI66GST6157424,73,26,18,8,1
SBI60EHT2316039,68,22,21,1,1
SBI01DAT1777405,93,23,19,4,1
SBI63GWR6277762,60,32,27,5,1
SBI31ZQK9486878,76,24,20,4,1
SBI26IZC3978384,80,28,16,12,1
SBI64DPC5631318,92,27,23,4,1
SBI01KCA5920582,88,31,19,12,1
SBI21VKC0754233,94,23,13,10,1
SBI91OFH2518375,80,33,25,8,1
SBI19VEB2366026,90,18,17,1,1
SBI02LXI2949904,87,28,17,11,1
SBI59VNM5264390,85,24,16,8,1
SBI37GUX4052934,74,19,16,3,1
SBI77BKO6779679,91,25,16,9,1
SBI99JQO0599620,81,23,21,2,1
SBI27MGT2358699,68,29,20,9,1
SBI60TSP6536820,97,13,9,4,1
SBI82IEI6649180,24,24,21,3,1
SBI54WIT7528572,78,25,21,4,1
SBI21EIH0638117,24,19,10,9,1
SBI51NWD8690279,21,26,17,9,1
SBI01ENF6778845,82,31,27,4,1
SBI81VQN8352067,75,20,11,9,1
SBI56WOW7007261,65,26,15,11,1
SBI48RFE4062102,63,23,16,7,1
SBI18BKG7115083,86,26,18,8,1
SBI55NWV4110814,73,20,18,2,1
SBI86XVK5177215,72,26,16,10,1
SBI28SZY0757350,73,23,15,8,1
SBI90BLP5469721,83,24,17,7,1
SBI57IJU4429162,98,29,28,1,1
SBI25PXV8211975,81,24,23,1,1
SBI11RDW5129410,80,27,26,1,1
SBI69JTJ6288992,81,27,16,11,1
SBI25FFU3138031,74,24,19,5,1
SBI77PED9259445,96,30,24,6,1
SBI55PLN5501372,84,28,25,3,1
SBI02GZV6045337,60,17,11,6,1
SBI58AMG4617116,64,26,15,11,1
SBI22GLJ3904273,74,21,11,10,1
SBI24FJC1326832,68,22,16,6,1
SBI54CWL7817511,25,26,17,9,1
SBI84HPO0863608,61,25,17,8,1
SBI59VYE3832866,66,27,19,8,1
SBI88DXX7417194,84,23,14,9,1
SBI92RAW1080438,63,27,17,10,1
SBI27YEB1521795,87,32,28,4,1
SBI03HOG3536915,87,21,15,6,1
SBI07OPE9469158,96,27,14,13,1
SBI55TSG6300253,77,20,11,9,1
SBI15MUD8046610,66,25,22,3,1
SBI46JOS7084055,86,31,16,15,1
SBI67SMR0690820,89,18,10,8,1
SBI04YSU4172869,74,18,17,1,1
SBI71XMP1973559,96,25,18,7,1
SBI74OWV1326120,94,20,19,1,1
SBI56NMM9165260,83,24,20,4,1
SBI67QCM6042611,63,19,12,7,1
SBI32OYQ5471146,84,20,17,3,1
SBI89ERU7811317,81,21,15,6,1
SBI42SRZ6614594,67,24,17,7,1
SBI66UTW9800895,75,22,12,10,1
SBI91XTI0713437,80,30,19,11,1
SBI77JME4858728,93,33,30,3,1
SBI17AUE7681697,81,28,24,4,1
SBI22TKV9417279,71,27,20,7,1
SBI38NMC0971426,70,28,17,11,1
SBI42UPS9032439,69,29,28,1,1
SBI09UXJ3614037,92,28,22,6,1
SBI47ECY7957048,19,26,19,7,1
SBI03IRF8336760,89,34,18,16,1
SBI52DPF8745730,67,26,19,7,1
SBI36GAG8010998,76,19,18,1,1
SBI71CVV1834646,76,27,25,2,1
SBI90AUU3489684,61,30,17,13,1
SBI79NJJ4308501,88,27,14,13,1
SBI90VVB7119201,88,20,18,2,1
SBI75EGB5698495,73,23,14,9,1
SBI88KGN0692376,60,29,24,5,1
SBI18PLS8781435,68,27,24,3,1
SBI99RNV6250057,75,28,23,5,1
SBI08PQM7983811,67,27,24,3,1
SBI90MPV6693524,25,20,14,6,1
SBI62CYG8792945,80,24,22,2,1
SBI07DVR2524704,79,20,16,4,1
SBI45WBO0565199,20,29,20,9,1
SBI61OIU8407807,66,18,10,8,1
SBI77TPB0706445,80,23,13,10,1
SBI63TGD7030348,67,31,24,7,1
SBI69BCQ9596998,24,26,25,1,1
SBI17ZOL3487148,78,18,12,6,1
SBI60GZW2031100,91,20,19,1,1
SBI83QAU0627531,97,28,24,4,1
SBI49UJP1741391,83,29,17,12,1
SBI89LUT9521295,22,19,10,9,1
SBI11YRU9272112,95,16,11,5,1
SBI48AYU1673444,63,28,26,2,1
SBI12VHJ0247574,70,23,13,10,1
SBI66GYL7874366,25,26,21,5,1
SBI54MHW4757333,18,26,21,5,1
SBI26ZOQ5576361,63,25,15,10,1
SBI03QNZ5271326,85,22,20,2,1
SBI77IZD5912864,91,26,16,10,1
SBI98FEY3609826,86,25,22,3,1
SBI34GDU4754882,61,26,16,10,1
SBI16PNY3951128,23,24,17,7,1
SBI17SWC2174680,70,10,7,3,1
SBI98BIQ1344230,85,24,18,6,1
SBI71FPC0194295,95,25,14,11,1
SBI60OMT4398499,67,26,18,8,1
SBI30OIB2310061,93,20,15,5,1
SBI18CYU2208428,77,27,26,1,1
SBI44ROL1546078,78,17,12,5,1
SBI80HRA7035528,23,16,10,6,1
SBI89XHL6031258,20,34,33,1,1
SBI90QPN3773234,91,25,23,2,1
SBI04LII3715454,97,19,12,7,1
SBI91TUJ8882588,20,22,13,9,1
SBI14OXU9133544,61,22,17,5,1
SBI59ZGG4911430,87,30,26,4,1
SBI43FYO8196027,93,25,18,7,1
SBI37TKA3570643,62,22,13,9,1
SBI45WSY4671355,66,14,11,3,1
SBI06KCR7320959,97,36,30,6,1
SBI46UWH3105080,70,24,17,7,1
SBI09TCS7386818,65,27,17,10,1
SBI93ZIL0467491,21,33,29,4,1
SBI94DBQ6340536,60,22,15,7,1
SBI55JIK8736000,19,27,24,3,1
SBI89KCV4342511,91,25,13,12,1
SBI92GWA0679502,72,34,21,13,1
SBI08BBM8662152,69,23,21,2,1
SBI91ZPU3298542,24,23,14,9,1
SBI50DDQ1493273,74,14,8,6,1
SBI97WNX0692523,84,19,11,8,1
SBI64OZC2065043,61,23,20,3,1
SBI29NKE8711022,81,28,25,3,1
SBI59LXM3317667,60,26,20,6,1
SBI59SCS4273769,94,32,18,14,1
SBI96AWP8191267,86,21,17,4,1
SBI72NSK8891254,21,20,14,6,1
SBI30PCW5928886,60,25,23,2,1
SBI42AEM5243398,69,29,23,6,1
SBI71FOD3340149,68,29,19,10,1
SBI85PNV2988909,99,34,32,2,1
SBI89CZS9591893,73,23,18,5,1
SBI94ARP5928733,94,25,15,10,1
SBI11KET0917095,67,23,12,11,1
SBI51ZJV3226506,22,37,21,16,1
SBI97EVR7862068,69,20,15,5,1
SBI60SED6123865,65,30,17,13,1
SBI21ICV7029627,72,25,18,7,1
SBI41MHK7907390,72,23,18,5,1
SBI17LFI3297436,93,22,15,7,1
SBI21TKP3800565,65,26,14,12,1
SBI53HNH7285150,72,26,24,2,1
SBI42HHN2404906,63,16,13,3,1
SBI48ORV2341453,72,25,23,2,1
SBI94NTB4749803,63,23,17,6,1
SBI92NQU6133794,92,17,13,4,1
SBI91HZZ3558726,21,21,11,10,1
SBI07JTA7159733,89,30,24,6,1
SBI07DCQ1385891,90,18,17,1,1
SBI35QZX3977104,86,20,18,2,1
SBI62UQA3232258,65,26,25,1,1
SBI06AVM0714098,25,29,20,9,1
SBI35SEH9339189,85,25,21,4,1
SBI61MZY0447486,96,31,30,1,1
SBI38ZWT0911236,84,23,18,5,1
SBI12BAG0902055,60,29,21,8,1
SBI06PDJ3781899,66,27,16,11,1
SBI80GFS2789643,75,25,24,1,1
SBI06COH2327342,96,34,22,12,1
SBI79KKS1207638,75,18,11,7,1
SBI20WHN0786978,73,22,16,6,1
SBI04UZK8508570,98,26,24,2,1
SBI49IJH3958583,97,23,16,7,1
SBI85NBE8806242,22,25,22,3,1
SBI45ETV2537431,67,25,17,8,1
SBI35PQS6862016,81,20,16,4,1
SBI65HFT8065869,94,26,23,3,1
SBI61YUU9167539,89,19,16,3,1
SBI78OBZ7956127,18,17,9,8,1
SBI24CMO8872177,18,27,25,2,1
SBI89CVN9450964,95,15,11,4,1
SBI82OWA7916780,80,26,24,2,1
SBI71DXN4906735,19,27,18,9,1
SBI96JRR2696529,83,22,17,5,1
SBI34UMA7405974,24,20,17,3,1
SBI37DSV8204195,62,26,15,11,1
SBI05USC0788551,25,23,22,1,1
SBI19RJG5694069,85,22,15,7,1
SBI80ZRJ6393541,70,21,14,7,1
SBI48EPD2267865,72,16,14,2,1
SBI27FZP5328759,91,21,17,4,1
SBI36PZK9786747,99,25,18,7,1
SBI26PVO4883313,67,33,29,4,1
SBI08PYG5100246,72,22,12,10,1
SBI03NLS4957089,70,24,13,11,1
SBI24APV1869017,67,21,15,6,1
SBI06OJI8926970,60,22,17,5,1
SBI59RXH3778941,94,27,22,5,1
SBI10AOL6470274,83,28,18,10,1
SBI68VVS6481920,77,29,17,12,1
SBI00YSA4144842,78,20,17,3,1
SBI80HUE8604440,86,16,15,1,1
SBI73QCB2159484,25,27,16,11,1
SBI74RWN6338638,94,23,14,9,1
SBI52ELI3861176,18,25,20,5,1
SBI84NSZ3330300,21,18,16,2,1
SBI13OIN9617181,95,21,13,8,1
SBI97ONM2013278,69,22,17,5,1
SBI53UKG3944005,68,29,22,7,1
SBI62IFW4710453,95,30,25,5,1
SBI92JCA4050190,83,31,29,2,1
SBI59UDT2438659,62,33,20,13,1
SBI92AGQ4060562,79,27,19,8,1
SBI51UPG8901662,81,26,15,11,1
SBI24UOL9221130,19,31,26,5,1
SBI39NVB6690141,69,32,20,12,1
SBI65WRR7739027,95,32,22,10,1
SBI84BOW3103298,63,20,12,8,1
SBI43CKX5934634,63,25,14,11,1
SBI37WYG0574412,96,35,34,1,1
SBI48MUN6396002,86,25,23,2,1
SBI08APR0887545,81,22,18,4,1
SBI39XDF2280953,87,29,17,12,1
SBI52OHU4775185,77,28,20,8,1
SBI80AVG0534688,90,27,16,11,1
SBI12CHU1386070,76,17,15,2,1
SBI79BCK0831666,92,15,12,3,1
SBI29JEA0910036,83,31,20,11,1
SBI31WQQ5645586,22,26,16,10,1
SBI36XQW0001876,92,28,17,11,1
SBI01HFJ4063697,79,23,21,2,1
SBI17UGV5970725,18,22,19,3,1
SBI14ELA1098611,64,21,13,8,1
SBI07JCF1772508,90,19,15,4,1
SBI38NJT8114211,98,21,13,8,1
SBI33OHT4708685,60,29,24,5,1
SBI40PVE2827718,99,23,16,7,1
SBI84BLG1961095,24,29,28,1,1
SBI42SBT3227769,64,20,13,7,1
SBI37JVQ6364804,18,24,15,9,1
SBI39OGQ2206912,89,30,19,11,1
SBI70SWS6130607,75,23,13,10,1
SBI48JGB8766131,61,15,11,4,1
SBI05BNE1512277,61,18,13,5,1
SBI09DBP4802031,61,28,17,11,1
SBI33YTU5074098,22,20,19,1,1
SBI49VIT9983786,86,23,19,4,1
SBI48DWF0641515,77,29,27,2,1
SBI90CLN6889381,78,38,26,12,1
SBI81FGH7004700,78,17,10,7,1
SBI50EJP0768596,87,23,12,11,1
SBI04OYV0152409,75,28,21,7,1
SBI26EVM9154388,99,30,25,5,1
SBI35ZGB3058528,80,24,22,2,1
SBI87SFQ2677334,66,27,19,8,1
SBI19NGS9853796,91,29,25,4,1
SBI82VFU0641655,22,23,16,7,1
SBI86QGW1922889,81,30,22,8,1
SBI42QFV5440526,84,29,23,6,1
SBI11WBT5680714,79,25,13,12,1
SBI05AVZ4487838,67,28,22,6,1
SBI42ATD4888494,70,27,17,10,1
SBI93BQD5513863,23,21,16,5,1
SBI57BZW9828129,19,23,16,7,1
SBI98FGU2891453,22,22,21,1,1
SBI34TIQ3073413,74,22,21,1,1
SBI96UNZ7293779,21,24,20,4,1
SBI47LIT1570314,63,19,13,6,1
SBI92EAC2713600,88,21,17,4,1
SBI56UJC9137700,77,23,16,7,1
SBI98RDK2817423,62,32,29,3,1
SBI83OBH6731703,23,29,20,9,1
SBI44JUW0566421,72,27,19,8,1
SBI03VKX5345106,68,29,18,11,1
SBI50ZST9002202,24,30,18,12,1
SBI74BOW3322878,84,21,15,6,1
SBI53FGF4948638,71,29,19,10,1
SBI31MBM7446583,67,33,26,7,1
SBI67ZDM8478164,88,30,28,2,1
SBI00SOC5596012,20,25,13,12,1
SBI44DJS2502675,81,18,13,5,1
SBI03IDC3151587,63,27,17,10,1
SBI08HSG6754801,98,33,23,10,1
SBI18BQD0705331,60,26,23,3,1
SBI92BSC6106659,19,25,14,11,1
SBI47SVT7072682,63,25,22,3,1
SBI90OQM0569008,97,24,21,3,1
SBI52ZUT0844624,69,24,23,1,1
SBI04RCL9443856,92,26,19,7,1
SBI20VCQ5207701,96,25,13,12,1
SBI20GHF6590426,21,23,17,6,1
SBI25OFH9003346,63,19,17,2,1
SBI64JWD9403101,87,23,21,2,1
SBI17YZS8625782,23,24,13,11,1
SBI01MWO7321949,18,23,13,10,1
SBI30QQX6840557,74,20,11,9,1
SBI48NCA7374149,95,30,16,14,1
SBI92CYS4127845,97,26,23,3,1
SBI16IXX7522305,87,23,13,10,1
SBI16IHX1488915,18,21,19,2,1
SBI29RES6876272,92,22,16,6,1
SBI39EYI2913612,97,21,19,2,1
SBI56YKB6603016,91,21,17,4,1
SBI51SFT5480468,25,19,12,7,1
SBI75HSH8061705,68,25,24,1,1
SBI04UEE9943834,93,26,17,9,1
SBI59YKQ6863003,23,24,18,6,1
SBI87XLL2979790,70,12,11,1,1
SBI80HHZ6914981,73,25,15,10,1
SBI34MUH8590755,72,18,15,3,1
SBI96MWA4823025,62,32,25,7,1
SBI80SNO5482998,24,26,20,6,1
SBI56RDY6710481,22,25,19,6,1
SBI26DWW2088159,23,18,17,1,1
SBI70DUY3515069,70,25,21,4,1
SBI99ECE8914742,82,26,23,3,1
SBI57RZF9397844,20,24,19,5,1
SBI23XYV2787492,60,21,15,6,1
SBI17IQD4411927,96,25,13,12,1
SBI11IZL5722347,71,38,20,18,1
SBI38MWB9522266,97,21,15,6,1
SBI41BMR0016565,68,16,12,4,1
SBI33CYT0354359,68,15,11,4,1
SBI44PFY0748325,92,35,31,4,1
SBI80UHR0040386,84,27,24,3,1
SBI17GAO8281465,63,21,17,4,1
SBI01WXK2028406,66,24,18,6,1
SBI83VMQ4128433,89,23,15,8,1
SBI91EFA5420879,69,20,17,3,1
SBI46XUL5736046,70,18,15,3,1
SBI02JCC9200416,96,25,22,3,1
SBI52PIB2271672,25,17,11,6,1
SBI15BRO1909846,65,25,19,6,1
SBI68QFZ3557701,91,13,8,5,1
SBI65XVH6350299,63,18,16,2,1
SBI32QYV8815885,18,16,10,6,1
SBI74TQX7247582,20,19,15,4,1
SBI01OLF8395332,68,19,10,9,1
SBI18PHT6220817,80,26,20,6,1
SBI01XZV8116529,72,20,19,1,1
SBI01ZUW7495804,71,28,17,11,1
SBI61EHN1130201,81,15,8,7,1
SBI06ZCQ8293468,92,24,15,9,1
SBI61XIU0733829,76,30,26,4,1
SBI08JMT0867015,98,31,28,3,1
SBI53VOX1608844,22,26,21,5,1
SBI82SNQ6897858,61,16,15,1,1
SBI96ZGL7577438,63,22,18,4,1
SBI26FUN3797182,94,30,28,2,1
SBI32OZS4378937,75,32,22,10,1
SBI63WPC4917273,87,26,16,10,1
SBI92IMC7449719,81,26,19,7,1
SBI19DJX3417621,80,20,16,4,1
SBI75KBV3620797,92,23,13,10,1
SBI02YHU5976596,90,26,20,6,1
SBI18VDP3922888,68,30,25,5,1
SBI37JJZ5021458,88,19,12,7,1
SBI39CKR0661907,23,16,9,7,1
SBI38CEQ3129242,74,23,12,11,1
SBI89PNF5284827,82,23,22,1,1
SBI89FVO7091162,80,20,13,7,1
SBI07XXY6849789,24,20,14,6,1
SBI45LFQ2588541,61,34,21,13,1
SBI30UJN8907122,97,23,12,11,1
SBI48AJI5176265,73,22,18,4,1
SBI88XGD5382253,90,24,21,3,1
SBI15JYC0556687,94,25,20,5,1
SBI04RKS0634271,78,24,23,1,1
SBI94KNG8319956,62,16,14,2,1
SBI98KAV7056801,99,34,33,1,1
SBI47JXE5932479,91,21,17,4,1
SBI69PRV4028039,99,16,11,5,1
SBI04FIS1581387,24,15,11,4,1
SBI82NWG9795364,66,21,16,5,1
SBI99XLC8153689,21,19,12,7,1
SBI41DJO5311970,98,25,13,12,1
SBI36VPB7732071,25,34,20,14,1
SBI20EPN6880389,24,29,26,3,1
SBI06CZA5854627,22,31,27,4,1
SBI74PSO3720432,85,20,14,6,1
SBI69HFG9502731,74,23,14,9,1
SBI58WZV1387905,96,32,29,3,1
SBI78ATG9501829,87,24,13,11,1
SBI18KQW9929315,86,21,19,2,1
SBI76KBC7752524,67,28,21,7,1
SBI96IRZ0394329,61,31,22,9,1
SBI92XCX9745768,74,19,15,4,1
SBI94QHB8298166,60,18,15,3,1
SBI03KTW7776822,98,26,16,10,1
SBI02ION8071991,84,26,25,1,1
SBI91AGY3228046,96,28,20,8,1
SBI35RNT1572868,93,33,17,16,1
SBI92QVV2077684,77,33,31,2,1
SBI32BCF3146594,84,27,21,6,1
SBI68RGI6973283,69,18,11,7,1
SBI70SNX8995244,79,22,19,3,1
SBI30PDB4443614,77,38,29,9,1
SBI07HFJ0224652,66,15,10,5,1
SBI97TUN4984197,63,17,11,6,1
SBI47NFL3047705,71,10,9,1,1
SBI73KCV1405630,20,27,23,4,1
SBI10AUE1583419,82,28,16,12,1
SBI73TEZ1323395,21,29,23,6,1
SBI45QGB6555217,73,30,21,9,1
SBI34BDZ7690955,97,29,17,12,1
SBI94CAY4046307,93,25,24,1,1
SBI32AYT9712772,80,21,11,10,1
SBI54NUG1836121,70,24,17,7,1
SBI56CVP2775924,90,25,22,3,1
SBI22FUW0523205,98,15,10,5,1
SBI23QPI5396176,97,26,17,9,1
SBI64ADX7074424,83,16,11,5,1
SBI06CHE5098129,95,22,16,6,1
SBI29GGP9771696,93,33,24,9,1
SBI68HEE8977323,73,24,23,1,1
SBI16TLY6825237,73,25,23,2,1
SBI03GWY4765517,65,27,19,8,1
SBI67ZWF6529573,66,31,22,9,1
SBI80RNM2079801,20,18,11,7,1
SBI97NSR3942872,78,26,18,8,1
SBI19YKJ7461483,69,24,19,5,1
SBI60ZDC7094074,21,23,21,2,1
SBI58YOA8426492,80,22,18,4,1
SBI74AJN7684328,84,23,18,5,1
SBI67JJN2708074,96,29,16,13,1
SBI97AYP8523417,76,26,25,1,1
SBI41YEI8650410,86,25,16,9,1
SBI76UBO4883875,85,19,13,6,1
SBI00MPI0003529,22,19,15,4,1
SBI22UYM9293676,24,24,13,11,1
SBI09RDP0513207,92,32,28,4,1
SBI28FOV0445360,23,22,19,3,1
SBI97WZB4219634,68,23,17,6,1
SBI08AJR7972249,62,19,11,8,1
SBI20PNR9955853,73,24,18,6,1
SBI76OWQ8764468,97,36,27,9,1
SBI38MEI2891860,18,25,21,4,1
SBI33OBL1050145,67,23,14,9,1
SBI12MBK2441577,62,21,18,3,1
SBI15XQV2792249,76,27,25,2,1
SBI17FQW4410777,99,25,17,8,1
SBI79XQC9363640,83,21,20,1,1
SBI39LZC1974608,94,32,20,12,1
SBI82IMK9987242,20,24,13,11,1
SBI06ZII6015628,83,30,18,12,1
SBI52IDX1396245,67,21,14,7,1
SBI64EIH5017054,97,19,13,6,1
SBI81MNX6868048,18,19,16,3,1
SBI97JIQ8305485,80,23,14,9,1
SBI95XOF6373310,91,33,26,7,1
SBI14BUU1530338,92,26,21,5,1
SBI22TYT1296039,23,13,11,2,1
SBI47CEI8952339,68,29,22,7,1
SBI30PLN0114024,81,18,17,1,1
SBI29GMG5638195,95,21,19,2,1
SBI53TIE4437827,64,27,14,13,1
SBI66VLM6397263,20,25,17,8,1
SBI40BYC7355143,67,26,16,10,1
SBI29MHG8372698,23,12,7,5,1
SBI56SNP4717156,63,21,13,8,1
SBI28UUR4083705,69,22,14,8,1
SBI89CXO3458726,71,22,21,1,1
SBI44CKM9083381,73,24,22,2,1
SBI10EMZ9840103,18,28,23,5,1
SBI99SFD9428255,86,20,13,7,1
SBI05JOA9186070,23,14,8,6,1
SBI24EIH5614358,80,27,15,12,1
SBI57RRR7745181,18,24,22,2,1
SBI41NAB9163089,96,33,28,5,1
SBI67BTE4367353,71,25,19,6,1
SBI35PDG8852518,22,27,14,13,1
SBI92EPQ7009086,64,37,36,1,1
SBI77CXJ2078541,86,29,19,10,1
SBI33TEK8952625,68,24,16,8,1
SBI09ZPY9374961,97,34,24,10,1
SBI20WLG0727259,84,20,17,3,1
SBI82JUS2253834,84,28,27,1,1
SBI31YJI1488726,82,27,23,4,1
SBI15CIO2505994,24,21,13,8,1
SBI15EJY7553673,93,20,16,4,1
SBI25RAN3435191,77,26,24,2,1
SBI08NGV4167302,63,27,24,3,1
SBI18PWM2274982,88,21,15,6,1
SBI98DFD0395740,77,29,16,13,1
SBI51UZR6573520,21,18,12,6,1
SBI97QAM2427509,69,28,17,11,1
SBI39XDV9711300,99,24,15,9,1
SBI98RNT6856661,95,27,15,12,1
SBI56WPO5904768,66,23,13,10,1
SBI27XEK6617986,20,24,19,5,1
SBI33IWL0377868,19,30,20,10,1
SBI81LIR4662893,22,26,18,8,1
SBI48MOV2603887,20,33,32,1,1
SBI82HDX2793559,93,25,23,2,1
SBI70APF9059270,19,24,22,2,1
SBI09MPE5663112,91,31,19,12,1
SBI90TME9702827,67,27,14,13,1
SBI42ZRV9443635,86,21,12,9,1
SBI43EAJ4587085,83,23,14,9,1
SBI64XCB4433607,82,28,21,7,1
SBI03TJI6666131,67,18,13,5,1
SBI06LIT2402667,20,28,26,2,1
SBI27ZXN4679255,85,19,15,4,1
SBI12PSV7161224,74,21,11,10,1
SBI40IJI1680148,70,24,17,7,1
SBI93FRD5222789,96,28,17,11,1
SBI62KLC8115617,73,22,13,9,1
SBI54EBK4569650,91,25,18,7,1
SBI73AVD9862050,22,24,23,1,1
SBI06MTD6051702,22,31,22,9,1
SBI06IOA3917945,64,21,13,8,1
SBI37RDK4272083,19,26,25,1,1
SBI65QXO6450839,79,18,16,2,1
SBI05IEV3563106,18,27,18,9,1
SBI75KGZ3101791,76,19,15,4,1
SBI64HSF6904347,71,23,22,1,1
SBI16PVB7812400,86,22,21,1,1
SBI62GPQ9353723,72,27,24,3,1
SBI93QPK4897102,70,28,18,10,1
SBI38DFM0642499,88,19,10,9,1
SBI26RJK9664707,87,22,20,2,1
SBI01TMM4152010,79,27,20,7,1
SBI61XKU3134505,78,27,17,10,1
SBI01VZW3957287,74,34,23,11,1
SBI37DCP1619384,62,16,11,5,1
SBI99GYE4025738,19,21,17,4,1
SBI79FSZ2159213,71,28,21,7,1
SBI09BTQ2572888,83,26,23,3,1
SBI08PMR3087560,70,22,15,7,1
SBI78LYN7670813,66,26,19,7,1
SBI89EBD9488020,76,26,21,5,1
SBI95UEF1866762,60,21,14,7,1
SBI40WEH3568358,82,26,24,2,1
SBI48VUZ0795859,64,21,13,8,1
SBI93OVN9459206,90,23,22,1,1
SBI45JHC7368272,76,20,15,5,1
SBI02EFL8472038,63,26,21,5,1
SBI92EFD8439229,64,11,6,5,1
SBI49LMO0770959,86,27,18,9,1
SBI62DTD2568512,96,22,15,7,1
SBI85ZLL9225561,63,25,15,10,1
SBI38GLO9515348,77,25,14,11,1
SBI27KME6203818,77,21,11,10,1
SBI90OKW8298608,91,29,20,9,1
SBI13INX1997120,69,21,13,8,1
SBI04ITC5098139,97,27,26,1,1
SBI70VWJ6387763,22,26,23,3,1
SBI96ITY9245099,65,28,18,10,1
SBI65RYH0334977,73,18,16,2,1
SBI85PWP6138510,61,26,23,3,1
SBI63JUI3258045,24,18,10,8,1
SBI32EPF4140000,77,30,27,3,1
SBI01QEH4795887,97,26,20,6,1
SBI14LKK6937169,75,20,19,1,1
SBI62VAW9560000,95,27,24,3,1
SBI20QZT1202295,23,30,22,8,1
SBI43WPW6852145,69,28,26,2,1
SBI11UKR4925904,77,24,17,7,1
SBI03JPW5837530,85,24,23,1,1
SBI08ABZ9041591,96,30,23,7,1
SBI02BNJ4784502,77,24,13,11,1
SBI75GPJ3107972,87,23,15,8,1
SBI75DTD5761157,94,26,15,11,1
SBI99CQP4182130,19,33,28,5,1
SBI34PKB8716878,95,28,19,9,1
SBI13VRI5076436,73,34,24,10,1
SBI51KCU0198115,82,26,23,3,1
SBI39JDQ4551457,90,29,27,2,1
SBI74TFO3705724,89,23,20,3,1
SBI19TBI1827945,23,17,11,6,1
SBI69GVO1399347,23,17,11,6,1
SBI79KQL1008023,20,30,17,13,1
SBI69SUW5371942,25,35,23,12,1
SBI47YGC2659979,94,22,20,2,1
SBI44ITJ3002753,79,23,13,10,1
SBI58OMS4620077,63,26,25,1,1
SBI56HKQ6954310,71,23,12,11,1
SBI91DOK0772710,20,23,15,8,1
SBI96CLO8928884,76,25,15,10,1
SBI72CZV3485422,90,22,13,9,1
SBI71YSA8040211,92,22,21,1,1
SBI75LWV0887881,89,26,14,12,1
SBI49OJW7491966,99,34,29,5,1
SBI97FFY3100186,22,20,12,8,1
SBI10WBU6977784,65,20,13,7,1
SBI25ISZ4266623,60,31,23,8,1
SBI63OAT3620089,24,28,17,11,1
SBI13VDF3806530,23,27,23,4,1
SBI34YHE1445472,75,26,15,11,1
SBI62ZMU7842611,99,19,12,7,1
SBI39FHB4723388,70,28,15,13,1
SBI78HYV1724363,68,23,14,9,1
SBI41GXB9817496,76,30,18,12,1
SBI48KNI3629817,79,22,12,10,1
SBI83GZZ4015800,94,16,12,4,1
SBI52RHR8402635,87,22,20,2,1
SBI49SMY1875003,84,24,22,2,1
SBI17CPS8059824,63,21,19,2,1
SBI28TKS5412015,70,25,24,1,1
SBI34AGC2763855,79,27,22,5,1
SBI88FMX0023576,71,31,20,11,1
SBI28JLX7391020,70,18,15,3,1
SBI95IJZ0830346,95,23,20,3,1
SBI56IRX9970769,87,30,28,2,1
SBI52UDP9622812,71,25,24,1,1
SBI61YIX9339009,18,22,20,2,1
SBI49HEO7139713,83,18,16,2,1
SBI17RUG4996603,67,28,17,11,1
SBI88BNU6257843,98,36,20,16,1
SBI36TLA5307098,70,16,10,6,1
SBI63NKD9398974,91,33,19,14,1
SBI53NNW1933425,67,23,20,3,1
SBI18IPA0408297,71,25,20,5,1
SBI99PCA9391832,62,29,16,13,1
SBI04NEI4357541,83,27,24,3,1
SBI69PFG4250162,24,22,17,5,1
SBI03VYB7457990,72,24,22,2,1
SBI71QIW0032490,93,32,26,6,1
SBI14YFN9183349,88,28,18,10,1
SBI75CYP6806599,82,24,16,8,1
SBI70FPU3038460,20,19,18,1,1
SBI72KOM9819533,77,34,30,4,1
SBI72EHI4501738,22,30,29,1,1
SBI58VNZ1140241,64,27,16,11,1
SBI41OPN6382307,77,32,19,13,1
SBI46JIS7754981,93,21,20,1,1
SBI94UIS8482441,23,29,26,3,1
SBI26KGP8538482,90,23,19,4,1
SBI35XXG0658402,69,14,13,1,1
SBI03UIQ8835630,85,30,21,9,1
SBI42MWF5055507,92,29,16,13,1
SBI12ADP1311213,89,27,18,9,1
SBI64ZYW4861054,80,40,21,19,1
SBI72RGF8280645,87,34,29,5,1
SBI55WAL2117397,72,27,17,10,1
SBI78NWA2562784,82,20,12,8,1
SBI79FTX4789109,62,28,16,12,1
SBI36CJR6213118,96,33,23,10,1
SBI37FUF6477631,76,23,16,7,1
SBI68MAZ1189939,19,22,12,10,1
SBI20AFY6743673,63,15,11,4,1
SBI34WSK5586192,85,27,18,9,1
SBI06GXQ5229510,22,23,13,10,1
SBI74SMU6628719,90,28,19,9,1
SBI93BFC7666775,69,27,17,10,1
SBI44LGK7374192,76,44,25,19,1
SBI81HDZ9946244,77,35,29,6,1
SBI13SCJ8623065,97,23,19,4,1
SBI11RTW2152500,66,17,11,6,1
SBI83TZI5858256,64,31,21,10,1
SBI27SNU7272469,62,23,13,10,1
SBI37HTV2156958,93,27,22,5,1
SBI19ZVE2365407,97,20,17,3,1
SBI59XSJ6758050,64,24,15,9,1
SBI78KDT3744858,97,26,14,12,1
SBI47WZR3210799,70,16,14,2,1
SBI26KZQ6005052,73,20,15,5,1
SBI02GPQ1631920,60,31,20,11,1
SBI16QWF4094308,21,26,17,9,1
SBI21NXH3086165,81,23,14,9,1
SBI21BUM0756395,24,20,14,6,1
SBI96PHM0074770,69,20,17,3,1
SBI58ZIM5993608,85,27,16,11,1
SBI42UMR8146150,77,25,17,8,1
SBI19NEY8432081,63,23,20,3,1
SBI08AYZ9558377,63,24,20,4,1
SBI64DQU6845508,94,13,10,3,1
SBI04WSD3073746,69,18,12,6,1
SBI14DXI8123729,84,29,19,10,1
SBI70EXI1137995,88,15,11,4,1
SBI16DFX8253606,62,25,24,1,1
SBI39GYK5599864,25,21,15,6,1
SBI88CLD3401883,89,29,15,14,1
SBI39WGB8699304,62,31,28,3,1
SBI58NGG6583015,96,20,12,8,1
SBI35ACR4982947,81,21,15,6,1
SBI09EUR5519215,90,23,12,11,1
SBI28XPP6535261,65,25,13,12,1
SBI57VZG8546201,62,28,23,5,1
SBI94UDF9602824,74,29,27,2,1
SBI89CHD1498321,73,29,19,10,1
SBI41HSS1357031,63,23,15,8,1
SBI69QUV0323843,78,15,12,3,1
SBI24IPA3630738,21,26,17,9,1
SBI89OJV0401521,98,22,13,9,1
SBI45ZEN3698282,71,31,20,11,1
SBI28ZBJ6626191,62,23,16,7,1
SBI07HZR5403135,99,25,16,9,1
SBI96XPK6207571,98,23,21,2,1
SBI79QUX7233646,70,20,13,7,1
SBI80XQV8011850,84,22,18,4,1
SBI19KDE3509047,21,22,17,5,1
SBI64IDP9109072,80,26,20,6,1
SBI92LEN5169820,63,24,21,3,1
SBI47PIE2132817,60,25,18,7,1
SBI83NUO2868891,72,27,20,7,1
SBI02QSF9484232,75,31,21,10,1
SBI25WAQ6883591,89,26,14,12,1
SBI21SNY4418311,74,26,14,12,1
SBI13ZIJ7261930,96,19,15,4,1
SBI58DVX6781701,20,19,14,5,1
SBI14SEF9012118,62,31,27,4,1
SBI37PJZ6285055,88,29,20,9,1
SBI24WDE9923813,86,33,30,3,1
SBI58LMX7444255,84,27,20,7,1
SBI57VGS7875840,23,28,27,1,1
SBI02VUN6026427,81,23,20,3,1
SBI09UVO7204219,88,27,20,7,1
SBI34WCR2392365,87,27,23,4,1
SBI74PJQ6761944,94,15,11,4,1
SBI11SGN7372991,86,27,22,5,1
SBI06ISL0582378,67,25,19,6,1
SBI11VBA8374514,76,22,16,6,1
SBI11LLF9586488,82,15,9,6,1
SBI78CFN9779801,83,29,20,9,1
SBI47LRU1609081,23,18,16,2,1
SBI27OZV7272609,98,25,14,11,1
SBI97JRC8298894,99,28,25,3,1
SBI71STE6390234,86,19,17,2,1
SBI13ZID1556089,82,22,12,10,1
SBI01LNT6682532,89,29,15,14,1
SBI59OBY1543392,18,27,22,5,1
SBI45IIH7736210,81,24,19,5,1
SBI32AQN5449385,83,23,16,7,1
SBI44RSV5891804,92,22,21,1,1
SBI41TFG9648803,24,23,16,7,1
SBI40YWK0193869,72,28,25,3,1
SBI60WVQ2783353,97,22,17,5,1
SBI04TKI8681875,72,16,11,5,1
SBI24ZTO0044983,97,29,27,2,1
SBI54NAA2593355,21,28,24,4,1
SBI22CWK9623306,61,19,11,8,1
SBI59XLZ3145973,18,22,17,5,1
SBI58GMZ0268519,86,18,17,1,1
SBI40GSQ8369871,86,16,9,7,1
SBI14UCH8243015,64,21,12,9,1
SBI43TIC9106864,24,24,18,6,1
SBI89MTT0718751,62,25,22,3,1
SBI51ZAR7358770,64,24,21,3,1
SBI12DQY8608228,68,39,37,2,1
SBI67LWP2057203,77,26,14,12,1
SBI82KUE4533430,91,20,12,8,1
SBI58ZVY1632209,91,29,25,4,1
SBI85ZBI7122775,62,32,20,12,1
SBI87ZNE6909155,92,33,18,15,1
SBI84SEH0084829,74,25,20,5,1
SBI44FOY1692644,74,27,23,4,1
SBI35QFX4854323,23,32,26,6,1
SBI69IPY0186564,86,26,17,9,1
SBI62KKM6639188,75,21,14,7,1
SBI92TKY1547905,90,22,16,6,1
SBI56URP8071198,85,24,21,3,1
SBI39EZW0394384,77,25,14,11,1
SBI08PXR8141429,21,17,14,3,1
SBI69IJA7606118,81,19,17,2,1
SBI78CUX0042431,83,20,12,8,1
SBI25SQD8922231,19,33,24,9,1
SBI72XZS4457977,65,24,22,2,1
SBI80GIK4464399,21,25,18,7,1
SBI52BYL0922801,96,25,17,8,1
SBI04XMV3533731,24,17,11,6,1
SBI56VDM2172530,81,18,15,3,1
SBI52MJM4287664,64,21,12,9,1
SBI38OMA4876878,81,23,18,5,1
SBI44QPO1239961,61,20,14,6,1
SBI21KAJ2026888,76,33,26,7,1
SBI15ZGM8187730,72,26,20,6,1
SBI50LFQ9190901,91,24,20,4,1
SBI95YHV0332328,90,25,16,9,1
SBI35NXA9567863,19,27,21,6,1
SBI05MJZ1117725,67,27,20,7,1
SBI62DZD7194186,86,18,11,7,1
SBI33FLB8615249,86,31,23,8,1
SBI70KNR5020466,96,24,19,5,1
SBI33JAH7406188,73,22,14,8,1
SBI20DTL0717639,61,28,16,12,1
SBI73UZM6960716,86,21,17,4,1
SBI66LUY9404686,70,20,16,4,1
SBI34KKF3318010,70,19,12,7,1
SBI00UHM9382688,73,28,22,6,1
SBI72JBU8367785,78,25,17,8,1
SBI24PJU0306236,76,29,27,2,1
SBI90NIU9924216,99,26,18,8,1
SBI21QDI6471588,64,24,15,9,1
SBI92AHY0254900,60,22,12,10,1
SBI64ZLC3251270,75,23,20,3,1
SBI82RHE4537497,74,19,12,7,1
SBI39FTX1073591,71,31,18,13,1
SBI44JIY1038064,83,22,12,10,1
SBI74ITZ7965456,71,22,14,8,1
SBI33EFF6824129,24,20,18,2,1
SBI09YSG6145672,18,26,19,7,1
SBI03NUF5684752,94,19,12,7,1
SBI37UUT0690770,24,29,20,9,1
SBI63ZLU0190350,65,30,25,5,1
SBI08TEZ9489103,72,25,21,4,1
SBI61YQC0807892,90,25,16,9,1
SBI28OQY3267555,77,18,15,3,1
SBI78XKO0140886,95,18,11,7,1
SBI57LOX7747899,25,25,24,1,1
SBI48SFL9209215,64,18,16,2,1
SBI53QBC3849219,72,26,15,11,1
SBI22KCG0964013,90,22,16,6,1
SBI60RWL5780954,78,31,19,12,1
SBI77WEM5566979,23,31,18,13,1
SBI50IXI2162398,89,31,19,12,1
SBI89YFH2277753,74,31,26,5,1
SBI53HWF5178213,86,19,12,7,1
SBI37MFD3055322,91,18,11,7,1
SBI52UXB3645340,79,31,29,2,1
SBI00QOY9421552,97,23,19,4,1
SBI21ZIG1586090,79,28,20,8,1
SBI37LNU2488342,70,22,21,1,1
SBI01VYP9854992,77,29,18,11,1
SBI18DJZ5070137,74,19,12,7,1
SBI46UXO1939353,77,25,15,10,1
SBI78AVX6178892,62,29,20,9,1
SBI65GKD7817550,62,21,19,2,1
SBI42XAF3994922,85,19,16,3,1
SBI46BAQ3922336,86,27,22,5,1
SBI20IMD8805101,24,21,12,9,1
SBI03XLD8718907,86,23,18,5,1
SBI52JSD1489740,19,30,27,3,1
SBI15CKM8034281,94,24,22,2,1
SBI43JJR0480947,63,29,18,11,1
SBI84DBI6034452,66,20,16,4,1
SBI91EOV9957096,94,24,16,8,1
SBI33MFZ1430709,88,25,19,6,1
SBI83GPL5081863,68,31,25,6,1
SBI23MSB8338487,84,22,15,7,1
SBI17VPB3921521,22,24,20,4,1
SBI53KWF7854381,80,21,14,7,1
SBI52HVN2596834,83,29,20,9,1
SBI46DMM3078010,65,22,13,9,1
SBI27DKI4170223,76,17,9,8,1
SBI28ATP5651133,23,25,14,11,1
SBI91KFQ2646904,94,20,16,4,1
SBI97FFB3309805,73,24,16,8,1
SBI95MKD9086431,18,22,21,1,1
SBI63QJZ2674713,61,22,13,9,1
SBI19TDZ7968061,84,24,18,6,1
SBI12TAQ2630783,19,21,12,9,1
SBI00DZJ8510915,93,23,22,1,1
SBI49OAK6194000,82,23,16,7,1
SBI41TVX2239924,80,27,18,9,1
SBI22SSS7271405,67,24,16,8,1
SBI33DEK1092036,61,22,14,8,1
SBI06NFA5374202,25,27,18,9,1
SBI94MMF9043229,83,38,34,4,1
SBI32KLJ4637298,63,32,20,12,1
SBI57SIM6858047,20,25,22,3,1
SBI22QZW9845447,78,30,28,2,1
SBI49CGX1674945,89,26,20,6,1
SBI12UBP5641091,89,31,19,12,1
SBI58VXC4519931,68,29,19,10,1
SBI63DZD2251228,62,27,20,7,1
SBI49HND0817136,84,24,13,11,1
SBI17AJN6615307,66,26,15,11,1
SBI83SFG4706770,71,33,25,8,1
SBI06WBT3327198,64,21,14,7,1
SBI15UOS4006074,81,24,22,2,1
SBI64IDN5091242,92,28,15,13,1
SBI95XZI6344348,66,15,14,1,1
SBI13UDA3716124,22,32,26,6,1
SBI69VTR5756957,70,31,16,15,1
SBI86IMS4448126,61,18,13,5,1
SBI90NGV3270084,24,29,25,4,1
SBI00GNE6545343,86,32,23,9,1
SBI41JYD0901139,75,19,14,5,1
SBI42XES7124566,63,26,21,5,1
SBI86KYT3884630,64,23,16,7,1
SBI71QYI8207563,76,29,16,13,1
SBI25DMZ5234968,62,22,16,6,1
SBI74CFF0743521,71,22,15,7,1
SBI71PNK6929715,95,29,23,6,1
SBI49TEN4394923,20,25,21,4,1
SBI72SOH3977439,88,23,20,3,1
SBI07HLN3240655,81,25,21,4,1
SBI73UZN3728308,70,29,24,5,1
SBI47HPN5617817,71,32,27,5,1
SBI33HJN8511206,92,17,12,5,1
SBI32YFU5025483,85,16,9,7,1
SBI67IZM7117924,74,30,21,9,1
SBI57AMP8896361,96,35,19,16,1
SBI24YNL5351503,74,27,26,1,1
SBI42YMG6645644,19,25,23,2,1
SBI01HUI0494620,20,31,26,5,1
SBI01KOV5054102,69,24,14,10,1
SBI40GCP6466061,89,18,12,6,1
SBI91CLF6423872,88,16,15,1,1
SBI83QYY1485866,64,22,15,7,1
SBI89EVF6192318,88,33,31,2,1
SBI72ESV9336657,73,23,12,11,1
SBI40GFF4551746,73,24,19,5,1
SBI31IIC8673475,85,19,11,8,1
SBI34JHO4308282,83,21,19,2,1
SBI43XZC8263412,72,30,19,11,1
SBI21LRB8368539,70,18,15,3,1
SBI40PLX8613443,71,23,20,3,1
SBI13GYJ0860943,80,29,28,1,1
SBI32MIJ2549142,76,18,12,6,1
SBI44RBV1343134,81,22,14,8,1
SBI68MVZ6150815,96,23,22,1,1
SBI78YAG3176080,91,13,11,2,1
SBI80NYF3253941,66,16,9,7,1
SBI69PTY4340417,19,17,13,4,1
SBI58YWA2401844,20,29,21,8,1
SBI24NAX4405667,91,23,22,1,1
SBI79PKA5551446,71,25,17,8,1
SBI75QKP7855070,67,27,16,11,1
SBI35OQD6325625,20,20,14,6,1
SBI75UIJ6721912,89,27,26,1,1
SBI50SWI6230999,97,24,21,3,1
SBI91NIJ0323966,90,39,27,12,1
SBI10WJP8968499,75,30,26,4,1
SBI63EVF3331585,95,22,16,6,1
SBI67XKD8367503,69,23,20,3,1
SBI83JMW0967225,69,27,22,5,1
SBI90DFO2351285,97,29,16,13,1
SBI95GTC6087757,68,36,29,7,1
SBI22PTG8476246,91,22,16,6,1
SBI47RSZ9186300,92,17,11,6,1
SBI76TZC7160838,95,23,21,2,1
SBI12TIV2734126,21,24,17,7,1
SBI34XVO9139815,19,21,16,5,1
SBI01EFQ6542983,77,33,23,10,1
SBI32MON9279552,96,30,16,14,1
SBI44AMV2466285,18,23,16,7,1
SBI38YEA5845067,22,25,20,5,1
SBI44QYW8845619,79,25,20,5,1
SBI96MIS9929854,24,34,22,12,1
SBI86FYI7706977,68,35,27,8,1
SBI05TXU2319801,94,32,30,2,1
SBI21UNM2410657,68,23,19,4,1
SBI91MVT5879481,86,27,23,4,1
SBI86JOR5258977,73,24,18,6,1
SBI41WIC6806197,79,18,17,1,1
SBI31CKU7256998,92,31,24,7,1
SBI73HLW8364009,91,21,17,4,1
SBI36FJB5472226,91,16,14,2,1
SBI24NQJ0401873,76,25,20,5,1
SBI56PJA6909822,83,21,16,5,1
SBI59GLR1574605,75,26,14,12,1
SBI16UNB0247494,95,30,26,4,1
SBI49HQV9371663,99,22,16,6,1
SBI10VLX0620899,94,20,17,3,1
SBI62HDU9441229,19,30,20,10,1
SBI99XKU1618473,65,22,13,9,1
SBI87AVB8909433,98,31,29,2,1
SBI21YXW3745417,77,24,21,3,1
SBI59JTN1836774,87,26,18,8,1
SBI73HUH1566278,74,24,23,1,1
SBI68WYZ6846701,93,27,21,6,1
SBI02AHO4382559,69,19,13,6,1
SBI07VJC3411923,60,22,15,7,1
SBI64MRR9429863,60,10,8,2,1
SBI74YJS6621535,89,22,19,3,1
SBI31QPZ7492315,90,26,16,10,1
SBI75WIG5205006,84,25,17,8,1
SBI86ILJ5133728,81,22,17,5,1
SBI00YMT9791504,77,13,7,6,1
SBI14DCE6019670,98,25,24,1,1
SBI30TVW7509930,95,34,20,14,1
SBI77KAI1562589,21,17,12,5,1
SBI53EYO7503440,69,21,19,2,1
SBI05YTR3475226,65,24,21,3,1
SBI18YSY0622204,74,26,17,9,1
SBI40HRR8058543,82,24,20,4,1
SBI04VRS2506657,86,34,19,15,1
SBI87SJS2499222,63,24,13,11,1
SBI15FPN0849907,65,27,21,6,1
SBI27ITZ3925919,18,31,22,9,1
SBI33SKL4558255,74,33,23,10,1
SBI16WFH9828191,19,40,37,3,1
SBI14HFK8551379,67,24,13,11,1
SBI09ZPW2901148,99,28,25,3,1
SBI87ZTH1682213,84,32,21,11,1
SBI39IWL9633569,73,26,24,2,1
SBI42AJI1474007,86,25,14,11,1
SBI08GKW4878776,69,24,14,10,1
SBI43JNG9269694,64,31,18,13,1
SBI28MDT9762512,60,28,21,7,1
SBI67JYI8455627,85,21,15,6,1
SBI82FWP9829281,20,38,33,5,1
SBI95JXZ9896142,75,17,12,5,1
SBI84QJP0475422,63,26,16,10,1
SBI59XBM9121878,68,21,19,2,1
SBI52RBZ9154602,74,18,14,4,1
SBI10DYN8662387,71,25,19,6,1
SBI97SVD9657683,76,17,10,7,1
SBI50ZYF5251796,80,32,19,13,1
SBI04DSU1929970,62,28,26,2,1
SBI83PZA6373143,61,28,22,6,1
SBI46GTO2962738,99,19,10,9,1
SBI17ZFN6894989,65,25,16,9,1
SBI46APA2445277,69,23,20,3,1
SBI90GZS8757472,77,26,23,3,1
SBI19KCA0890015,86,33,25,8,1
SBI74OIG7822378,69,21,15,6,1
SBI50VWK0468046,72,20,19,1,1
SBI18QHP0073041,81,28,17,11,1
SBI97MGL3913419,21,29,21,8,1
SBI31ESR1110293,70,19,14,5,1
SBI00EGF5911215,65,25,24,1,1
SBI45AUR7887231,69,32,28,4,1
SBI84DRO5816838,61,20,16,4,1
SBI06EYW7538033,73,30,25,5,1
SBI41VKS6850940,83,32,30,2,1
SBI48ENA8629056,65,17,10,7,1
SBI83HPY7333224,89,28,26,2,1
SBI06KIP0814272,85,30,19,11,1
SBI55GZY8066490,80,23,12,11,1
SBI50HQM2717025,64,25,23,2,1
SBI75YIO1190153,85,25,14,11,1
SBI79WWQ5094410,61,25,16,9,1
SBI64SEZ2882958,21,27,22,5,1
SBI07OZF7263063,88,29,24,5,1
SBI06LZW0826563,76,19,18,1,1
SBI50GPV5234201,24,24,23,1,1
SBI82ZLQ4939968,88,16,9,7,1
SBI69NDI0859972,69,25,16,9,1
SBI99SNW6130102,71,30,27,3,1
SBI77RSC4662605,81,20,12,8,1
SBI95JMU0491217,23,30,22,8,1
SBI49FPE1307308,91,31,17,14,1
SBI56AAZ5436738,69,18,16,2,1
SBI56VDJ1707462,81,31,25,6,1
SBI22RFB5094929,65,34,21,13,1
SBI44PSW4537565,18,13,10,3,1
SBI41PBZ3767839,72,12,9,3,1
SBI29SJP9202111,83,27,22,5,1
SBI24JRX5551226,19,24,17,7,1
SBI64JYA4810792,92,20,19,1,1
SBI60BOW5311218,20,24,20,4,1
SBI45YYH7806933,66,25,16,9,1
SBI27FBB5905861,97,27,16,11,1
SBI65BPF9439305,66,30,29,1,1
SBI41GML8472898,81,20,12,8,1
SBI32BNC0827712,86,24,17,7,1
SBI76KZO7773056,82,26,24,2,1
SBI18SIB6580314,97,23,21,2,1
SBI06WBP6909998,25,40,26,14,1
SBI94RBI8732511,74,22,19,3,1
SBI73HNC9494999,80,24,16,8,1
SBI21XJG7287503,97,27,14,13,1
SBI17TNP6963538,75,30,27,3,1
SBI93PDA5435865,98,29,24,5,1
SBI47UVW5830711,62,16,15,1,1
SBI83VNZ5108167,99,25,20,5,1
SBI18NMH9634499,19,21,18,3,1
SBI85BKO6538269,83,32,27,5,1
SBI91BME9162735,91,29,19,10,1
SBI32NSA7066992,79,38,25,13,1
SBI59GCQ8592796,21,28,18,10,1
SBI12EAJ9639330,63,31,19,12,1
SBI88KDQ8263419,60,19,16,3,1
SBI62HRU3700834,62,27,19,8,1
SBI67QXM6102510,67,20,17,3,1
SBI04UDP7217186,64,24,16,8,1
SBI79VZW7374627,24,22,21,1,1
SBI77BEN1440738,69,11,8,3,1
SBI19LSM3265708,83,24,22,2,1
SBI23BTV5446835,23,35,24,11,1
SBI77VET6018660,68,22,13,9,1
SBI61FRO9189162,80,27,23,4,1
SBI76INI7771985,64,28,18,10,1
SBI43QMG5661488,21,25,20,5,1
SBI59BCH5015866,78,21,16,5,1
SBI46KOX7534428,67,24,23,1,1
SBI48YOO1136529,18,13,8,5,1
SBI08KPM3664006,22,28,24,4,1
SBI38YPU4126564,23,18,14,4,1
SBI59TNR3627194,77,28,27,1,1
SBI13VID5363662,91,27,26,1,1
SBI69CLZ5125687,95,23,15,8,1
SBI90YBJ1653864,94,20,13,7,1
SBI11GAK3047114,60,21,18,3,1
SBI24CUR7654196,77,20,14,6,1
SBI54HSJ5896377,63,22,18,4,1
SBI11WAK0434854,76,26,16,10,1
SBI51ZTN0547355,94,28,18,10,1
SBI61YAR1824374,19,25,17,8,1
SBI26DAQ4811935,81,31,23,8,1
SBI45BYU7367694,61,27,20,7,1
SBI09PJY6109369,93,19,17,2,1
SBI16QMC4561895,72,24,21,3,1
SBI42UHI0137445,74,21,11,10,1
SBI50OFL3059357,23,29,18,11,1
SBI27VPM4545744,71,30,17,13,1
SBI33XDD3139378,84,18,16,2,1
SBI16QVK2149083,73,21,12,9,1
SBI14YCX0671160,98,29,22,7,1
SBI77ZKE9923516,67,24,14,10,1
SBI28UOY0882640,75,28,16,12,1
SBI01TYV3544257,95,26,23,3,1
SBI02NLW1724316,61,26,22,4,1
SBI99LRX0330241,81,25,24,1,1
SBI58KXA2803082,20,24,15,9,1
SBI09IUT2445902,20,34,31,3,1
SBI13ZDZ6654909,20,33,27,6,1
SBI19HON3534755,97,24,18,6,1
SBI80GVM1793001,89,30,27,3,1
SBI22JWW4185223,71,29,19,10,1
SBI47OKH1627257,83,29,20,9,1
SBI10OZS3408201,66,22,21,1,1
SBI82KEC4829347,64,28,21,7,1
SBI96APL2130212,25,24,17,7,1
SBI29VGO6034449,21,27,21,6,1
SBI11JQQ9266082,71,23,14,9,1
SBI58MEE8824585,78,25,14,11,1
SBI60YEC0665385,62,26,23,3,1
SBI91GYK4089799,25,18,11,7,1
SBI23XWH4550591,71,41,25,16,1
SBI98UMM4516150,65,23,13,10,1
SBI21MDI9504880,97,17,13,4,1
SBI93YDT8492742,91,28,15,13,1
SBI80MFP5719955,21,23,17,6,1
SBI19QGB0710569,21,33,17,16,1
SBI48EBC1791368,81,31,18,13,1
SBI88RRK6600504,22,16,14,2,1
SBI75ZUU7685465,19,22,14,8,1
SBI49YXS8397337,24,22,20,2,1
SBI41SGJ8425810,77,25,17,8,1
SBI72FZA7535879,73,21,20,1,1
SBI75JWT9463785,61,23,18,5,1
SBI48CMQ1834039,97,27,25,2,1
SBI62GPP8509083,81,25,22,3,1
SBI00VHM6337007,71,29,17,12,1
SBI16PLX6917698,75,17,13,4,1
SBI84XLE3585221,22,34,21,13,1
SBI41ILZ3862697,18,22,12,10,1
SBI58FSV7150623,22,28,25,3,1
SBI38LPP6217040,71,19,15,4,1
SBI55RGV7835256,93,22,18,4,1
SBI31MZJ0817001,62,20,15,5,1
SBI91ALZ3188215,19,27,23,4,1
SBI53HRZ0202456,83,26,21,5,1
SBI93TRX7559331,73,25,22,3,1
SBI62KHH9656763,18,22,20,2,1
SBI92TOI1434228,79,26,25,1,1
SBI10BPH0381485,73,22,19,3,1
SBI79DQV3221217,63,27,21,6,1
SBI66NBY4684097,73,24,14,10,1
SBI19ROD0182410,18,18,11,7,1
SBI63LMO8423257,92,25,21,4,1
SBI37AJD3503076,93,28,23,5,1
SBI51XQW5231351,70,30,21,9,1
SBI17FIK0586848,68,23,12,11,1
SBI75SZT0312603,96,27,21,6,1
SBI01ZME1953283,76,27,26,1,1
SBI22UVH7800094,94,28,24,4,1
SBI96MPV7412164,18,24,23,1,1
SBI93PEA7716577,74,31,22,9,1
SBI80GET1487441,84,27,21,6,1
SBI66NOK4498996,94,23,15,8,1
SBI07ICP2339430,72,24,13,11,1
SBI86ZYX1520974,75,14,11,3,1
SBI99UVR2010002,18,24,23,1,1
SBI19ZIT2517848,73,18,15,3,1
SBI15OYW0248849,91,25,23,2,1
SBI04BIZ6160121,93,29,16,13,1
SBI60ZNB0038803,71,26,25,1,1
SBI40RMN7107652,69,25,19,6,1
SBI46QNU9714037,76,21,15,6,1
SBI46OBA7535903,25,24,20,4,1
SBI61DSZ5825907,73,26,16,10,1
SBI20APY7045259,25,25,23,2,1
SBI90HJN2130946,22,23,18,5,1
SBI65JDE5714242,22,33,27,6,1
SBI05ZZZ9211776,78,26,25,1,1
SBI13JGY0027715,78,21,18,3,1
SBI28WTB3871560,19,31,30,1,1
SBI69RPJ6400976,88,22,18,4,1
SBI68ZLV1959782,88,28,17,11,1
SBI14STW3775301,63,27,23,4,1
SBI62RZZ8985357,25,23,13,10,1
SBI39IIF7113109,81,33,26,7,1
SBI42DDV6519448,95,26,20,6,1
SBI79VVN6889066,68,20,18,2,1
SBI13BCV3149176,20,18,16,2,1
SBI51LXG6884467,97,27,26,1,1
SBI83NKO9621737,21,22,14,8,1
SBI98AEX9977300,82,28,26,2,1
SBI80TCC7630581,63,11,9,2,1
SBI59BID1090081,92,23,15,8,1
SBI77PSG9172954,21,21,15,6,1
SBI19MOB8741392,88,20,17,3,1
SBI22YUF3134606,64,23,14,9,1
SBI98ZTQ0282928,64,22,12,10,1
SBI38KYO0844171,67,23,16,7,1
SBI08YOY2771068,92,26,20,6,1
SBI58DRQ1376115,76,20,18,2,1
SBI50PBQ2841931,23,33,25,8,1
SBI74RKA3701547,20,16,9,7,1
SBI17ZCY1516210,88,25,23,2,1
SBI58QKR2624064,83,35,24,11,1
SBI45GFO5600395,68,26,19,7,1
SBI79BGR1182313,89,27,24,3,1
SBI82BTN6726272,90,27,25,2,1
SBI58KJJ7173255,66,26,20,6,1
SBI60QIY7736294,65,31,17,14,1
SBI46OFP8144247,91,28,21,7,1
SBI26CVA8628754,77,31,22,9,1
SBI65HOU0573693,69,17,16,1,1
SBI90BDH2437394,79,26,18,8,1
SBI85LOC4199400,74,27,15,12,1
SBI07FUM3107407,99,34,33,1,1
SBI08FXK9801192,73,31,21,10,1
SBI21VGI1846251,19,27,20,7,1
SBI27NMT8638255,90,20,16,4,1
SBI72DIM3308852,63,32,24,8,1
SBI26QTJ7670558,84,25,24,1,1
SBI09YSO2583349,87,21,13,8,1
SBI09QLJ6952333,99,20,16,4,1
SBI46NWO1460946,99,31,18,13,1
SBI16EMS8051335,68,28,25,3,1
SBI64VTE4730161,19,18,15,3,1
SBI45YZU8155157,86,25,22,3,1
SBI69MAT6011026,75,21,17,4,1
SBI62MJE3050810,67,26,22,4,1
SBI34IUE2337121,91,26,14,12,1
SBI06WUW4172761,91,24,21,3,1
SBI74KNQ1597431,85,25,13,12,1
SBI79VQA2810771,60,27,25,2,1
SBI37LIY5524834,98,23,12,11,1
SBI93HAC3049193,98,22,12,10,1
SBI51MJH5811365,84,22,15,7,1
SBI85YWT4301564,88,30,24,6,1
SBI58QKZ5273365,81,12,8,4,1
SBI78SJQ1079662,60,20,17,3,1
SBI08KPH0589803,69,30,16,14,1
SBI39MUY9220803,70,29,27,2,1
SBI61DCR2231506,73,22,13,9,1
SBI88LIT2924596,89,29,26,3,1
SBI11RIR7903099,65,19,17,2,1
SBI04GYB8410972,98,16,10,6,1
SBI71PLL1824098,63,32,19,13,1
SBI48EJU2275141,71,27,23,4,1
SBI94EVL3430440,63,30,29,1,1
SBI97VPH1471959,78,20,13,7,1
SBI54AOY6390589,20,23,13,10,1
SBI36OTO3799183,79,23,14,9,1
SBI17ZMO2638769,84,24,20,4,1
SBI57DCV6413463,80,14,9,5,1
SBI28HCF4091346,60,21,17,4,1
SBI89GTY2134845,84,22,12,10,1
SBI90BXM7116470,60,23,18,5,1
SBI43XCM3006202,21,21,18,3,1
SBI16IVU0372698,72,31,25,6,1
SBI69BPO4435347,75,31,30,1,1
SBI15KEZ1392945,82,23,12,11,1
SBI54JID1762918,89,28,26,2,1
SBI76FPH1468528,92,23,20,3,1
SBI97WME8050097,95,25,14,11,1
SBI57CHZ2694122,82,28,21,7,1
SBI45YGX9996229,61,20,17,3,1
SBI11ZNU1844509,96,21,11,10,1
SBI23SHL9458993,90,22,20,2,1
SBI31MSR3960964,74,15,14,1,1
SBI66RRF7133221,62,19,13,6,1
SBI66DFQ4083147,64,31,24,7,1
SBI72XWP9058981,62,29,22,7,1
SBI92XCL7173635,74,28,19,9,1
SBI82JVN1038719,64,20,18,2,1
SBI68IAB5384004,70,25,22,3,1
SBI04CSO1121681,88,28,25,3,1
SBI70VHB8873045,75,26,14,12,1
SBI60PKH7189280,92,11,8,3,1
SBI19PNF6016906,77,36,30,6,1
SBI68JPE6961539,89,29,20,9,1
SBI29CSA0046749,96,24,15,9,1
SBI63OZB5055003,74,21,16,5,1
SBI74YQX1424222,74,24,16,8,1
SBI30VUS9749388,90,36,25,11,1
SBI47WBM8112042,95,25,21,4,1
SBI80SFE1823725,68,18,11,7,1
SBI12WGW6662709,18,21,14,7,1
SBI63OXJ3626367,89,20,14,6,1
SBI79DFW7775568,91,21,13,8,1
SBI21MCI5538924,98,28,20,8,1
SBI68NLC8719514,19,33,24,9,1
SBI29MEK1774856,80,13,10,3,1
SBI39HKU1211408,62,21,12,9,1
SBI61JYN3760229,87,23,12,11,1
SBI32EXG4912408,85,23,13,10,1
SBI33UNT1842897,75,26,14,12,1
SBI16HLK7636834,21,25,19,6,1
SBI90AHV4521323,92,19,10,9,1
SBI31JVV4591393,76,23,21,2,1
SBI14UNC1279290,86,32,23,9,1
SBI06RZW8089889,72,24,20,4,1
SBI38NGH0678944,84,35,26,9,1
SBI94GXF1519519,78,22,15,7,1
SBI92EZP9044630,61,17,16,1,1
SBI80AFA7439743,77,29,22,7,1
SBI93RFH2884717,70,33,24,9,1
SBI85LDI7295162,68,17,11,6,1
SBI85BBW4742098,83,22,19,3,1
SBI78NZF3226430,79,24,21,3,1
SBI45BYB8622595,95,26,18,8,1
SBI94DNU5952484,69,22,16,6,1
SBI42GPN6809954,88,20,19,1,1
SBI74KRK6391304,92,16,15,1,1
SBI37YEF1988913,67,27,24,3,1
SBI88FMZ4026990,69,20,17,3,1
SBI54IBL4100458,67,25,14,11,1
SBI19QTQ0745561,75,34,20,14,1
SBI96CNB4351658,66,18,10,8,1
SBI11DPA0936790,78,24,23,1,1
SBI55IAV3606056,98,24,17,7,1
SBI99SOB0118697,68,23,13,10,1
SBI57IAC9051037,62,28,16,12,1
SBI14WJY2141222,84,23,21,2,1
SBI70RYT9794930,97,33,30,3,1
SBI47ABP0835971,78,29,26,3,1
SBI13CMQ2847039,93,25,15,10,1
SBI08DHU6053731,69,22,19,3,1
SBI94VHM8678726,18,24,14,10,1
SBI24XVE4035644,23,25,15,10,1
SBI52DRU7913998,95,24,15,9,1
SBI51KEG2879696,84,31,28,3,1
SBI74EUZ6939010,96,28,17,11,1
SBI29MQM6453913,88,28,25,3,1
SBI45RFG6987359,60,27,17,10,1
SBI91RDA5303954,78,30,23,7,1
SBI39YBF4525231,63,25,24,1,1
SBI08NUG9214703,77,29,20,9,1
SBI33IAN4599487,68,18,16,2,1
SBI56AJX6654116,21,32,21,11,1
SBI36QTP6988876,74,24,23,1,1
SBI65OKO0750315,93,36,24,12,1
SBI90NOJ4036790,65,23,12,11,1
SBI67INB2470368,94,24,22,2,1
SBI89AIU5384169,73,31,17,14,1
SBI18OYO9942174,90,22,19,3,1
SBI24MDA8522304,98,22,12,10,1
SBI17IYE8672149,88,27,17,10,1
SBI01PJG3282071,93,20,19,1,1
SBI28FLY8855474,96,23,13,10,1
SBI29LIE6485206,61,35,28,7,1
SBI75JWV9004223,71,27,24,3,1
SBI60TKC9987092,89,18,15,3,1
SBI17FAR6884482,70,25,19,6,1
SBI57FWZ0611869,19,29,27,2,1
SBI31DAQ6753939,21,33,30,3,1
SBI25ZDF5324482,69,22,14,8,1
SBI58GPW6463574,89,21,15,6,1
SBI10XCC0048875,81,28,27,1,1
SBI51GWO4882676,20,31,17,14,1
SBI69ESF4932280,97,27,25,2,1
SBI98UHW5791861,98,26,22,4,1
SBI69UDT3594082,78,19,11,8,1
SBI91LAL6721621,19,25,19,6,1
SBI36NOO9706899,20,23,18,5,1
SBI38MWI1596250,71,30,23,7,1
SBI45HOZ0634079,61,26,24,2,1
SBI59SPC9480222,85,31,20,11,1
SBI39BMA0324738,76,21,14,7,1
SBI11QCX1636678,21,26,14,12,1
SBI49MRM9917717,69,20,17,3,1
SBI48AYO4012095,85,30,26,4,1
SBI25TMD4662644,66,29,24,5,1
SBI52WAU3004369,20,21,12,9,1
SBI94VZF8932242,65,18,14,4,1
SBI54SKZ0031854,86,28,16,12,1
SBI27VTO1426401,97,23,18,5,1
SBI82YGG5938829,92,36,19,17,1
SBI08GUZ9840861,78,26,25,1,1
SBI19WDM3415167,93,18,15,3,1
SBI28ZTX1175259,21,24,21,3,1
SBI17IKH8412273,89,22,15,7,1
SBI78DQV2856681,89,27,25,2,1
SBI41FZD1743508,95,31,28,3,1
SBI35NPL0693663,91,21,12,9,1
SBI06NFZ1347406,94,21,12,9,1
SBI05EGV0094659,75,16,9,7,1
SBI57LTY4433529,20,17,15,2,1
SBI68FBR2102056,86,16,10,6,1
SBI33APJ6453407,72,28,19,9,1
SBI36ZTR6412324,65,24,13,11,1
SBI49WDC9322721,65,29,23,6,1
SBI05WGN4991514,69,24,14,10,1
SBI69XOE9312984,98,23,13,10,1
SBI13SKN6899029,85,28,24,4,1
SBI07LDL0656228,68,17,11,6,1
SBI50TLY2718742,67,18,10,8,1
SBI67HGY9635394,80,19,11,8,1
SBI30ECP5516547,24,24,14,10,1
SBI52GCU0329944,83,23,15,8,1
SBI20NQK2467725,98,17,15,2,1
SBI60JVH7541134,64,32,18,14,1
SBI18TWR9058200,61,21,13,8,1
SBI91ASM6025369,88,29,21,8,1
SBI69VSJ9418772,73,22,19,3,1
SBI90WCS2621247,21,25,23,2,1
SBI65SDG9228858,63,22,15,7,1
SBI80JZG7859052,87,21,13,8,1
SBI67OBM8504663,21,26,16,10,1
SBI55EBK6410177,75,22,20,2,1
SBI73XJQ3088390,70,18,15,3,1
SBI80ACW0008794,88,14,9,5,1
SBI34VXW0261801,67,23,16,7,1
SBI46THR6285872,84,27,23,4,1
SBI58STY8502782,18,34,29,5,1
SBI43WWC7496038,61,26,18,8,1
SBI58PEW0763724,22,33,29,4,1
SBI99JCM8864360,86,23,17,6,1
SBI24SPI1289203,21,26,15,11,1
SBI44RPI6502317,87,32,27,5,1
SBI45CZG4318234,63,24,20,4,1
SBI79MFZ6551960,72,29,24,5,1
SBI46XZP1900893,91,30,17,13,1
SBI44LCE5272612,77,22,20,2,1
SBI09EYU4049798,92,27,23,4,1
SBI97VQQ2531596,89,25,18,7,1
SBI61NYW8795338,22,29,26,3,1
SBI61RDY1966814,73,20,18,2,1
SBI46RDQ3539043,25,25,24,1,1
SBI01ALS3964703,65,23,15,8,1
SBI91EIM0226465,66,26,21,5,1
SBI68ZWS2102303,84,33,26,7,1
SBI95LRD1404069,94,22,14,8,1
SBI43HOJ9152697,98,28,25,3,1
SBI48QCA5650524,19,22,21,1,1
SBI13OSO1478021,88,22,14,8,1
SBI19QIX3471113,68,21,15,6,1
SBI33WQU9652605,96,32,26,6,1
SBI02OBG0858355,23,28,22,6,1
SBI25RFH1824783,92,23,13,10,1
SBI84OWK1192815,72,24,19,5,1
SBI31SYN8428160,77,20,17,3,1
SBI33ANG3965685,63,21,19,2,1
SBI80RNR7175741,80,25,13,12,1
SBI53VGO9698168,65,20,14,6,1
SBI15CJL6400594,71,25,20,5,1
SBI76DWY5684449,79,21,13,8,1
SBI38NCD5764828,96,21,15,6,1
SBI98YVW2571118,88,30,24,6,1
SBI70LLV4628436,78,37,23,14,1
SBI58NNW2901992,72,26,23,3,1
SBI50EJQ1430586,84,23,20,3,1
SBI70DOX8056367,79,22,21,1,1
SBI89NXF8688262,89,19,10,9,1
SBI71VFQ7920761,74,26,16,10,1
SBI92SNO7091130,74,22,14,8,1
SBI96VSW4064191,83,24,17,7,1
SBI40FPD4934447,98,28,25,3,1
SBI56GIT0691889,78,27,26,1,1
SBI40WEF1085087,69,28,24,4,1
SBI15AZC9879118,66,24,23,1,1
SBI09LAW7451420,86,23,22,1,1
SBI23JRB6545589,75,17,12,5,1
SBI17ZCA1821498,88,28,20,8,1
SBI46GHA3973465,96,31,18,13,1
SBI85MSB6861904,75,20,12,8,1
SBI49DPY7256881,97,25,16,9,1
SBI76HHH2439861,82,17,13,4,1
SBI38LQZ9656216,24,24,22,2,1
SBI79LXB6744756,77,25,13,12,1
SBI76FWM5417001,94,28,18,10,1
SBI50MPO8599625,67,26,14,12,1
SBI59MPU3131041,99,16,13,3,1
SBI43TZG4160502,73,20,15,5,1
SBI95SUI5076969,82,26,14,12,1
SBI19ETO0384884,80,22,13,9,1
SBI76TAD4366706,77,33,24,9,1
SBI40VMH8751565,83,24,13,11,1
SBI72GEZ4233334,61,33,26,7,1
SBI64SEL9836654,77,25,21,4,1
SBI04DSR6644767,89,32,25,7,1
SBI15WOP5571293,78,33,21,12,1
SBI47XDY5304288,77,17,16,1,1
SBI42IZK0917206,68,26,23,3,1
SBI99CHQ9703989,62,23,13,10,1
SBI83UPY6623255,68,20,15,5,1
SBI41ZJV8097708,22,20,19,1,1
SBI20IRE3142506,83,27,25,2,1
SBI50LJP6073308,85,17,9,8,1
SBI98EYI2988667,60,27,24,3,1
SBI91KZJ0051735,62,19,15,4,1
SBI53BSV0499262,98,17,15,2,1
SBI06RHO4695580,89,24,16,8,1
SBI11HOC1906895,61,19,16,3,1
SBI94UAX1347331,72,34,28,6,1
SBI87BVY3002365,69,26,18,8,1
SBI37EHP0204624,77,24,13,11,1
SBI19XXA7123710,68,32,24,8,1
SBI46KJJ0564989,94,18,12,6,1
SBI28BPM4434795,86,28,24,4,1
SBI05QWI6591006,78,26,22,4,1
SBI20SKP8102128,88,15,9,6,1
SBI33UHE1514202,71,28,25,3,1
SBI01KZM1193097,96,25,23,2,1
SBI98PRP0757740,69,18,10,8,1
SBI49MCI0571686,87,25,15,10,1
SBI72TTE2723587,76,32,27,5,1
SBI75WZR2455160,79,25,21,4,1
SBI95CCR5508132,67,29,24,5,1
SBI84DLE3320824,96,23,22,1,1
SBI10AYO6607470,99,18,13,5,1
SBI03SIX6291571,72,26,18,8,1
SBI63QZI8801418,80,30,17,13,1
SBI26TJY4661962,82,23,19,4,1
SBI60WLF8723020,95,31,27,4,1
SBI52DUF6045653,24,27,26,1,1
SBI26NBS5982339,84,15,11,4,1
SBI73CHY9987256,93,19,15,4,1
SBI24RSN9126491,21,26,20,6,1
SBI46SUE5231369,88,31,28,3,1
SBI42MTJ1985055,65,22,21,1,1
SBI40CPF1834200,24,30,22,8,1
SBI82EMU4728936,65,23,13,10,1
SBI11CXR5668186,69,20,12,8,1
SBI67YPM7290934,20,28,22,6,1
SBI50DXH2475049,65,25,20,5,1
SBI32WAO8510197,73,24,15,9,1
SBI64NLD2144705,90,25,19,6,1
SBI15TBI8556241,96,21,20,1,1
SBI55OVB0215448,18,16,14,2,1
SBI96CFB4333424,72,29,27,2,1
SBI45JUV0284307,65,32,26,6,1
SBI44TWG0531106,77,21,12,9,1
SBI96LGH6216454,93,30,23,7,1
SBI54BZP0515842,86,24,17,7,1
SBI99UWP1807663,93,33,32,1,1
SBI31JMH8821228,74,17,9,8,1
SBI78NXN4358114,91,23,15,8,1
SBI50VVF5951325,85,26,15,11,1
SBI19QDU4047312,66,24,16,8,1
SBI47GZM9738226,84,21,12,9,1
SBI24OJG2183017,80,29,16,13,1
SBI04HXS3424767,78,28,16,12,1
SBI30DQF1868076,61,35,18,17,1
SBI29IPK3971872,20,28,19,9,1
SBI49ZQF9695116,90,27,17,10,1
SBI52NRW9776733,79,31,23,8,1
SBI69XGM5472236,94,24,18,6,1
SBI59PJD8396417,76,38,22,16,1
SBI06AIU4456290,81,28,15,13,1
SBI75PVJ0671910,62,22,14,8,1
SBI12GDR3159764,62,32,23,9,1
SBI98UIX4118155,89,21,17,4,1
SBI18OWR0709499,98,26,23,3,1
SBI38UPM5765054,96,16,11,5,1
SBI12OWG6524236,80,28,23,5,1
SBI84TRU4438391,23,29,27,2,1
SBI37KAQ3894426,19,28,20,8,1
SBI87XSY2427089,20,33,29,4,1
SBI72CNJ0014509,97,22,17,5,1
SBI30MYB2530601,99,22,13,9,1
SBI06OZW0371977,65,28,27,1,1
SBI09BIT1658119,79,12,10,2,1
SBI88UIP9414436,87,29,23,6,1
SBI01VQV7276171,95,26,21,5,1
SBI73VVA1228761,20,36,30,6,1
SBI95FPI2028081,21,31,21,10,1
SBI16FGM4672225,85,26,16,10,1
SBI71NYK6501305,65,25,18,7,1
SBI73NLI3739391,60,22,13,9,1
SBI17DDO9197910,91,22,20,2,1
SBI95MDS7317325,96,27,17,10,1
SBI37GUY9269057,69,23,16,7,1
SBI56SXO2945185,21,24,17,7,1
SBI30ADE5982245,69,18,15,3,1
SBI51SGM6723675,63,22,15,7,1
SBI67RBF2300343,24,15,10,5,1
SBI00BWX3024606,67,19,16,3,1
SBI95ATZ5294672,78,23,16,7,1
SBI74QHE6989273,85,26,25,1,1
SBI25ZAK9739793,89,24,17,7,1
SBI80HZH5328435,92,20,15,5,1
SBI95CGU1301419,61,18,13,5,1
SBI65WKR3292424,78,23,20,3,1
SBI93IRL9168548,23,21,18,3,1
SBI82OGS2263316,73,25,17,8,1
SBI90UFZ1722648,89,23,17,6,1
SBI90LNU4652877,92,29,24,5,1
SBI07MZH1400422,90,26,14,12,1
SBI73DTW8398782,82,25,20,5,1
SBI41XFV1076000,88,36,21,15,1
SBI17IZI7631267,91,22,21,1,1
SBI21BJY8263356,80,27,22,5,1
SBI73YQK1485124,75,27,26,1,1
SBI79VIH8063845,61,22,13,9,1
SBI56EPC4358423,82,16,15,1,1
SBI66IPC4654489,79,19,17,2,1
SBI85MYV1163305,19,33,20,13,1
SBI62TPD7652849,65,24,16,8,1
SBI94UBR7246305,75,27,16,11,1
SBI10YBF6916717,22,26,24,2,1
SBI92XCM1856783,97,31,27,4,1
SBI51EFZ6812596,84,33,30,3,1
SBI40PHQ7161224,80,31,24,7,1
SBI78OWO4147649,81,25,16,9,1
SBI94JWC6782728,72,30,29,1,1
SBI10SVN0136647,23,23,14,9,1
SBI24YSB3140986,25,31,20,11,1
SBI00PAC3775654,74,37,30,7,1
SBI70HTE4504507,24,28,17,11,1
SBI97IRC1603028,75,31,18,13,1
SBI43MZL0991133,94,21,12,9,1
SBI87GAJ9948620,78,25,22,3,1
SBI20JAL3681070,97,28,16,12,1
SBI18JDL9038535,25,23,20,3,1
SBI88QFV4168547,25,30,25,5,1
SBI51ACA8833797,65,23,22,1,1
SBI57APQ5893797,96,32,18,14,1
SBI67AHO1938552,90,23,18,5,1
SBI89DIZ1358176,81,20,16,4,1
SBI94EIR6814059,83,16,14,2,1
SBI62DNB5827823,88,23,18,5,1
SBI32VJY2140431,79,24,23,1,1
SBI48PMF8492754,92,23,16,7,1
SBI06DHL4313509,76,28,17,11,1
SBI84NJF8308783,88,29,15,14,1
SBI71LXI2494827,78,26,25,1,1
SBI86UUX7283854,64,19,17,2,1
SBI49STC2003403,89,29,18,11,1
SBI85QCU2111444,72,15,11,4,1
SBI38JVL9359968,89,29,17,12,1
SBI32URM0474476,87,22,12,10,1
SBI38SEX6823361,67,26,20,6,1
SBI98UNF3755524,71,22,19,3,1
SBI79WIK3462910,24,23,15,8,1
SBI12TPI5750105,18,32,20,12,1
SBI76VSF7122840,93,21,15,6,1
SBI72AQD5723482,74,14,10,4,1
SBI01AUS5047238,65,21,11,10,1
SBI70BVM3922862,23,33,19,14,1
SBI09EPW3473444,82,20,11,9,1
SBI74ICK7409526,63,27,24,3,1
SBI77XIZ3596646,24,22,19,3,1
SBI95LDZ6460799,79,23,22,1,1
SBI55MFG7774055,63,18,11,7,1
SBI98EZI4255454,70,19,15,4,1
SBI89AIW5397526,79,20,12,8,1
SBI36UVH9099985,75,32,17,15,1
SBI42DPB6137382,75,24,17,7,1
SBI88GIT4001593,71,31,30,1,1
SBI38PKF1927386,97,26,18,8,1
SBI70OLP7053123,95,26,15,11,1
SBI53SPZ9660866,82,31,24,7,1
SBI38IYM4548759,64,15,9,6,1
SBI84HMW9681371,73,23,16,7,1
SBI96PGV1457290,84,20,18,2,1
SBI82NJN7621982,65,32,18,14,1
SBI33KPZ8146343,66,27,18,9,1
SBI70OUO2758532,82,21,16,5,1
SBI70PUF2676971,20,21,14,7,1
SBI11OJR2816144,87,29,18,11,1
SBI52JRD8443069,63,21,18,3,1
SBI06PAW8978884,79,19,13,6,1
SBI61AUZ3833543,21,26,21,5,1
SBI45WYM1551363,69,24,22,2,1
SBI12KYZ3816965,82,22,16,6,1
SBI30AOM2194340,63,20,15,5,1
SBI66OAT8348909,18,24,14,10,1
SBI07XLT2258898,66,24,15,9,1
SBI39LSV0598798,98,29,28,1,1
SBI43PXU3930253,79,31,21,10,1
SBI58QSH7686403,93,36,29,7,1
SBI78NPG1785171,93,11,9,2,1
SBI70MBS6022797,19,36,34,2,1
SBI27IKT8367632,25,22,15,7,1
SBI24HRN5154156,61,17,10,7,1
SBI40UPD4973553,89,26,17,9,1
SBI30FYI6741836,22,15,11,4,1
SBI03KPT3912084,90,20,15,5,1
SBI23TKQ7687893,77,25,22,3,1
SBI10BZR9182833,94,30,28,2,1
SBI02JMJ1496669,90,28,22,6,1
SBI63BHA8910391,83,30,29,1,1
SBI27HVN7303584,72,23,14,9,1
SBI85YVU4119432,92,27,16,11,1
SBI47FRT4671124,79,23,17,6,1
SBI54CQR0567727,24,20,17,3,1
SBI23DFX3554119,61,26,21,5,1
SBI53IBE6294424,20,26,15,11,1
SBI26VCV9180811,96,28,18,10,1
SBI87ZUE0632615,92,28,22,6,1
SBI64LMG6536894,85,21,13,8,1
SBI45UFG3894173,95,26,18,8,1
SBI00YOS0822023,81,26,17,9,1
SBI90PWM9521959,84,32,21,11,1
SBI75TDS2362082,72,31,26,5,1
SBI73WPB5253170,68,26,19,7,1
SBI19DYA6895726,97,26,19,7,1
SBI94AVX7105034,99,22,20,2,1
SBI42QSI8512454,86,30,27,3,1
SBI40IMU5427770,69,23,21,2,1
SBI72OES8082946,19,14,11,3,1
SBI71ADC3938422,83,17,14,3,1
SBI45IDF5143990,96,20,19,1,1
SBI88TVD2591196,22,27,23,4,1
SBI63UHO7391754,23,26,22,4,1
SBI84BYS3660946,74,19,12,7,1
SBI08IQQ7786901,61,21,19,2,1
SBI50IZY1687022,60,18,17,1,1
SBI10XLC4709881,67,28,27,1,1
SBI43YBZ2460991,88,25,17,8,1
SBI95DRN4941034,61,25,18,7,1
SBI05OOL9939098,75,19,10,9,1
SBI61KVT6926194,90,29,15,14,1
SBI71LSS2516752,83,22,19,3,1
SBI56LUY6549687,68,27,17,10,1
SBI02SHZ5411881,19,33,28,5,1
SBI43UAC1013578,18,27,15,12,1
SBI42TGR6396417,96,22,16,6,1
SBI57IXD8403651,63,25,24,1,1
SBI07EVV7310051,76,9,5,4,1
SBI83TPS6581965,96,22,14,8,1
SBI96HJW8644193,70,24,17,7,1
SBI43YBD6739003,77,31,21,10,1
SBI20YWC1069237,83,18,10,8,1
SBI07MUD5464672,80,25,23,2,1
SBI28HEZ3118023,76,22,13,9,1
SBI78WFJ2974113,89,30,29,1,1
SBI16LPG4289006,64,17,10,7,1
SBI10NTO9685542,96,30,24,6,1
SBI07GHZ5090422,64,31,30,1,1
SBI38ICL1379882,71,24,21,3,1
SBI96JRX0195489,99,24,15,9,1
SBI11ZAA8804317,65,32,28,4,1
SBI02PNO4843663,77,14,9,5,1
SBI01IWV1331109,68,23,13,10,1
SBI45MIK6239674,22,24,20,4,1
SBI99FFK4054055,71,38,23,15,1
SBI89RQO1815162,72,16,15,1,1
SBI24ROL1886791,98,22,17,5,1
SBI28XTE3968445,84,34,29,5,1
SBI44ILC5561197,83,18,17,1,1
SBI29OPN6468222,88,14,10,4,1
SBI01VSA9879723,92,28,26,2,1
SBI66NFJ9456186,60,35,26,9,1
SBI26WAP0944517,62,22,18,4,1
SBI00HOM1610345,84,24,22,2,1
SBI81LID8355301,68,22,18,4,1
SBI09WNK0331985,83,21,11,10,1
SBI32SIM7591943,68,24,21,3,1
SBI95SUM2696159,80,21,17,4,1
SBI83QZM8905487,91,24,13,11,1
SBI80AMO5473292,79,22,21,1,1
SBI44VXG2100779,96,23,14,9,1
SBI04EAT7143321,93,25,18,7,1
SBI30JEP4662273,65,26,16,10,1
SBI42HBC3901040,90,24,23,1,1
SBI80YVN0313937,68,30,26,4,1
SBI61XVM6699058,98,31,23,8,1
SBI86GWY4629101,72,18,17,1,1
SBI93LUF1531788,68,25,18,7,1
SBI56AVX8746499,83,18,11,7,1
SBI73HWR1031443,93,30,27,3,1
SBI45XRY2729810,22,23,18,5,1
SBI86UHN4262707,98,31,20,11,1
SBI43ALF7485597,95,23,16,7,1
SBI81JVR8575368,98,22,13,9,1
SBI31SZZ4827794,24,22,14,8,1
SBI05MSW2417141,61,13,11,2,1
SBI58HEB4165419,23,21,14,7,1
SBI79SUO3373938,83,26,14,12,1
SBI08IAZ2523294,91,28,17,11,1
SBI98LIX3847036,81,28,16,12,1
SBI05NVZ7144597,22,29,18,11,1
SBI59THD3136090,19,14,12,2,1
SBI38EEU7266736,24,30,24,6,1
SBI67VVR8133953,69,28,23,5,1
SBI70VIT5963054,81,37,25,12,1
SBI49EFB1206688,84,27,18,9,1
SBI29VTG2817437,63,29,23,6,1
SBI32EAT1358910,23,23,16,7,1
SBI03GFN8391618,91,20,19,1,1
SBI35ZED9263439,82,21,12,9,1
SBI73RGN5665197,96,21,17,4,1
SBI34BTZ7291133,60,27,24,3,1
SBI48ZVT0437031,90,25,13,12,1
SBI27MOS5655784,70,27,24,3,1
SBI87ZBP7125263,90,16,9,7,1
SBI32ONV2065920,94,27,14,13,1
SBI49JEE9936574,22,23,17,6,1
SBI06OXE9765084,69,28,19,9,1
SBI87LPO0278736,96,28,24,4,1
SBI35USN8426235,91,34,28,6,1
SBI48JTB0942439,95,29,15,14,1
SBI36AGQ6228627,95,14,8,6,1
SBI84STW5034483,93,16,13,3,1
SBI34GHX9151232,93,23,21,2,1
SBI71IPG3779888,88,24,16,8,1
SBI36CWG3252751,79,25,23,2,1
SBI51FZW6895684,69,21,14,7,1
SBI43SVI4516341,76,23,20,3,1
SBI47YAU0076496,86,37,22,15,1
SBI50ZLB2186174,91,28,24,4,1
SBI52ZUF2119496,79,24,19,5,1
SBI07IYP4802016,99,15,13,2,1
SBI01ZID6143310,62,31,23,8,1
SBI05IAD0623561,74,32,22,10,1
SBI25RDO8939685,79,15,11,4,1
SBI02JIN7775936,76,34,32,2,1
SBI83NST9507255,96,27,26,1,1
SBI75ZRF7700726,91,22,17,5,1
SBI44MGH3318388,18,27,20,7,1
SBI64AZV7205960,80,26,16,10,1
SBI18YNW5121848,89,35,21,14,1
SBI26ITX2846717,21,32,30,2,1
SBI46HOK6904142,68,27,21,6,1
SBI41GNN6201938,19,19,10,9,1
SBI93MEM7473214,84,28,24,4,1
SBI62CAD4418784,82,27,20,7,1
SBI08WMS3472614,73,17,13,4,1
SBI57QGF9180720,62,28,16,12,1
SBI03DOG4324538,79,25,13,12,1
SBI21XQG9274193,82,24,23,1,1
SBI33PME1780949,88,26,25,1,1
SBI59RJJ0427668,19,21,12,9,1
SBI84MAI1666021,88,33,18,15,1
SBI55FGX7769983,76,26,17,9,1
SBI09HUF4296906,24,28,25,3,1
SBI57OCP3234014,78,23,17,6,1
SBI59LWB2945072,72,26,15,11,1
SBI33TCH7265792,85,25,18,7,1
SBI43HBL6352145,74,29,15,14,1
SBI53IGY7994696,22,31,20,11,1
SBI79GJR3026430,79,29,24,5,1
SBI39RCY3099206,83,29,25,4,1
SBI58TRS3459541,75,22,19,3,1
SBI14KDR4825253,84,21,11,10,1
SBI36BSW9644658,89,31,23,8,1
SBI35GBY8581932,90,17,16,1,1
SBI59ZAI1666548,72,30,24,6,1
SBI07CDS2221171,75,29,24,5,1
SBI39WON0088184,76,29,17,12,1
SBI70AKQ0824938,85,22,17,5,1
SBI71QXP0495061,90,18,12,6,1
SBI78SZC5962192,79,24,21,3,1
SBI55PRH3160994,79,18,16,2,1
SBI36SGQ5119052,98,22,16,6,1
SBI32VRK9929544,71,36,25,11,1
SBI32AVS7322508,94,30,25,5,1
SBI51NTL6349268,97,25,20,5,1
SBI71PXD4214816,71,33,29,4,1
SBI28IDM6205980,20,23,22,1,1
SBI99KQO7774704,86,19,13,6,1
SBI72ICN1332502,97,28,17,11,1
SBI88WEQ6136532,94,28,15,13,1
SBI37ZVH2937529,77,20,16,4,1
SBI53YPL0628807,19,28,26,2,1
SBI90LJU1265247,82,18,14,4,1
SBI23TXE0250469,68,31,27,4,1
SBI65FXT2339327,98,22,15,7,1
SBI21ROJ9255396,79,22,15,7,1
SBI81UFD7243833,76,28,20,8,1
SBI26HMW7395969,21,31,24,7,1
SBI79HXJ6625550,92,21,19,2,1
SBI85EWE6255646,20,33,18,15,1
SBI22GDY2067903,87,24,22,2,1
SBI33PSN9090619,85,22,13,9,1
SBI80GLE1063138,60,15,10,5,1
SBI51ZCE8228499,95,23,16,7,1
SBI05SLR0817123,80,26,23,3,1
SBI09NSU0314263,72,27,14,13,1
SBI25HQL4251199,18,32,26,6,1
SBI13VDY6001533,73,22,13,9,1
SBI32BZN2074156,63,29,20,9,1
SBI60JPP9234145,23,22,12,10,1
SBI72SUP1241538,92,21,20,1,1
SBI36VDI6586590,21,14,13,1,1
SBI56FTO9744232,93,27,18,9,1
SBI26DZE7643555,90,22,16,6,1
SBI14VIN5197764,64,24,15,9,1
SBI05ZPW6215861,92,25,21,4,1
SBI31PLT6443859,86,18,10,8,1
SBI47DHC6930251,98,28,26,2,1
SBI55GAS3932703,19,26,24,2,1
SBI76EUY8448230,24,27,15,12,1
SBI03TVO6806878,70,18,16,2,1
SBI29SYH6338430,99,11,7,4,1
SBI25FRF9318982,96,23,13,10,1
SBI50ZBB7051007,24,28,19,9,1
SBI34JGX8796715,63,30,26,4,1
SBI57FYI1335383,97,29,19,10,1
SBI56XMC7043677,78,21,11,10,1
SBI23KBU9296451,71,30,29,1,1
SBI92NQL0888542,93,19,16,3,1
SBI52PZE2542961,65,23,18,5,1
SBI46HTY3174633,23,24,18,6,1
SBI26DLK0598513,79,23,13,10,1
SBI76CXN5943344,62,27,24,3,1
SBI96AFX3072884,73,26,24,2,1
SBI07LEL1731142,61,20,12,8,1
SBI75ECY9741843,18,27,24,3,1
SBI37QIV6388344,95,31,22,9,1
SBI47MEF0910348,92,30,18,12,1
SBI11VRL6727306,82,20,15,5,1
SBI74FLQ2972113,19,21,18,3,1
SBI63AGT1871408,73,20,14,6,1
SBI89LFT1317283,93,21,13,8,1
SBI61PVO0879771,25,28,23,5,1
SBI39VBP9293370,23,28,15,13,1
SBI26HRJ8586864,66,25,13,12,1
SBI95BBM0950142,79,25,18,7,1
SBI21XMD8894026,23,19,13,6,1
SBI28YLX2105839,97,27,25,2,1
SBI69YST4953391,19,22,12,10,1
SBI97KPO3856722,76,23,17,6,1
SBI05RJR2409059,23,32,27,5,1
SBI27HHO9053640,85,26,15,11,1
SBI17MXE8598349,73,26,18,8,1
SBI53IPF4538494,21,30,29,1,1
SBI84LKJ6981694,92,26,25,1,1
SBI58OFR5306285,84,25,18,7,1
SBI79SEY1902647,71,18,12,6,1
SBI40MZV4474964,90,23,16,7,1
SBI34QLC2190981,69,29,21,8,1
SBI71NWP0778943,62,23,21,2,1
SBI69FII0265474,60,15,10,5,1
SBI17UOM1695493,23,20,13,7,1
SBI22KFW6411727,70,24,22,2,1
SBI50TFC6608311,94,30,25,5,1
SBI72CXJ6618487,18,22,21,1,1
SBI46CPQ7396739,65,26,23,3,1
SBI10FRM9130410,23,21,14,7,1
SBI22WBU8323838,90,27,15,12,1
SBI85CJP5689638,97,32,30,2,1
SBI27YLC5021319,64,22,17,5,1
SBI95RKL0259288,95,31,29,2,1
SBI94SYK5104064,21,21,18,3,1
SBI48RFV5483500,71,25,21,4,1
SBI16CNY8517558,80,21,13,8,1
SBI61SJJ4541230,74,28,23,5,1
SBI65ZQA1111784,82,19,11,8,1
SBI14LMU3348818,74,24,21,3,1
SBI69UZU6811963,66,19,10,9,1
SBI37EDB6718489,96,28,18,10,1
SBI42CBZ2596244,96,30,19,11,1
SBI17YCG4369904,73,22,12,10,1
SBI41DHV9540402,73,29,25,4,1
SBI26IWB4088814,93,22,15,7,1
SBI03LSL4832505,82,16,12,4,1
SBI25NLU2189687,66,18,14,4,1
SBI02BRS4088344,74,29,18,11,1
SBI91NCH6185930,24,32,28,4,1
SBI93KMF1987799,68,29,22,7,1
SBI95WQN1606326,72,21,16,5,1
SBI02PUT8874343,76,19,10,9,1
SBI75SIV6849456,86,26,17,9,1
SBI22YLP4755805,60,25,18,7,1
SBI06PQS8265330,63,25,19,6,1
SBI83AXC8282813,73,23,16,7,1
SBI99LMY6509318,65,30,22,8,1
SBI16KKW6682313,23,27,14,13,1
SBI33XBS0240551,77,23,17,6,1
SBI56JLD6430161,21,23,14,9,1
SBI04RKG0296028,65,30,28,2,1
SBI99FDG3786180,79,22,15,7,1
SBI22NRY4417899,77,26,18,8,1
SBI56LUD6700235,75,25,24,1,1
SBI63YGR0648267,80,21,19,2,1
SBI75QWA0973510,67,30,25,5,1
SBI88IHK7999539,73,29,19,10,1
SBI05JJB8106737,70,27,19,8,1
SBI69KZE9210352,61,28,17,11,1
SBI24EQT6649334,96,30,21,9,1
SBI01YHW5472937,18,26,20,6,1
SBI13VPU2805021,83,26,22,4,1
SBI91AKH0917787,74,30,26,4,1
SBI92OFI5207304,76,28,21,7,1
SBI41CTH9690046,98,26,25,1,1
SBI16UOE3557906,89,25,21,4,1
SBI26TNU0640275,20,22,16,6,1
SBI32HIZ4486882,25,32,25,7,1
SBI13VDE9823239,69,29,28,1,1
SBI13NVR4625976,60,23,20,3,1
SBI34UUI2048958,72,23,19,4,1
SBI14KGK7391154,80,25,18,7,1
SBI30HYQ0759677,83,21,15,6,1
SBI09NYB2312208,89,30,22,8,1
SBI26OGV0427225,94,22,17,5,1
SBI66VQT6439276,78,21,18,3,1
SBI47CIT0720622,95,19,15,4,1
SBI43XAE7835186,73,24,17,7,1
SBI70EJF9395650,76,23,14,9,1
SBI75FEM0378246,82,25,24,1,1
SBI24KOX5056801,63,21,13,8,1
SBI14WGG7511731,77,30,26,4,1
SBI32JDZ4540403,76,29,15,14,1
SBI30LDC6300943,82,24,17,7,1
SBI62HHQ1932184,62,30,23,7,1
SBI71LBS8415520,71,28,15,13,1
SBI85PHH7425138,21,19,15,4,1
SBI27DRP1528973,96,27,17,10,1
SBI60NBG3386716,66,25,19,6,1
SBI87JNC3450022,87,16,12,4,1
SBI13GTP6865285,92,31,27,4,1
SBI49GDI9113745,93,12,9,3,1
SBI63DYN0724955,95,26,23,3,1
SBI14VVY6566628,75,27,23,4,1
SBI40UXX1805157,81,27,19,8,1
SBI44WSL3086100,60,23,21,2,1
SBI81JZQ2906020,66,27,24,3,1
SBI84UKC2450630,72,20,12,8,1
SBI39KJV7094786,71,23,21,2,1
SBI69VLM6066324,68,25,15,10,1
SBI69UOW6971939,63,25,15,10,1
SBI77CPB7535087,86,18,12,6,1
SBI14NIP0926504,65,26,17,9,1
SBI61LAV7942167,66,20,18,2,1
SBI41NNC9975073,64,18,14,4,1
SBI26QBK4778495,77,23,14,9,1
SBI44OCD8668214,94,20,13,7,1
SBI22HGF8718863,63,19,18,1,1
SBI65XPU3356938,85,25,13,12,1
SBI78KIX8542718,99,28,22,6,1
SBI15XDS6341139,68,25,24,1,1
SBI57NBU2486883,92,27,16,11,1
SBI27NGT7610018,76,20,13,7,1
SBI37GNX1896725,22,20,12,8,1
SBI02SFJ1113838,67,27,14,13,1
SBI82EBM0971210,70,24,22,2,1
SBI30APD9597481,97,22,14,8,1
SBI30VEG0490746,66,25,21,4,1
SBI73VUF3629252,93,27,19,8,1
SBI66BHE8483287,99,30,26,4,1
SBI36III1570157,92,19,16,3,1
SBI65ARP0518915,70,23,22,1,1
SBI58WGY7455014,95,24,19,5,1
SBI28AOM4690801,62,28,19,9,1
SBI01OAQ8353643,89,20,16,4,1
SBI19NCU0208148,95,36,25,11,1
SBI14YFO0310658,91,24,15,9,1
SBI35OGY6014075,77,30,29,1,1
SBI31TZV1416393,82,27,26,1,1
SBI98AJP3988956,95,24,22,2,1
SBI21CGW9956231,22,28,22,6,1
SBI07GKR3004609,64,19,18,1,1
SBI12NGF7202579,18,33,26,7,1
SBI24WLB8104591,74,19,18,1,1
SBI92AZH8485736,24,28,15,13,1
SBI91HYH6427034,89,26,21,5,1
SBI67BTV3832430,88,24,22,2,1
SBI32ATO2913753,20,22,21,1,1
SBI68TFU7669864,65,27,23,4,1
SBI35JHA6319402,83,25,24,1,1
SBI76YSN3739734,20,24,14,10,1
SBI25UZC3816385,19,24,17,7,1
SBI55LCL3848592,76,28,18,10,1
SBI58PUS3085697,22,25,18,7,1
SBI40KHN1046735,84,26,16,10,1
SBI19VJC4954889,65,23,18,5,1
SBI02LAB4346559,82,26,21,5,1
SBI72ZDJ2228101,18,26,21,5,1
SBI03FJM9646846,94,24,21,3,1
SBI64GAE7128698,71,30,28,2,1
SBI31ZNT3133018,74,23,18,5,1
SBI93XSH9817680,87,27,25,2,1
SBI46NRS5690440,85,31,18,13,1
SBI13RHX2265636,21,23,20,3,1
SBI22DEX1718322,72,25,15,10,1
SBI74SPJ6878859,81,25,14,11,1
SBI07PUD4491346,89,19,13,6,1
SBI73WHY4045912,83,29,16,13,1
SBI43QKX7865747,18,16,14,2,1
SBI44HLN1274904,66,20,16,4,1
SBI51BNT0500286,86,23,21,2,1
SBI57QKC1510914,22,34,29,5,1
SBI94WPA5968248,90,27,26,1,1
SBI05HIL6429762,95,23,13,10,1
SBI36ESV3318635,67,31,22,9,1
SBI12LZF5759566,61,24,18,6,1
SBI09EGJ8310586,73,20,13,7,1
SBI30QVA1119208,77,18,16,2,1
SBI70KGU0361986,70,23,14,9,1
SBI57HJL6227995,18,23,18,5,1
SBI64EXU7184196,98,24,19,5,1
SBI20JYE6818945,78,27,20,7,1
SBI55QAS5969003,91,25,24,1,1
SBI15BQC0649627,23,31,21,10,1
SBI02CBJ5119203,92,22,17,5,1
SBI84THY7522551,94,24,18,6,1
SBI18FCQ5675484,96,28,23,5,1
SBI48TPK8757870,22,36,29,7,1
SBI71PFY9389665,74,26,18,8,1
SBI58DST5328633,78,23,14,9,1
SBI89ATN4199738,61,24,13,11,1
SBI97LMB8360144,86,17,9,8,1
SBI97SQH4116707,78,31,24,7,1
SBI37POF6846947,60,20,18,2,1
SBI02DNL2364254,83,28,20,8,1
SBI02FZG8517643,64,30,21,9,1
SBI08SKH3421315,24,22,21,1,1
SBI91ZSL0213416,64,31,24,7,1
SBI83CTN9038357,62,23,14,9,1
SBI41BHD2934670,77,25,24,1,1
SBI11GVJ4030036,81,30,29,1,1
SBI29CTZ8834265,86,31,18,13,1
SBI73FQF6158530,90,23,22,1,1
SBI35MCR6409756,19,27,14,13,1
SBI25LLC0859487,85,27,21,6,1
SBI85WVE3501356,23,25,14,11,1
SBI65LEM0320979,19,20,13,7,1
SBI97VCM3987910,98,26,20,6,1
SBI93VHJ9807402,97,21,17,4,1
SBI23XAV0868156,83,28,22,6,1
SBI21KLW3549411,97,26,18,8,1
SBI53YFY2351540,73,24,18,6,1
SBI46EQE6815974,97,20,18,2,1
SBI46OYM5904881,67,19,12,7,1
SBI72MLK8773442,86,22,12,10,1
SBI98JZP1189535,97,19,17,2,1
SBI16ZCF7079909,67,17,15,2,1
SBI94TSB5875192,64,23,12,11,1
SBI00DGJ2342556,25,29,25,4,1
SBI14PHP7535417,63,22,19,3,1
SBI83IEK1771546,69,25,23,2,1
SBI95QPT2055234,78,20,16,4,1
SBI60DCL0065428,84,22,20,2,1
SBI32XJS4001513,68,27,22,5,1
SBI12HVI0060135,76,29,28,1,1
SBI72LFZ8519742,87,26,20,6,1
SBI74EEJ6167159,89,25,21,4,1
SBI68NEH6932242,20,26,25,1,1
SBI34UEH6593004,21,28,19,9,1
SBI87OLP7821397,78,25,18,7,1
SBI50XIM2404081,70,25,22,3,1
SBI77MFV5835834,80,32,31,1,1
SBI61SFG5491006,73,18,11,7,1
SBI39PQW0894418,94,27,24,3,1
SBI41QQM0018884,92,23,17,6,1
SBI27ZTY2752376,18,19,18,1,1
SBI38IFJ2070068,81,25,23,2,1
SBI00ELV5399482,89,22,18,4,1
SBI64BRP5351117,86,19,11,8,1
SBI13HFZ7816011,85,23,14,9,1
SBI89SQP0396304,62,30,29,1,1
SBI66FXI8315600,80,25,16,9,1
SBI60EUD1529926,69,28,16,12,1
SBI74VHE8449299,22,26,25,1,1
SBI16CZF6414695,64,21,14,7,1
SBI18WTC9197325,60,30,18,12,1
SBI40IYQ2990582,87,21,17,4,1
SBI46AJL2695971,67,29,19,10,1
SBI41GIE7508630,66,30,17,13,1
SBI58SRB5730003,60,8,5,3,1
SBI41MPI4056278,62,24,18,6,1
SBI72PIZ1281946,24,23,18,5,1
SBI57JXG7206496,91,23,21,2,1
SBI19NSC1429702,67,35,31,4,1
SBI86UBR5508659,81,16,12,4,1
SBI87ZIJ0844503,23,25,22,3,1
SBI47THL9421132,60,28,20,8,1
SBI68VWL5699955,78,28,27,1,1
SBI81ULG3250611,88,29,21,8,1
SBI93QRP2965240,79,23,13,10,1
SBI97YVQ4514756,63,27,25,2,1
SBI53WFY1058823,74,28,18,10,1
SBI97WMV6858611,97,25,19,6,1
SBI86TBQ7242572,85,26,25,1,1
SBI89RDG9407043,83,25,14,11,1
SBI46RTS5544061,62,24,21,3,1
SBI84FLG8391406,69,27,22,5,1
SBI36YAB5020146,64,19,18,1,1
SBI86FUN3668147,24,21,15,6,1
SBI19FFH8306756,73,24,16,8,1
SBI40GXO1411131,72,24,22,2,1
SBI13SWA1838905,20,30,19,11,1
SBI98VWF2210647,19,27,20,7,1
SBI07XGD1449146,75,19,12,7,1
SBI57CQH6268555,71,30,24,6,1
SBI91QLB1367125,94,24,23,1,1
SBI64MBV6612425,80,23,16,7,1
SBI64ESN4117066,80,23,16,7,1
SBI74TGR6116848,92,24,15,9,1
SBI10NKC1991229,84,30,22,8,1
SBI08ZYD0061040,96,24,21,3,1
SBI18CVZ3405585,63,28,21,7,1
SBI04SSQ6765903,87,26,19,7,1
SBI38ZXK5752793,94,19,11,8,1
SBI60DTZ7106282,61,23,20,3,1
SBI67CCM4541289,70,29,20,9,1
SBI04QDQ0404426,21,29,25,4,1
SBI02PFH1081522,85,30,19,11,1
SBI17VCF9671226,65,28,27,1,1
SBI97HXY5977767,72,19,10,9,1
SBI77DVS1408887,61,26,16,10,1
SBI17WPQ3186961,73,32,28,4,1
SBI82DTI3674840,89,19,15,4,1
SBI75FDY3470814,99,32,21,11,1
SBI14IGZ9039812,85,23,18,5,1
SBI89MAX8314653,84,27,16,11,1
SBI84XUC7719887,72,28,22,6,1
SBI56QFM3007245,74,18,12,6,1
SBI10PNN3277807,64,30,25,5,1
SBI49HXB7615051,65,26,23,3,1
SBI68HBC1426899,79,30,16,14,1
SBI31BFF9701507,78,23,20,3,1
SBI60ZBB4663285,91,30,18,12,1
SBI42BLL5146818,73,14,10,4,1
SBI26OHU5486407,72,22,14,8,1
SBI14NEV6969632,90,29,15,14,1
SBI33ZME8404506,60,27,14,13,1
SBI77DXO2624300,19,24,15,9,1
SBI24LFP4622374,78,22,13,9,1
SBI68UWD8238102,73,23,18,5,1
SBI17QIB0929641,70,23,18,5,1
SBI60ELP4047755,79,17,10,7,1
SBI99LOO3575520,74,28,19,9,1
SBI07SQQ9142274,80,19,14,5,1
SBI02SME4736011,21,25,13,12,1
SBI39FIJ2941862,95,27,19,8,1
SBI74VXU8664060,87,22,14,8,1
SBI40JPI3024865,71,25,14,11,1
SBI52KAO0686120,61,24,17,7,1
SBI01ZDK5231019,24,26,18,8,1
SBI40QFD8744599,94,26,17,9,1
SBI90KYK9105404,75,27,22,5,1
SBI62GMY1152723,67,23,16,7,1
SBI40UPJ3532412,23,19,18,1,1
SBI92ZTK5854433,24,33,28,5,1
SBI70RGV4394002,99,23,19,4,1
SBI36IGK7667615,88,22,16,6,1
SBI36LSB6192977,81,22,15,7,1
SBI22CKP6618122,72,26,18,8,1
SBI59RZF6195171,94,21,13,8,1
SBI77EIA8528082,21,19,12,7,1
SBI40PQE1837529,83,17,13,4,1
SBI94XZE2318476,86,21,17,4,1
SBI04KWB1692994,89,33,24,9,1
SBI52HOO2102679,70,20,12,8,1
SBI38PGR8550227,93,18,12,6,1
SBI84MEG8336812,73,26,19,7,1
SBI10OZM8206647,65,25,22,3,1
SBI75EGR7495142,95,25,16,9,1
SBI32HMO2127051,18,38,27,11,1
SBI24ZLU4187045,83,19,13,6,1
SBI98EZL4111565,77,27,22,5,1
SBI70IAJ3693537,77,30,23,7,1
SBI40DQI0453805,79,26,15,11,1
SBI81PKT8326122,98,29,27,2,1
SBI50PMH4703841,80,16,9,7,1
SBI65OUD9626626,63,23,19,4,1
SBI06IAK7170928,20,17,10,7,1
SBI35OMZ8261233,75,26,18,8,1
SBI31DYY4840886,24,21,14,7,1
SBI92QWY8140628,22,20,17,3,1
SBI61WJX8326975,76,17,10,7,1
SBI88EZL2699268,87,21,12,9,1
SBI07FFW2043417,65,22,18,4,1
SBI19CWW0639250,96,30,21,9,1
SBI55TXY8035804,61,17,12,5,1
SBI31JOE3763951,76,25,14,11,1
SBI14EYY6472423,72,28,27,1,1
SBI70SXT7780142,66,24,18,6,1
SBI11CPN6231373,67,22,13,9,1
SBI67PNN7408568,65,23,18,5,1
SBI30BUI4510735,20,22,14,8,1
SBI02EKU6057152,74,30,29,1,1
SBI23SGE7543715,79,19,15,4,1
SBI26LFD8050049,94,38,32,6,1
SBI25QWR0769169,70,22,12,10,1
SBI60YHS6231568,87,26,22,4,1
SBI16KLK9437510,93,25,23,2,1
SBI80ORZ8980972,75,19,12,7,1
SBI54PUB6050278,94,25,17,8,1
SBI58LGL6810892,63,25,13,12,1
SBI85LXM4169556,18,33,28,5,1
SBI53BGY5002714,79,25,16,9,1
SBI80JBJ6668849,98,22,13,9,1
SBI97QCI1802782,72,23,20,3,1
SBI75ILA0656052,22,25,22,3,1
SBI48AYM3896570,83,21,13,8,1
SBI95KRI3492206,78,27,16,11,1
SBI73JGJ4270135,23,24,16,8,1
SBI18MSH9260090,90,26,21,5,1
SBI04JBA4624567,60,26,23,3,1
SBI05UVY4921387,91,17,15,2,1
SBI91ZLQ8360667,68,26,14,12,1
SBI29ZQO6797000,65,23,13,10,1
SBI47CPX8372352,23,31,28,3,1
SBI97NSJ7445834,67,38,34,4,1
SBI02DCW4384814,61,25,17,8,1
SBI56FRS0121587,94,18,15,3,1
SBI14XBD7128513,98,22,14,8,1
SBI85ZHK8720721,80,23,17,6,1
SBI27QKO2353871,97,19,12,7,1
SBI04GQI1752774,25,27,25,2,1
SBI44ERI7849176,60,22,13,9,1
SBI92JZW8310811,93,20,11,9,1
SBI64QEF4548394,60,19,17,2,1
SBI80DNC0679897,24,18,15,3,1
SBI09TQD2822038,97,30,19,11,1
SBI14EJV0311497,82,30,16,14,1
SBI98XGM2726135,68,23,12,11,1
SBI92ACX9772550,21,22,13,9,1
SBI78XAT7751129,25,23,14,9,1
SBI44DBB8674609,90,31,19,12,1
SBI95LYN8945701,91,31,30,1,1
SBI83CBB2841161,79,27,15,12,1
SBI93EUE3201211,73,18,14,4,1
SBI37VRV2666472,83,26,14,12,1
SBI86RKD2250910,79,17,13,4,1
SBI65QKD0439485,23,18,15,3,1
SBI23QCP3259144,96,28,26,2,1
SBI65HZE5776926,73,32,21,11,1
SBI88VXC9764269,62,21,17,4,1
SBI85YNN4918933,82,31,18,13,1
SBI16DLN5430733,67,25,21,4,1
SBI73IAL3294151,78,33,25,8,1
SBI50IWW8641762,83,27,23,4,1
SBI06AZP7671767,21,21,16,5,1
SBI56FAU3227841,60,26,23,3,1
SBI05LEY0593181,63,21,20,1,1
SBI48NCS7604078,81,30,29,1,1
SBI04RQE0193465,22,17,15,2,1
SBI28OOY0706049,92,27,19,8,1
SBI70OFO9707234,75,27,25,2,1
SBI37ESQ1844339,82,25,19,6,1
SBI91XOI4710016,85,23,16,7,1
SBI35KUZ8359621,76,14,10,4,1
SBI86QBQ6081188,98,20,17,3,1
SBI78AGV5055558,96,24,14,10,1
SBI17BFB2191299,98,24,20,4,1
SBI90BRN7788578,20,23,14,9,1
SBI93PEU5649788,85,18,13,5,1
SBI39JFZ5639491,64,28,18,10,1
SBI61NPK5004424,78,11,9,2,1
SBI20PDI5748928,62,15,11,4,1
SBI39UKJ3236593,85,31,23,8,1
SBI06TNG1263672,84,25,18,7,1
SBI94LQQ1053951,18,24,15,9,1
SBI75PYL7127194,88,17,13,4,1
SBI33QYP0945580,21,21,14,7,1
SBI53YUY3906941,21,23,12,11,1
SBI42OQD0512555,60,34,18,16,1
SBI42ETM9711468,82,31,16,15,1
SBI87CWL2838900,60,22,17,5,1
SBI43JGW7703626,84,17,16,1,1
SBI64DIA0855425,76,29,28,1,1
SBI47RTW2878643,25,25,22,3,1
SBI36GTL6116464,85,29,18,11,1
SBI26JTD3189030,20,19,16,3,1
SBI47DGS7340655,97,21,18,3,1
SBI22HQN7255531,75,25,14,11,1
SBI78POW7236345,92,20,19,1,1
SBI49QJX5662408,91,22,19,3,1
SBI61QHR7866513,88,27,23,4,1
SBI71CSK0155234,92,23,20,3,1
SBI32CTY2847301,78,28,22,6,1
SBI97KIP9530121,77,22,16,6,1
SBI52QBW8752159,61,25,19,6,1
SBI39MCG0881731,67,17,11,6,1
SBI15DBB3297981,70,23,16,7,1
SBI44IUK0401376,67,29,15,14,1
SBI03AZZ9325326,65,9,5,4,1
SBI38AZP7468924,68,18,10,8,1
SBI62XIU4425359,79,28,19,9,1
SBI30LHF4358982,66,27,24,3,1
SBI58MRO0167877,75,20,11,9,1
SBI46IYJ8005601,99,11,7,4,1
SBI42ROU1570014,73,34,27,7,1
SBI38ELX9154334,81,22,13,9,1
SBI53UTR3951536,83,23,15,8,1
SBI80HYV3215806,74,25,16,9,1
SBI95EBN6729807,72,29,28,1,1
SBI57QJJ8296727,23,25,15,10,1
SBI27VOL1989827,24,23,15,8,1
SBI70PAW2120600,98,21,16,5,1
SBI84OPO8069224,99,23,22,1,1
SBI82DRC4299977,95,22,17,5,1
SBI17WAC6926774,19,19,15,4,1
SBI02VWH7342381,82,26,25,1,1
SBI08TYF8985512,86,31,19,12,1
SBI60VSB1649903,85,19,11,8,1
SBI20RVV7364939,73,30,17,13,1
SBI82ZAM3775068,91,29,16,13,1
SBI30ACQ4894538,79,29,23,6,1
SBI01WFS7250395,81,22,15,7,1
SBI74OVW1530721,73,20,16,4,1
SBI75MBF7284454,98,32,30,2,1
SBI32QXL8575163,99,17,14,3,1
SBI78BCU4996350,75,27,15,12,1
SBI39NPF0642463,80,28,26,2,1
SBI26TJZ4582331,62,31,26,5,1
SBI75UMR1475489,21,21,11,10,1
SBI57YLC0732392,63,18,12,6,1
SBI97EYS4654714,79,28,22,6,1
SBI04WMU6241489,94,32,29,3,1
SBI68KQF4561888,96,28,22,6,1
SBI14ZIH8737226,18,18,11,7,1
SBI00ZST9836685,82,28,26,2,1
SBI42PBG7906089,63,25,18,7,1
SBI52EZW4624872,99,31,28,3,1
SBI86VEB7559725,79,26,21,5,1
SBI04XEN9785629,62,28,21,7,1
SBI65KMI2419688,90,30,26,4,1
SBI18MEM8654137,62,33,28,5,1
SBI07OAZ4921473,83,22,19,3,1
SBI19TUP1431764,68,28,26,2,1
SBI60YPZ9222347,89,31,29,2,1
SBI33FFL4541025,90,29,28,1,1
SBI03JNE9879957,64,21,19,2,1
SBI86CAK2311418,20,42,22,20,1
SBI91IQX3566414,66,26,15,11,1
SBI49DYO9617169,99,23,12,11,1
SBI74XFS9425094,65,26,15,11,1
SBI27ZUI0289184,68,29,17,12,1
SBI69SEE8841969,89,25,23,2,1
SBI17ELG4009499,97,22,12,10,1
SBI55HBI1759117,80,25,18,7,1
SBI33DFI7221927,23,22,13,9,1
SBI55FQT2411345,95,26,21,5,1
SBI43KWI1016264,60,20,16,4,1
SBI59RBG9509524,65,27,19,8,1
SBI90DYD1504002,77,22,16,6,1
SBI77IAH1803880,66,21,12,9,1
SBI22DUY7987504,93,29,19,10,1
SBI85NLC8785932,61,25,17,8,1
SBI30ZYU7705370,73,20,11,9,1
SBI78TLR3219566,85,27,23,4,1
SBI18RPS2907697,74,27,20,7,1
SBI15KYC8674018,73,34,28,6,1
SBI60YQZ0909596,73,23,14,9,1
SBI49PXV7740640,82,26,14,12,1
SBI91GOH0539102,82,23,17,6,1
SBI72OMJ4094790,91,25,23,2,1
SBI82LNI6840418,20,22,19,3,1
SBI53DXB2310091,87,27,18,9,1
SBI48IWR5311874,83,28,24,4,1
SBI56HDP8850986,94,26,15,11,1
SBI13LDY5499742,66,20,15,5,1
SBI20RKD7972602,65,34,28,6,1
SBI98RIV9027397,97,13,9,4,1
SBI92CNK9943032,89,26,23,3,1
SBI57GIP1323497,63,23,22,1,1
SBI88WDA7024629,61,19,18,1,1
SBI92AIZ2257661,18,17,11,6,1
SBI19PZC4791069,62,25,16,9,1
SBI45AIG8989758,98,26,19,7,1
SBI11ARK2452941,97,28,27,1,1
SBI67ZOC7753020,70,28,16,12,1
SBI99FTH1701377,73,17,11,6,1
SBI94XWS3573172,61,24,19,5,1
SBI79YLH6831613,94,13,11,2,1
SBI53MPQ8638244,82,26,17,9,1
SBI47WWN0339530,78,25,19,6,1
SBI35MDO6681481,79,26,24,2,1
SBI19DTX4968615,65,31,23,8,1
SBI63DWA6423706,18,21,12,9,1
SBI66GFT1398723,98,21,12,9,1
SBI96YZI9820750,70,29,20,9,1
SBI09GKD2686051,21,19,15,4,1
SBI28YUW3497675,94,18,14,4,1
SBI41QZQ7851325,25,29,16,13,1
SBI06GAM6900939,78,25,15,10,1
SBI80KYP4413309,98,36,31,5,1
SBI06SPE8323293,92,28,16,12,1
SBI65MFM9026808,72,31,17,14,1
SBI82TZG6261001,79,26,20,6,1
SBI68VTX0473796,81,21,17,4,1
SBI53MOY5610074,89,17,16,1,1
SBI66TNJ1710091,60,26,25,1,1
SBI64BSW0244631,74,17,11,6,1
SBI38IKD5808947,96,23,14,9,1
SBI24YKS4999909,18,30,29,1,1
SBI00ONL4420224,85,24,23,1,1
SBI40DYJ1187064,66,24,18,6,1
SBI25GTV1742634,92,28,15,13,1
SBI49OUU6342906,88,18,12,6,1
SBI95GXQ0322257,83,23,17,6,1
SBI00PKQ5685083,95,23,13,10,1
SBI64GBE6127732,84,13,8,5,1
SBI75BYM6989103,65,24,21,3,1
SBI14FFL2641900,65,23,17,6,1
SBI97KYV6933369,99,30,26,4,1
SBI92LVH6559933,91,33,20,13,1
SBI14UGT4524316,84,32,30,2,1
SBI13QRC2760759,65,23,12,11,1
SBI64XEG1239537,80,27,22,5,1
SBI13JZH5947382,65,22,20,2,1
SBI18XJX8896740,64,23,22,1,1
SBI68KRH1073241,73,25,14,11,1
SBI58LVU4613740,91,20,19,1,1
SBI95WNV2845166,23,24,19,5,1
SBI95QGF9634237,78,24,23,1,1
SBI40IOY7394665,90,21,18,3,1
SBI34HOP0522192,81,31,27,4,1
SBI77QRY6047601,79,24,13,11,1
SBI76GLU4845884,99,24,21,3,1
SBI02FOA7609716,22,22,20,2,1
SBI98KMP0165783,88,18,13,5,1
SBI86IZJ9337200,60,19,17,2,1
SBI51EQE6464109,65,16,14,2,1
SBI24PYB6335199,95,23,21,2,1
SBI47KFX6552639,24,28,15,13,1
SBI19GZZ5069511,87,32,21,11,1
SBI61PND9022071,65,33,26,7,1
SBI77BRQ5912229,68,27,22,5,1
SBI93WVY0090933,79,30,16,14,1
SBI12LPH0056845,72,27,21,6,1
SBI37AMD6927913,80,39,28,11,1
SBI83BJR4479823,68,24,23,1,1
SBI18UKA1395922,94,31,19,12,1
SBI07SBZ0584818,85,19,13,6,1
SBI77BJP0172680,70,32,24,8,1
SBI51KXA2388650,89,31,25,6,1
SBI90GXS0979989,75,26,19,7,1
SBI19BOO8872131,71,27,26,1,1
SBI07QMY9080745,96,22,19,3,1
SBI32OAF2571302,66,28,27,1,1
SBI23FKU5067465,70,23,16,7,1
SBI78ANI1932078,71,16,12,4,1
SBI06YQL8080758,97,26,17,9,1
SBI85HEH9119610,88,28,27,1,1
SBI83LBI2781651,68,26,24,2,1
SBI60RGS8471491,25,25,21,4,1
SBI85QBV9088131,96,25,18,7,1
SBI82WIG7032285,62,29,26,3,1
SBI52CKY5915289,71,28,18,10,1
SBI85HNF5234851,89,25,17,8,1
SBI97XGA9252526,77,18,14,4,1
SBI16KFH1809112,92,22,19,3,1
SBI48KPY7856961,69,27,21,6,1
SBI38QOV3755704,18,33,32,1,1
SBI22OMA1536837,23,25,22,3,1
SBI23OCU4381297,91,22,19,3,1
SBI97XIJ7267288,71,17,16,1,1
SBI96BJT9736066,73,24,21,3,1
SBI90PGV3312012,67,18,15,3,1
SBI45EOA0586271,75,26,15,11,1
SBI51MZS1016128,98,18,13,5,1
SBI77DOT2371228,97,26,23,3,1
SBI59CDO7231734,94,26,23,3,1
SBI44OWH5650938,61,25,24,1,1
SBI82ZTB2355084,69,28,23,5,1
SBI30IHC2452713,92,21,16,5,1
SBI81GQD3486953,74,29,28,1,1
SBI28HRF5134163,69,30,24,6,1
SBI66NQA0880853,78,31,17,14,1
SBI32DIZ4686306,79,28,24,4,1
SBI46ZCM1862589,93,22,12,10,1
SBI05VCJ6847113,74,19,15,4,1
SBI40GPT7755029,99,36,35,1,1
SBI49ZXE6383525,71,32,26,6,1
SBI88YJV0247374,73,33,28,5,1
SBI49TTK0687242,82,23,19,4,1
SBI43WBH3017042,77,19,13,6,1
SBI65QIQ0961387,91,32,23,9,1
SBI63ETI2749662,77,19,16,3,1
SBI22NUV3527855,87,26,15,11,1
SBI89DEJ8638862,69,21,14,7,1
SBI33IUW7223574,72,22,12,10,1
SBI09URQ4897861,19,20,19,1,1
SBI89GFD3002798,86,25,24,1,1
SBI61TPD7305179,79,26,23,3,1
SBI61DUS2313013,98,28,21,7,1
SBI38FMR6816085,92,28,21,7,1
SBI38NFM0974909,63,23,22,1,1
SBI62KBF5199946,82,30,21,9,1
SBI23WEE1512952,92,20,12,8,1
SBI16FED7992934,97,24,15,9,1
SBI25QCS4381654,63,26,15,11,1
SBI55YRH4661758,89,16,14,2,1
SBI67BAJ3534903,65,25,24,1,1
SBI09JSB6197212,75,21,14,7,1
SBI13IRX9467549,70,27,21,6,1
SBI02CJT0810129,79,22,13,9,1
SBI95PWH7427254,18,33,29,4,1
SBI64FLI1801787,66,27,17,10,1
SBI66SDB1607836,84,22,17,5,1
SBI02BOI9955428,93,21,19,2,1
SBI80BRV1071750,75,32,20,12,1
SBI29HQS2320880,70,33,20,13,1
SBI35SHN6156771,74,24,13,11,1
SBI57NKR9821006,95,21,16,5,1
SBI68RCM3265593,69,27,16,11,1
SBI79CCR4359394,86,29,26,3,1
SBI54WXW4220739,70,29,15,14,1
SBI43XAG6912408,78,21,20,1,1
SBI47LAA5230240,21,25,13,12,1
SBI38CHH5462964,84,29,22,7,1
SBI21ONP0616158,65,20,18,2,1
SBI65MYX8266672,79,27,22,5,1
SBI01ZCI1932793,95,29,22,7,1
SBI22KLE3956228,82,23,15,8,1
SBI96PVE9832587,67,24,22,2,1
SBI53SMZ3482153,94,25,23,2,1
SBI93HNT7114979,73,23,19,4,1
SBI81SZQ6586794,62,33,20,13,1
SBI37CGG3224389,86,32,23,9,1
SBI19GGQ3780699,72,23,12,11,1
SBI85QVQ8930961,66,28,25,3,1
SBI97NQG7295284,88,30,16,14,1
SBI17TWL0988986,80,31,29,2,1
SBI85RID7669129,93,22,15,7,1
SBI77BKJ8343490,88,20,19,1,1
SBI05NVL4393750,73,20,11,9,1
SBI84NYN4271449,69,19,16,3,1
SBI75PFE4560688,71,38,23,15,1
SBI89CAN2904894,74,32,25,7,1
SBI68PHW8016430,70,23,14,9,1
SBI73DXU1132776,64,22,14,8,1
SBI87VAP5088287,86,30,21,9,1
SBI74KBB8405939,61,28,19,9,1
SBI99PYX1934106,95,19,17,2,1
SBI28YIQ9512780,98,26,24,2,1
SBI99PQV4678165,73,30,25,5,1
SBI12DZE9691132,80,28,16,12,1
SBI11QEY3762417,99,28,15,13,1
SBI11AKN3370402,63,34,22,12,1
SBI22RQB3141013,79,24,13,11,1
SBI89KIP1763902,98,33,22,11,1
SBI73NLB2467130,97,17,16,1,1
SBI49HSG8294296,91,34,25,9,1
SBI47JWJ5585523,83,25,18,7,1
SBI53GVK8846678,81,29,15,14,1
SBI59HYH1917407,61,23,14,9,1
SBI32RTE0924338,21,25,16,9,1
SBI62BWB2559700,18,29,27,2,1
SBI89MYM8495591,98,22,19,3,1
SBI29JCA6195382,75,23,16,7,1
SBI28HOF2608965,22,30,17,13,1
SBI21KFF2038528,95,15,10,5,1
SBI57ERF2705396,21,21,15,6,1
SBI37IAM8903475,92,29,26,3,1
SBI28NXZ3551661,91,25,14,11,1
SBI57EYB7386048,97,25,20,5,1
SBI76IKO0061944,75,30,25,5,1
SBI63TGC0454524,61,30,16,14,1
SBI37DBP4943691,62,23,16,7,1
SBI24OMR1014360,99,21,14,7,1
SBI01QEN6096900,88,32,20,12,1
SBI08YTO5182793,88,24,21,3,1
SBI91NBE7668745,62,24,13,11,1
SBI59PKP9795141,68,30,24,6,1
SBI35WOT4650706,84,27,15,12,1
SBI85SLO9363157,86,21,12,9,1
SBI61EUA4604195,89,35,19,16,1
SBI08BEV1509765,66,27,26,1,1
SBI30AGG7298245,69,25,22,3,1
SBI92IWF6648376,66,26,20,6,1
SBI52DTA9163408,20,27,21,6,1
SBI64EEO2168500,61,32,24,8,1
SBI04RFW0104492,92,33,27,6,1
SBI76OQW6838346,18,20,18,2,1
SBI03VIM9826345,22,22,13,9,1
SBI17IKJ0637678,60,22,20,2,1
SBI10JTS1623789,90,22,16,6,1
SBI45ETQ5447728,88,25,17,8,1
SBI37OIY1707722,66,33,20,13,1
SBI71ARN8290587,91,19,12,7,1
SBI51ENO1092428,66,33,23,10,1
SBI35XEW1833162,23,24,17,7,1
SBI71SLK6611473,62,29,24,5,1
SBI56QEQ8141812,96,29,23,6,1
SBI36QTI1672677,90,23,16,7,1
SBI64TPK6816610,79,32,23,9,1
SBI41VOA5180387,71,29,24,5,1
SBI40WBT6837453,90,28,25,3,1
SBI72ELI8921297,79,15,11,4,1
SBI68YDN7138421,65,26,24,2,1
SBI84APK8379189,86,27,17,10,1
SBI43UKC5904116,89,23,22,1,1
SBI36JVV9569832,61,21,12,9,1
SBI93JFD5499335,64,25,15,10,1
SBI83MWP3054719,66,35,28,7,1
SBI54YNC8994872,67,21,20,1,1
SBI03HSF3144057,88,28,26,2,1
SBI77ESY4079362,92,22,19,3,1
SBI30WJD3968189,91,14,9,5,1
SBI20WBI8693981,82,24,22,2,1
SBI44EWT3997381,64,30,22,8,1
SBI02BSZ5963489,72,25,21,4,1
SBI65CFW9097121,24,27,25,2,1
SBI67UJQ7553842,77,22,16,6,1
SBI97YJZ3538872,22,28,25,3,1
SBI49GYP4759395,96,13,8,5,1
SBI15TBB6548010,83,25,22,3,1
SBI57HVE6608529,86,27,23,4,1
SBI98BGR7610000,61,19,15,4,1
SBI73SNB8038010,75,26,23,3,1
SBI15BKD7751705,99,22,19,3,1
SBI16KMA5505662,99,22,20,2,1
SBI07JHS2124673,20,25,13,12,1
SBI40SRH9467931,62,21,12,9,1
SBI21HOS7323928,86,31,16,15,1
SBI51QHP5088422,77,25,19,6,1
SBI34OHQ6692324,78,15,13,2,1
SBI38UKB1183593,71,29,28,1,1
SBI00RLJ9196492,64,22,14,8,1
SBI03UFX5420396,76,14,8,6,1
SBI20RBD4079984,73,21,11,10,1
SBI33GII1374091,87,25,15,10,1
SBI91YZY8762074,90,31,23,8,1
SBI84CIW5334439,96,23,22,1,1
SBI13WXM5418396,96,11,7,4,1
SBI39CQJ7695395,76,22,18,4,1
SBI05VWX9735669,81,20,17,3,1
SBI44PJU0471219,64,28,24,4,1
SBI99RAH3633312,64,18,13,5,1
SBI04YTR7126128,72,29,15,14,1
SBI29EZQ7586577,73,25,20,5,1
SBI85JOL5790439,81,15,13,2,1
SBI89KCP6825712,75,24,20,4,1
SBI26WIN1234449,62,19,14,5,1
SBI41NKR8026815,60,24,13,11,1
SBI67QKW1115048,74,15,12,3,1
SBI46XGK5556403,77,27,18,9,1
SBI21VWV0147519,22,22,19,3,1
SBI15KMR2755718,23,23,15,8,1
SBI19XVL5660612,97,20,17,3,1
SBI29RMH0567755,84,22,18,4,1
SBI05WJQ5002819,84,24,13,11,1
SBI78RSX7261921,79,22,12,10,1
SBI64PKL4413194,84,10,7,3,1
SBI81TQC4865263,79,25,20,5,1
SBI22AJN8671160,66,15,9,6,1
SBI52PFV7630813,95,25,17,8,1
SBI55WGY9487768,73,27,20,7,1
SBI01PUW6337655,18,22,21,1,1
SBI84MDO1017704,81,20,16,4,1
SBI89EVG3592604,69,20,12,8,1
SBI09MYN9682135,74,22,15,7,1
SBI22ZJF4041995,19,27,17,10,1
SBI02VYX7768783,79,28,19,9,1
SBI21DMX1241852,95,26,15,11,1
SBI97RPV1092550,92,22,12,10,1
SBI99ZHZ8676792,68,20,15,5,1
SBI10DHC5158719,83,21,17,4,1
SBI87IXE4969468,92,29,22,7,1
SBI88MMX5463521,25,20,17,3,1
SBI95XZM9702162,64,23,18,5,1
SBI90XSN3430140,87,30,27,3,1
SBI77HJY9925143,21,37,23,14,1
SBI26DZV2414806,71,18,17,1,1
SBI39CED0104613,67,28,22,6,1
SBI22AVK9048424,70,23,12,11,1
SBI60EPH9893180,73,14,11,3,1
SBI08UBD6370348,71,21,11,10,1
SBI73ARE1341314,76,28,18,10,1
SBI47LAV0682443,82,23,12,11,1
SBI39PBK8625636,67,32,24,8,1
SBI88TUI8052229,66,20,16,4,1
SBI86UJE2458770,90,28,17,11,1
SBI38TXK5355799,65,16,11,5,1
SBI28WDS5238885,18,18,13,5,1
SBI28RYU4053581,21,26,17,9,1
SBI27USM6196823,64,23,20,3,1
SBI72HND9726096,60,23,19,4,1
SBI34GWP8465126,67,31,16,15,1
SBI34WHH7179367,68,23,13,10,1
SBI27JJV1495405,83,24,20,4,1
SBI17PQH4134454,93,21,11,10,1
SBI38ZLQ2601813,70,32,23,9,1
SBI74SNY9015154,98,32,28,4,1
SBI29PIX8004934,87,27,25,2,1
SBI89ZEV0890617,70,20,14,6,1
SBI88STM0181051,85,17,16,1,1
SBI52UPM2704763,90,19,10,9,1
SBI58SSH5358186,95,25,17,8,1
SBI91JYO4466676,92,26,15,11,1
SBI49LJH1018672,91,23,18,5,1
SBI08BUD9352436,72,23,20,3,1
SBI20UHP4236325,80,29,18,11,1
SBI25DJW3085078,65,24,16,8,1
SBI64MOS2444624,19,33,31,2,1
SBI69ZDA1169598,71,24,17,7,1
SBI52EVY1310188,90,20,12,8,1
SBI80OSP8728870,62,32,18,14,1
SBI57JBX8247197,90,23,17,6,1
SBI62TVK1914290,19,17,14,3,1
SBI75OTX7226666,94,31,20,11,1
SBI25YTV1072449,96,29,19,10,1
SBI39BCP4900064,63,19,16,3,1
SBI50ZCD6670298,95,25,19,6,1
SBI66COX8663219,91,19,16,3,1
SBI87VZA6742377,87,21,15,6,1
SBI69UMT7479744,65,23,19,4,1
SBI26VHF5868944,73,21,11,10,1
SBI22JIB9577712,85,29,19,10,1
SBI00VSK1698608,79,21,20,1,1
SBI24ZCS0356912,75,21,18,3,1
SBI73ZJK3169642,67,30,26,4,1
SBI09OPH6605839,84,19,13,6,1
SBI13VOV6847996,97,19,10,9,1
SBI92IGH2774483,21,25,17,8,1
SBI39YCF5775467,94,22,16,6,1
SBI40LSB7745271,19,30,19,11,1
SBI85YJH2131586,74,14,9,5,1
SBI21LON1000705,60,22,14,8,1
SBI34AXQ7313349,18,32,19,13,1
SBI39VCS9695453,19,23,17,6,1
SBI03AOY2282197,81,21,19,2,1
SBI22KYR9689635,91,31,27,4,1
SBI59UZL8498241,90,23,14,9,1
SBI45CLL7866489,92,20,13,7,1
SBI09XIU9125445,71,25,22,3,1
SBI11EWU7029955,23,30,27,3,1
SBI31FJL7329726,95,28,16,12,1
SBI23IXA5512461,77,20,16,4,1
SBI17XPD0999438,91,28,24,4,1
SBI74HSZ1060846,70,28,15,13,1
SBI14IWN4791709,80,13,11,2,1
SBI99GWN5007963,84,30,24,6,1
SBI55OVN3521861,92,22,20,2,1
SBI98ARF5011985,66,17,13,4,1
SBI73JAA2725257,70,25,23,2,1
SBI76BMD3100507,80,18,17,1,1
SBI26PHB6218337,20,21,19,2,1
SBI10PSC6260022,66,23,21,2,1
SBI37UAD5734848,20,33,29,4,1
SBI44ZRV2088900,73,30,25,5,1
SBI67IYA2971401,72,23,19,4,1
SBI15OKM3910275,67,21,14,7,1
SBI34BFX8522842,95,24,21,3,1
SBI99INU5429733,84,25,15,10,1
SBI89ISU6037412,76,30,22,8,1
SBI58HQB0846792,68,24,22,2,1
SBI51COS3996766,81,30,21,9,1
SBI47JUC9811572,96,22,17,5,1
SBI95ROK1463491,71,28,19,9,1
SBI74VTN1277775,25,29,20,9,1
SBI98XZL4880359,20,26,24,2,1
SBI76LQO9799825,70,27,21,6,1
SBI44TPE8387614,79,23,14,9,1
SBI65UHO6078432,66,32,25,7,1
SBI17AGP3261259,18,25,24,1,1
SBI79YKW7498931,20,33,17,16,1
SBI34BBK0505664,75,23,19,4,1
SBI36IRJ9107316,69,19,10,9,1
SBI64TIS3526670,69,29,20,9,1
SBI67FUO2624161,80,21,18,3,1
SBI83PFR2293783,62,22,17,5,1
SBI61MAY2215308,90,30,29,1,1
SBI45JQU1257378,23,21,16,5,1
SBI88YPZ1222846,76,21,20,1,1
SBI64MQE1684804,62,20,15,5,1
SBI35IHQ8727516,94,25,13,12,1
SBI88WVV2209281,90,26,17,9,1
SBI52BVH6347439,78,20,13,7,1
SBI48GTK4854385,99,17,13,4,1
SBI03IGF9290052,60,25,23,2,1
SBI19MMI0615121,84,20,16,4,1
SBI13HBE4364108,64,28,17,11,1
SBI91ZMT4056315,74,27,23,4,1
SBI76WCE8849720,94,20,17,3,1
SBI72FQA2551903,19,27,24,3,1
SBI11WNQ9272899,78,25,13,12,1
SBI05SZN0727472,82,16,10,6,1
SBI08PWW3103963,21,35,23,12,1
SBI54REU2226709,70,25,20,5,1
SBI15RIO3467200,79,24,13,11,1
SBI15GRD2739907,76,21,16,5,1
SBI12LBY1182392,66,20,12,8,1
SBI00WIC4582641,97,23,20,3,1
SBI14LSX6432168,23,22,20,2,1
SBI36TXY1128480,22,18,13,5,1
SBI06OTE4367824,92,27,23,4,1
SBI56AHO6064729,94,11,8,3,1
SBI90TXR4473219,95,23,22,1,1
SBI92ZXM5374235,75,26,22,4,1
SBI40XTZ3682595,84,24,14,10,1
SBI23SZL0534260,61,21,16,5,1
SBI61ZWI5646998,87,19,18,1,1
SBI59WBM2873986,20,23,17,6,1
SBI18SUZ3024747,25,28,25,3,1
SBI91XYC7478114,18,33,20,13,1
SBI61RQC8015857,91,30,20,10,1
SBI45PIA6303213,68,22,21,1,1
SBI29AIX2608031,73,18,11,7,1
SBI26KEB9485577,81,30,17,13,1
SBI66OBJ8134161,92,27,25,2,1
SBI23WHI8994168,69,36,23,13,1
SBI84ZGV4089595,24,27,14,13,1
SBI71UIK2856387,19,22,12,10,1
SBI79MIR0736397,99,30,22,8,1
SBI66XFV8536874,77,35,19,16,1
SBI26ZQD9417705,73,23,20,3,1
SBI18FQK4425549,96,23,20,3,1
SBI81XPD4440187,74,19,18,1,1
SBI37IVY3029505,20,28,18,10,1
SBI20DMO5807878,66,20,14,6,1
SBI70PGJ6812516,18,24,20,4,1
SBI00TPF3703187,21,17,12,5,1
SBI39FAM0648648,75,24,18,6,1
SBI75HQU5590275,97,33,28,5,1
SBI04XWA9207115,24,27,22,5,1
SBI65YTD4652371,67,24,18,6,1
SBI52ZIS1236743,73,26,15,11,1
SBI11HYB1616145,99,27,23,4,1
SBI94MUK7337928,62,15,12,3,1
SBI84SAM6307442,61,26,23,3,1
SBI02WBT3815013,84,27,22,5,1
SBI99REP6110153,68,24,21,3,1
SBI77HWM5426165,89,23,15,8,1
SBI96UIC2726757,91,28,15,13,1
SBI70ZWX3461911,79,30,26,4,1
SBI45WCD3092042,68,24,20,4,1
SBI84IUJ6580443,95,21,20,1,1
SBI64CMJ2255842,76,26,17,9,1
SBI01YNL0528137,99,28,18,10,1
SBI10NQA2875035,92,24,14,10,1
SBI75BJS8701762,60,18,13,5,1
SBI87NVT7462805,25,34,27,7,1
SBI93FHE8048304,88,22,15,7,1
SBI42FTY0838433,61,31,21,10,1
SBI78AXC9884571,89,26,15,11,1
SBI99WHQ9996036,89,26,14,12,1
SBI52LJB6450763,91,34,24,10,1
SBI62EVF4270581,83,28,22,6,1
SBI24VDR2931958,78,26,23,3,1
SBI39WKF7904820,99,19,16,3,1
SBI41JPX7937070,75,22,18,4,1
SBI62FBS5855443,63,22,17,5,1
SBI49YQJ2600127,72,28,19,9,1
SBI87FNZ7266079,83,25,21,4,1
SBI35UNY6208691,66,21,16,5,1
SBI54IVU1971580,76,22,18,4,1
SBI63EYV5683640,70,28,23,5,1
SBI50STQ7419796,68,25,21,4,1
SBI66WSO7159527,64,15,9,6,1
SBI63LRN9354838,66,28,15,13,1
SBI94HUY1484427,84,27,24,3,1
SBI12YPQ9598809,62,29,27,2,1
SBI81IUA2601634,95,30,29,1,1
SBI52HWO5007071,23,26,24,2,1
SBI99CME2549056,80,25,14,11,1
SBI95QDB4609247,21,17,11,6,1
SBI44TKK9540980,73,21,18,3,1
SBI58QCU6886347,96,25,18,7,1
SBI74KNN8179864,65,29,21,8,1
SBI92PKL0947967,75,32,24,8,1
SBI37NLY2539110,24,24,14,10,1
SBI44RSM3265225,88,21,14,7,1
SBI22MAE6748008,63,30,18,12,1
SBI94LKI7335990,92,24,19,5,1
SBI69ZQB6513041,18,21,12,9,1
SBI39QZN7999447,85,27,17,10,1
SBI53IHN0397091,64,27,16,11,1
SBI16DQH3239894,79,22,15,7,1
SBI34ZQC8871544,92,26,15,11,1
SBI26MYG9250398,61,19,15,4,1
SBI32WRH4261776,84,25,22,3,1
SBI82IUO1756882,81,30,19,11,1
SBI81ESG4820790,60,21,16,5,1
SBI68ZRL2764903,65,18,14,4,1
SBI74LUU6254158,23,20,15,5,1
SBI08XPQ5756040,71,33,24,9,1
SBI82UEX4489247,73,37,31,6,1
SBI10KEZ7677619,99,26,20,6,1
SBI82NME2339372,20,29,26,3,1
SBI20RPW1148580,20,28,22,6,1
SBI80AQX5338141,77,19,13,6,1
SBI67RSU7615469,69,21,16,5,1
SBI87HLD9036099,91,23,16,7,1
SBI68RES7245033,87,27,16,11,1
SBI22GHU1571037,93,13,9,4,1
SBI95FWJ4609435,98,23,15,8,1
SBI74WBJ4267476,22,33,32,1,1
SBI47EKX5373432,82,30,22,8,1
SBI88CBK0902461,93,29,15,14,1
SBI97LCZ2641200,91,12,10,2,1
SBI12TWE0668317,18,31,26,5,1
SBI49MTB9410238,65,21,13,8,1
SBI27QWO1286656,20,30,16,14,1
SBI52IHP6279641,73,27,14,13,1
SBI38LFE3087968,63,25,16,9,1
SBI79VBW5299959,61,25,18,7,1
SBI76GCM0253164,71,24,16,8,1
SBI44ZVM3029807,79,23,12,11,1
SBI40BFR6317312,69,19,16,3,1
SBI92FJH5056576,80,26,15,11,1
SBI08LGC0631440,73,28,19,9,1
SBI68KJX5230230,81,15,12,3,1
SBI10GRV3903328,82,32,30,2,1
SBI48ODN6647206,22,12,9,3,1
SBI36TLC2653024,89,23,13,10,1
SBI39ZXB2485390,77,28,15,13,1
SBI20TNB1245612,91,14,12,2,1
SBI44HSX2049950,78,31,22,9,1
SBI12SVD5378140,81,26,23,3,1
SBI39UNQ5523142,97,31,25,6,1
SBI00XPR9088718,82,18,14,4,1
SBI18CEM8328207,68,22,18,4,1
SBI87ZSO7700439,70,26,24,2,1
SBI70QGN4717105,20,15,12,3,1
SBI13THU2150971,75,26,16,10,1
SBI49UIY4760088,62,26,21,5,1
SBI17UTL2016859,68,24,23,1,1
SBI25OIU1770247,66,26,20,6,1
SBI70OFB2827673,96,23,22,1,1
SBI94SJQ5194561,18,28,16,12,1
SBI43FNS5915810,69,21,16,5,1
SBI25UYH5882566,92,34,23,11,1
SBI50EOV6716940,25,30,25,5,1
SBI32ZKD3880824,99,15,12,3,1
SBI28AZE9401610,75,27,23,4,1
SBI26OGW4102267,62,30,23,7,1
SBI49SRW5285093,96,25,16,9,1
SBI42AHI6156934,88,22,19,3,1
SBI86OIR2529575,92,20,12,8,1
SBI12XMG3516235,97,25,22,3,1
SBI25DAN3966631,95,31,23,8,1
SBI75HQH8726065,82,28,22,6,1
SBI45GEP1090970,66,22,16,6,1
SBI10HYM4497268,69,23,14,9,1
SBI64BXA2946563,61,23,12,11,1
SBI78SBT6104988,95,25,20,5,1
SBI36UBR1359022,78,23,14,9,1
SBI55EVV5599640,66,25,17,8,1
SBI49URE6298207,66,26,24,2,1
SBI25IJR9955560,19,30,26,4,1
SBI44NID3734307,99,18,14,4,1
SBI57VOM4841898,94,27,26,1,1
SBI16RNG5708458,75,28,19,9,1
SBI72FOZ0390570,88,28,18,10,1
SBI17DSY6206097,86,17,10,7,1
SBI34XSG2351436,90,22,20,2,1
SBI90YOC7281674,67,33,21,12,1
SBI47NXY7872817,18,21,13,8,1
SBI48FEH1908269,63,26,16,10,1
SBI43QXX2577645,63,24,16,8,1
SBI43IVG5090364,90,17,16,1,1
SBI57BKV1661936,87,32,23,9,1
SBI63BPQ4115630,90,23,15,8,1
SBI41FGM3143850,88,22,18,4,1
SBI39MCX8326599,93,27,19,8,1
SBI50PCD1225316,23,29,27,2,1
SBI05IVG7141127,76,24,16,8,1
SBI42IHY9452840,85,29,20,9,1
SBI78CTW6829037,90,12,10,2,1
SBI07JCP9043829,74,18,10,8,1
SBI27LJL6698769,78,18,16,2,1
SBI92YNR5680380,72,23,18,5,1
SBI35GCD2834098,85,30,26,4,1
SBI41TVV7647410,80,22,16,6,1
SBI96JNP5029963,90,21,17,4,1
SBI78XXZ1723275,86,21,11,10,1
SBI24SAW1546626,64,25,19,6,1
SBI68EJK9806215,82,29,28,1,1
SBI66QOF6111500,96,28,18,10,1
SBI58AXQ4441054,62,16,10,6,1
SBI61SWB2864280,68,25,17,8,1
SBI59HUR4735599,73,31,27,4,1
SBI84FFY8281539,98,26,14,12,1
SBI71YXS4164128,88,21,11,10,1
SBI03RNI3010186,84,27,25,2,1
SBI37FLR7849476,25,30,21,9,1
SBI42KXH7955153,84,26,16,10,1
SBI14JWH8536557,69,23,16,7,1
SBI76LLF6040815,63,23,13,10,1
SBI92OJC0296537,73,13,12,1,1
SBI70UXS6637336,19,31,20,11,1
SBI03UDG2626529,69,22,18,4,1
SBI26NDI8355800,20,27,17,10,1
SBI17TNS1918011,93,26,23,3,1
SBI43SNM8619757,72,29,16,13,1
SBI66ACV2725472,96,30,28,2,1
SBI15ZQR7454760,81,27,24,3,1
SBI09JBM4079359,75,31,30,1,1
SBI69IIF9570374,24,25,20,5,1
SBI22YVP5518556,76,11,6,5,1
SBI17YHX8239581,76,32,26,6,1
SBI43BET1784639,94,30,18,12,1
SBI85LUJ2521977,69,28,16,12,1
SBI97TVY5825429,63,16,12,4,1
SBI99RUM8698219,86,24,17,7,1
SBI96WRZ8530685,77,28,20,8,1
SBI37CUO4139006,25,23,17,6,1
SBI71MJA5565049,73,22,13,9,1
SBI03WSN1316836,95,30,26,4,1
SBI80XTF8767869,85,28,23,5,1
SBI60OTO9169188,63,21,20,1,1
SBI87YRH3982795,92,26,21,5,1
SBI48VEE0628602,66,22,19,3,1
SBI64RSK9907673,74,19,18,1,1
SBI71EBQ3258529,73,27,17,10,1
SBI71OVM1819137,69,25,14,11,1
SBI36TZU1792432,67,18,13,5,1
SBI58LGX1798981,76,22,15,7,1
SBI02YYK6917923,77,29,17,12,1
SBI26BXU4192430,25,24,14,10,1
SBI98DBB6773260,78,29,22,7,1
SBI43OPW0929119,92,26,23,3,1
SBI37PRK4133648,80,30,25,5,1
SBI74DJP9930066,92,26,23,3,1
SBI07NLK8853438,88,23,16,7,1
SBI53FPV2378651,69,24,23,1,1
SBI12BJV4423877,65,27,24,3,1
SBI75GEH0153938,25,28,17,11,1
SBI61NLO4085238,25,34,23,11,1
SBI72EJG5719954,88,24,19,5,1
SBI85EBC3153296,93,23,14,9,1
SBI96SJW1249569,85,27,25,2,1
SBI27TQQ6824635,95,26,16,10,1
SBI90KTM3903212,78,29,24,5,1
SBI20SML5325352,92,17,16,1,1
SBI79IYJ3063825,94,18,12,6,1
SBI70JMZ8336674,97,26,25,1,1
SBI59ZRC7982646,86,26,21,5,1
SBI69QYA4488534,84,20,18,2,1
SBI13LFT5718751,76,28,24,4,1
SBI94SBM9116225,83,21,18,3,1
SBI53HWG5711249,23,25,18,7,1
SBI22PDQ5839916,66,23,16,7,1
SBI60KKS5270989,66,17,11,6,1
SBI20QNQ7047778,21,22,12,10,1
SBI60LMC8151046,93,20,12,8,1
SBI59YPG1373536,89,24,19,5,1
SBI85YYR8049519,92,22,20,2,1
SBI77DFV7669787,86,22,17,5,1
SBI05UKF2748332,18,24,16,8,1
SBI70IEU5949092,84,17,14,3,1
SBI77YJO8683922,88,27,25,2,1
SBI74KRA9169301,18,28,26,2,1
SBI03KKA5855291,75,24,20,4,1
SBI06XNJ6959012,21,20,15,5,1
SBI38IRN6264787,79,23,18,5,1
SBI16CMP5414862,63,30,20,10,1
SBI50MIH3571176,19,20,16,4,1
SBI04YCO0920301,99,21,14,7,1
SBI05GNJ9973153,19,20,16,4,1
SBI35NNA7996405,76,31,26,5,1
SBI35XPX4845512,85,23,20,3,1
SBI95KTE4032384,78,21,20,1,1
SBI41WKX7757358,66,21,13,8,1
SBI29GCG9011339,67,21,20,1,1
SBI51CAM4035392,92,22,14,8,1
SBI88TCL0099539,83,29,20,9,1
SBI50CYP7434350,90,24,21,3,1
SBI03VYS6961822,74,23,12,11,1
SBI91TVJ2382455,75,14,8,6,1
SBI28GZY4687817,73,28,19,9,1
SBI12QCO8787554,86,25,22,3,1
SBI10AYV1781161,63,21,18,3,1
SBI76NPX2284230,91,20,19,1,1
SBI38CKH2936516,18,27,25,2,1
SBI23IFG7913704,84,30,21,9,1
SBI06PWP2229424,18,23,21,2,1
SBI55RCS6733813,99,19,16,3,1
SBI16RDE7918975,72,27,14,13,1
SBI93SNK0788998,72,34,30,4,1
SBI86QEY8338620,96,24,19,5,1
SBI09ZPF1578345,86,27,14,13,1
SBI25PWM2244797,60,28,19,9,1
SBI67MZP5408823,86,22,18,4,1
SBI38SAE3067470,25,33,25,8,1
SBI05DYE2722702,73,31,24,7,1
SBI34ZJV0354400,76,29,23,6,1
SBI52YZT0843261,88,18,15,3,1
SBI72UOW9270490,25,25,15,10,1
SBI74QHU1810361,83,29,28,1,1
SBI17EPV8944865,63,31,25,6,1
SBI10FLX3947994,98,24,19,5,1
SBI22CVB6939920,19,16,15,1,1
SBI28RYH8714315,85,11,7,4,1
SBI46OJS1117617,68,29,18,11,1
SBI56XOH1236933,61,20,13,7,1
SBI24RZF9963289,96,30,18,12,1
SBI27WKG1229038,95,16,13,3,1
SBI35EYT8039559,88,23,19,4,1
SBI50HXJ4690502,87,17,14,3,1
SBI48DYV2543454,86,24,23,1,1
SBI80AUI6378793,70,17,15,2,1
SBI38ACB6888819,18,32,29,3,1
SBI56PXB7681977,86,25,20,5,1
SBI93HHK9403208,81,22,18,4,1
SBI90NFS8260814,66,26,22,4,1
SBI87GYW9156242,98,23,20,3,1
SBI14CUZ0598592,94,28,15,13,1
SBI39PZR5739796,21,31,22,9,1
SBI74VQF5302336,94,27,24,3,1
SBI21GQH9411609,87,27,19,8,1
SBI27GEV6892383,64,29,18,11,1
SBI96LFB0978931,23,22,18,4,1
SBI12QUW7814850,79,25,22,3,1
SBI14ACL2750964,89,25,13,12,1
SBI35SPK3008966,77,26,19,7,1
SBI11OTR2345706,78,26,20,6,1
SBI88ZZS6983188,96,30,20,10,1
SBI41LZQ5694969,75,22,13,9,1
SBI61MGB6071745,99,28,17,11,1
SBI73UGI4746933,79,21,20,1,1
SBI04JIY1755239,24,32,19,13,1
SBI21HCU9465717,95,21,20,1,1
SBI00ZDF7307440,67,28,19,9,1
SBI35VHB2245584,97,21,20,1,1
SBI85LAY0316636,25,22,13,9,1
SBI82WTP3032428,83,26,20,6,1
SBI20ZFE4235395,21,15,10,5,1
SBI40URR7056342,75,30,25,5,1
SBI69CCG9316786,22,26,19,7,1
SBI61EYA3870977,22,32,27,5,1
SBI59ZTQ7906777,79,21,11,10,1
SBI29NZG8298823,69,28,24,4,1
SBI20HAT5793996,97,30,16,14,1
SBI27GSM8695188,73,30,29,1,1
SBI49NEO4791257,21,26,16,10,1
SBI56ONM4201475,78,25,16,9,1
SBI08GIZ3875570,63,25,16,9,1
SBI04XNN1009835,25,34,19,15,1
SBI66NCD9855871,60,22,16,6,1
SBI96KTT7549143,76,20,17,3,1
SBI39OAD1084410,90,31,24,7,1
SBI40BHD7702970,63,28,23,5,1
SBI02DUL7790706,63,35,22,13,1
SBI26EXA5322397,69,23,12,11,1
SBI06BRY5566448,66,21,14,7,1
SBI38EVJ9158200,85,25,19,6,1
SBI86FRV8105866,79,25,13,12,1
SBI90AXL6807446,61,27,20,7,1
SBI32DWU8491342,83,30,23,7,1
SBI38RYL4345816,64,26,14,12,1
SBI73JVU8403762,66,19,10,9,1
SBI94LFE0301268,77,27,20,7,1
SBI38BIA3916342,87,21,18,3,1
SBI99ADY8678312,88,28,17,11,1
SBI66QQN0711266,62,24,23,1,1
SBI39BDO7589307,18,29,23,6,1
SBI10YOG2489348,18,21,16,5,1
SBI57AAM3484738,18,33,17,16,1
SBI92OSD9902779,94,22,18,4,1
SBI43ZAZ7707035,61,29,22,7,1
SBI10ZAN0044217,22,19,11,8,1
SBI20AGM8592280,69,19,13,6,1
SBI32IIJ4500011,73,17,12,5,1
SBI26EJQ7452952,89,33,30,3,1
SBI45LPK9647760,66,26,20,6,1
SBI65UVZ7748896,84,34,26,8,1
SBI23HLB1355941,18,28,18,10,1
SBI86EPI4984158,19,21,11,10,1
SBI32DJC5475560,18,24,23,1,1
SBI15CYN2349961,88,28,15,13,1
SBI07KZN1994361,74,21,13,8,1
SBI60CNK1291190,25,26,18,8,1
SBI45UPK2130755,93,21,19,2,1
SBI70ZQE6193519,88,24,21,3,1
SBI75XLE4501502,20,25,20,5,1
SBI31WPW4886585,67,22,12,10,1
SBI10MEV6330894,64,23,22,1,1
SBI67OQM6536593,94,22,15,7,1
SBI72XRI8081079,21,23,16,7,1
SBI38YSC3168754,70,28,21,7,1
SBI44OUS8098818,68,29,17,12,1
SBI58TJB9435604,19,26,24,2,1
SBI88DZW7929112,64,20,13,7,1
SBI72DRV4977325,88,17,9,8,1
SBI01WVX7435984,92,24,15,9,1
SBI06FGV3379114,69,19,17,2,1
SBI77XYJ6793485,76,23,12,11,1
SBI18TGY9114293,98,29,17,12,1
SBI84QBZ1189308,65,33,25,8,1
SBI64NMZ7005507,20,23,22,1,1
SBI74BZL3429270,83,24,22,2,1
SBI76XBW3034607,97,20,19,1,1
SBI29QMB8906480,61,25,22,3,1
SBI96YAZ1730496,78,26,14,12,1
SBI21VPH7555817,75,27,20,7,1
SBI67ZKB8597760,60,23,20,3,1
SBI37NDE6588560,83,26,20,6,1
SBI86ISM9307534,25,30,16,14,1
SBI90HPM2002537,99,27,15,12,1
SBI38SAU1525213,87,25,13,12,1
SBI28EHS9389230,61,23,17,6,1
SBI99NIN6578617,69,26,19,7,1
SBI72NRY4884930,64,36,20,16,1
SBI11ALL6288189,87,19,17,2,1
SBI27FJD0091055,61,28,22,6,1
SBI04ZJV0196903,88,24,19,5,1
SBI53YXI3846474,62,14,12,2,1
SBI61SSI2232718,69,42,39,3,1
SBI21RTK2707409,60,25,22,3,1
SBI93YDR1725594,97,22,21,1,1
SBI73CUE2026192,71,37,31,6,1
SBI23BAZ9694059,88,22,19,3,1
SBI17PHR3180983,92,29,18,11,1
SBI17OJD2415576,94,32,27,5,1
SBI11XWJ8801903,92,22,19,3,1
SBI17GZS8482805,97,27,18,9,1
SBI04JWK3593886,96,21,18,3,1
SBI54BRS5140226,94,25,24,1,1
SBI82FYW1259111,71,28,25,3,1
SBI75EIP7777616,23,24,13,11,1
SBI73FCX2540396,78,25,16,9,1
SBI61WYK9515302,84,22,15,7,1
SBI22LGK5832913,21,29,19,10,1
SBI99BXO6541739,21,24,18,6,1
SBI10QVQ1582671,19,22,14,8,1
SBI20LBS3521516,62,25,17,8,1
SBI20DOV5321921,70,24,15,9,1
SBI24IXI1158642,78,21,16,5,1
SBI80MCU6826668,89,26,20,6,1
SBI64WVK1329230,69,23,18,5,1
SBI28JAJ8558846,97,23,19,4,1
SBI57TDE2707843,19,31,24,7,1
SBI61FIM0994710,74,24,14,10,1
SBI96KAA2149300,65,17,14,3,1
SBI23GPQ4256753,67,21,18,3,1
SBI55SYH0471062,64,24,18,6,1
SBI93WEO5193759,72,28,21,7,1
SBI75QBS8062714,90,26,24,2,1
SBI80DDU5029302,60,23,17,6,1
SBI04GID2890292,73,22,13,9,1
SBI44MZS4705164,77,6,4,2,1
SBI29ZTD1091938,69,24,19,5,1
SBI49PKC7957634,86,27,15,12,1
SBI83RLS7333354,96,28,19,9,1
SBI34BZU0347531,95,25,20,5,1
SBI91TNI2003578,78,25,14,11,1
SBI69TDU1745248,82,33,26,7,1
SBI38EYD4032787,75,19,17,2,1
SBI04GXO0163832,62,16,11,5,1
SBI38STL1528981,78,30,27,3,1
SBI76WIU8950834,79,22,12,10,1
SBI29EYR1501477,92,23,13,10,1
SBI39JBG6671738,66,35,18,17,1
SBI32TLH2428862,89,20,18,2,1
SBI70ZYY5534937,97,21,20,1,1
SBI09EMN3595873,76,28,25,3,1
SBI73KGA7440033,83,27,16,11,1
SBI12TPI6309290,83,30,20,10,1
SBI49JNJ3287405,66,20,16,4,1
SBI87EEV6574113,93,22,21,1,1
SBI44FBL1591828,63,18,11,7,1
SBI21KKU4522712,75,24,13,11,1
SBI97SFE8182848,93,23,13,10,1
SBI32ZOI7577843,86,27,23,4,1
SBI85CDW6752462,96,23,20,3,1
SBI50XPB1484733,75,29,23,6,1
SBI77SCZ0715561,81,21,16,5,1
SBI93FPV7725371,94,23,18,5,1
SBI40NAB7510786,89,27,19,8,1
SBI46CTN3081293,97,28,19,9,1
SBI05MSF2002745,75,23,22,1,1
SBI74HWG7828381,92,35,30,5,1
SBI91YLC2161834,94,20,14,6,1
SBI83FCO4421481,72,27,21,6,1
SBI69IVL8952306,79,24,15,9,1
SBI17LQZ0991549,77,31,20,11,1
SBI74RGF2533771,84,33,24,9,1
SBI50RAQ1674327,18,18,16,2,1
SBI08LWY8964473,85,29,18,11,1
SBI67VNL2384404,18,32,25,7,1
SBI39DMR0506618,87,17,16,1,1
SBI33HZI1374430,98,28,15,13,1
SBI67NRB2465812,65,29,23,6,1
SBI58RIY8289343,24,27,23,4,1
SBI10ZOY5595839,80,27,21,6,1
SBI68BPC8191526,91,28,26,2,1
SBI96NYB4005286,85,18,12,6,1
SBI28QTQ2775984,70,25,22,3,1
SBI59HJP8368276,65,20,17,3,1
SBI74YPJ4284001,66,25,14,11,1
SBI72NKP4467714,89,26,18,8,1
SBI75TEJ1871927,78,20,14,6,1
SBI88ESF1385154,96,30,29,1,1
SBI43BAP4183823,75,19,14,5,1
SBI21AMK2932119,22,32,31,1,1
SBI57GLM8439677,64,21,18,3,1
SBI52FNT4373413,73,17,15,2,1
SBI41MTC4214776,99,25,14,11,1
SBI69LCN0639166,96,21,11,10,1
SBI48YJY0295805,96,23,12,11,1
SBI11GOL5751442,60,24,19,5,1
SBI33OYZ9205647,74,29,25,4,1
SBI98MIA7168114,86,22,16,6,1
SBI58JGZ0823647,79,24,15,9,1
SBI95SGZ1178514,68,26,20,6,1
SBI86IKO7184336,93,30,18,12,1
SBI06NBF8264567,21,29,19,10,1
SBI00TVN0285516,21,25,14,11,1
SBI99WYI9265642,71,26,16,10,1
SBI59ARE0237467,66,28,21,7,1
SBI83DLE3456410,98,27,19,8,1
SBI82PXT2391289,83,32,20,12,1
SBI85IYV3135463,73,31,24,7,1
SBI14RKG8950454,65,27,24,3,1
SBI56AGM6408332,91,25,20,5,1
SBI55IZI9633904,72,29,22,7,1
SBI06PUP0793848,87,27,17,10,1
SBI02XOY9428640,99,24,20,4,1
SBI63YVW3047564,70,17,14,3,1
SBI45GTK4636933,71,21,16,5,1
SBI45RCX8284193,92,23,19,4,1
SBI51YBJ9219645,20,38,37,1,1
SBI62TGC9821403,73,21,19,2,1
SBI63SLP9023443,61,31,20,11,1
SBI57WQG9604015,74,25,15,10,1
SBI33UQA9897432,97,20,11,9,1
SBI58VUZ5949935,83,27,19,8,1
SBI10RMC8352177,80,23,13,10,1
SBI24SVV0937635,66,25,19,6,1
SBI34XCP3901502,80,25,17,8,1
SBI45PMB7654312,62,20,19,1,1
SBI73BBM0776709,18,25,18,7,1
SBI49SCQ9384057,78,31,16,15,1
SBI72SXM7166415,21,22,17,5,1
SBI56BMP4422849,75,21,20,1,1
SBI73XIR3819409,89,28,25,3,1
SBI54IXS1524888,24,19,16,3,1
SBI95ZTC5902445,18,30,23,7,1
SBI11ZOO1837058,86,25,13,12,1
SBI40MLG4463254,72,24,13,11,1
SBI95WAY9104929,67,20,17,3,1
SBI47ZME0054820,21,18,13,5,1
SBI47JGM8058617,80,25,21,4,1
SBI75QUY9722124,96,28,24,4,1
SBI04JTV9674987,77,30,27,3,1
SBI35NUL3261097,77,26,23,3,1
SBI09VZU6898635,82,18,14,4,1
SBI62SGC5264340,82,32,21,11,1
SBI62DBX8046219,83,21,14,7,1
SBI87RSP9653095,90,26,16,10,1
SBI72AYL9341763,24,25,13,12,1
SBI33YDQ9304241,22,31,26,5,1
SBI73RPU3785419,96,27,17,10,1
SBI51YVV7354974,72,27,19,8,1
SBI52OAD2753091,75,23,12,11,1
SBI34TBH3760088,69,26,22,4,1
SBI74DIB2190876,93,24,19,5,1
SBI14MWF1253024,63,31,19,12,1
SBI59QWX0072843,86,23,19,4,1
SBI21PQN7239179,94,27,21,6,1
SBI25KUA2968346,78,37,19,18,1
SBI18BIM5159240,63,24,19,5,1
SBI66FQO2922312,97,23,22,1,1
SBI19EXW6173799,88,17,11,6,1
SBI75BGC5520226,90,28,19,9,1
SBI83VTK0336138,70,31,17,14,1
SBI12UZZ0264148,69,19,12,7,1
SBI75NRV0762427,78,20,19,1,1
SBI67JET4822679,84,32,31,1,1
SBI18YGI5248199,98,21,20,1,1
SBI14LNB6700621,92,26,17,9,1
SBI86HSJ7866472,97,17,14,3,1
SBI08KVK4233090,95,26,23,3,1
SBI30IDQ3216159,69,42,38,4,1
SBI44IUP2924681,86,30,18,12,1
SBI64XHL4444470,94,31,25,6,1
SBI53IIK7640292,85,21,18,3,1
SBI26ETO2311223,69,31,29,2,1
SBI06XBX3770555,74,21,11,10,1
SBI90WPS5643213,80,25,16,9,1
SBI88BPQ0974686,61,14,11,3,1
SBI15XDA0152943,86,22,12,10,1
SBI07QRL5908517,79,23,15,8,1
SBI96NRB8547687,24,25,18,7,1
SBI60BRF1119971,74,29,26,3,1
SBI33ZJI9400839,99,19,10,9,1
SBI68MHW2104159,79,22,19,3,1
SBI44OTS3746064,84,23,21,2,1
SBI89XQG5090426,97,21,20,1,1
SBI32XXO9384352,62,25,20,5,1
SBI80WAO5013717,74,22,16,6,1
SBI29OQB3347595,18,16,13,3,1
SBI79BMC6547931,21,19,16,3,1
SBI95PNK6677925,67,21,17,4,1
SBI57BTW5428535,97,18,12,6,1
SBI03UHM0363328,83,24,14,10,1
SBI19QTX0002362,22,25,14,11,1
SBI40BNW7093779,20,23,16,7,1
SBI91TRA4441890,22,22,13,9,1
SBI81IGI7994921,63,23,13,10,1
SBI21FKY3147917,98,23,12,11,1
SBI05TST9357866,92,33,31,2,1
SBI40VFH0582606,22,38,27,11,1
SBI03CND0631071,74,27,21,6,1
SBI69TGJ2341220,87,35,27,8,1
SBI61KFR5950407,97,31,16,15,1
SBI39ZQC4724075,22,26,21,5,1
SBI85UAR8472532,79,29,21,8,1
SBI77HBS8874710,81,24,16,8,1
SBI49QYV1574554,75,28,20,8,1
SBI24BTY8968281,91,24,23,1,1
SBI95QVY4225471,63,19,12,7,1
SBI31OWD4459519,93,24,14,10,1
SBI09DWP7092604,96,32,20,12,1
SBI84ELN5892689,22,33,32,1,1
SBI20HKN3984306,64,17,14,3,1
SBI44SQZ7704119,96,28,20,8,1
SBI08NOR3114126,18,21,14,7,1
SBI03KQW3948952,96,27,17,10,1
SBI47JRE4096015,64,26,16,10,1
SBI53NQZ5727931,91,24,16,8,1
SBI68WGE7779390,81,22,18,4,1
SBI40FJQ2506130,90,20,16,4,1
SBI47SVM9549617,74,27,14,13,1
SBI01SFR3400519,71,24,16,8,1
SBI67FTS0832320,64,26,24,2,1
SBI64YHP2983015,84,37,33,4,1
SBI11FEH4229704,21,17,15,2,1
SBI74TIF7144380,89,17,9,8,1
SBI02PQO0770251,62,20,11,9,1
SBI22LDD9016920,71,20,12,8,1
SBI87EHY4074414,75,20,11,9,1
SBI09IPG4216269,82,26,24,2,1
SBI48CYM2002352,95,19,10,9,1
SBI75QEM7308210,82,32,28,4,1
SBI45ZLT6529620,93,33,20,13,1
SBI84YPX6815126,68,37,30,7,1
SBI51LFJ4225686,83,15,14,1,1
SBI62OJC1681100,68,22,12,10,1
SBI99YQW6904496,96,28,15,13,1
SBI77WES8012914,98,28,22,6,1
SBI02JDY1686195,74,29,22,7,1
SBI20VJR0555290,67,30,21,9,1
SBI23NZI0831748,67,20,13,7,1
SBI09EOV5676713,99,25,15,10,1
SBI43JKC9126437,61,21,11,10,1
SBI85HWB3899165,23,24,23,1,1
SBI70ZBQ0312845,84,28,24,4,1
SBI69BNU6064196,94,15,11,4,1
SBI19IXJ7254886,94,25,20,5,1
SBI83GCR5547351,78,21,15,6,1
SBI89TRA7137073,89,23,12,11,1
SBI08NML5061434,70,24,13,11,1
SBI35JYK1800454,83,19,11,8,1
SBI58THW4763643,92,28,21,7,1
SBI92OCG5087322,91,26,16,10,1
SBI28PWS5892748,81,20,14,6,1
SBI38JTJ9468194,22,23,19,4,1
SBI04CRF1107077,60,32,24,8,1
SBI88RHG5900639,75,26,16,10,1
SBI35VAD0969025,76,25,22,3,1
SBI25PSA5152753,85,19,11,8,1
SBI13FAH4662996,68,22,20,2,1
SBI71HRJ8709996,67,15,8,7,1
SBI48WSL6299773,99,16,14,2,1
SBI39CYN4697583,94,22,20,2,1
SBI87BGY4587393,68,21,16,5,1
SBI67VNX6185074,66,25,15,10,1
SBI17FBN5210833,67,26,21,5,1
SBI18MZZ3331257,71,25,24,1,1
SBI07PUY3369462,96,26,21,5,1
SBI06CTS4365364,93,20,11,9,1
SBI34ANN4156683,18,19,12,7,1
SBI39DFW8578763,89,25,20,5,1
SBI84SGC8466145,83,24,21,3,1
SBI84TZI9827258,20,20,18,2,1
SBI97WSJ1025151,25,31,20,11,1
SBI88FHA8785792,86,23,13,10,1
SBI14CEB8166581,91,27,21,6,1
SBI57LQM8400186,91,19,15,4,1
SBI61DZP8852612,22,19,14,5,1
SBI47ASK6781154,63,29,28,1,1
SBI04LQG3596819,19,27,15,12,1
SBI74YZM1301123,18,16,13,3,1
SBI39GZZ6613363,77,22,14,8,1
SBI67DPA8094686,80,22,21,1,1
SBI51XEI8808498,84,17,9,8,1
SBI39BHI6567538,95,26,22,4,1
SBI04GZQ1523467,65,16,11,5,1
SBI35KTV7722695,22,22,19,3,1
SBI61MYY1000645,71,24,20,4,1
SBI74EXJ7160121,98,29,21,8,1
SBI08XKG9781324,99,21,13,8,1
SBI96JRM3317601,70,18,11,7,1
SBI00CDM4028754,72,29,22,7,1
SBI21MZR4458939,71,27,18,9,1
SBI78LTV0773140,90,30,20,10,1
SBI40JFM0415619,62,25,14,11,1
SBI28UJX8837069,73,22,21,1,1
SBI00ITP3450961,89,17,14,3,1
SBI78WEJ5361148,73,33,17,16,1
SBI74UCN6209657,80,25,13,12,1
SBI99TDB5430745,99,29,20,9,1
SBI76AGD0441410,91,16,12,4,1
SBI96ORD8559897,74,21,16,5,1
SBI46TYS6497775,24,29,28,1,1
SBI84EUH0979708,95,30,17,13,1
SBI81LAX1424289,60,28,21,7,1
SBI71NAR6530010,74,33,22,11,1
SBI55JQA2573738,68,22,18,4,1
SBI62PMJ0353912,97,29,16,13,1
SBI41VLJ7349744,71,28,20,8,1
SBI90QAT0705159,22,30,29,1,1
SBI16AYG5539890,23,21,13,8,1
SBI02WYJ2066403,18,22,13,9,1
SBI62XCN7132014,92,24,14,10,1
SBI52SIM2601699,97,24,15,9,1
SBI91WCX2411628,66,23,17,6,1
SBI66AAT2622981,18,23,18,5,1
SBI69MOV4306742,90,24,13,11,1
SBI08JRD9286262,63,27,14,13,1
SBI77NPD2323708,75,27,14,13,1
SBI07UWY5142124,99,30,28,2,1
SBI67IHE8264754,66,15,14,1,1
SBI84AOY9647820,19,18,10,8,1
SBI72OWE6002656,60,24,13,11,1
SBI45MCG4782092,25,31,16,15,1
SBI95QYW1275911,94,22,19,3,1
SBI82APJ0406665,19,18,15,3,1
SBI81AUP3494355,89,29,22,7,1
SBI86BLA7375185,83,43,41,2,1
SBI54AOH5982559,78,28,15,13,1
SBI23HFP6027811,83,19,15,4,1
SBI65KFR9807829,99,24,21,3,1
SBI16MLE8192275,69,24,15,9,1
SBI79XIU3952727,18,30,22,8,1
SBI50XCU6465517,65,24,20,4,1
SBI93XKT9377768,79,24,17,7,1
SBI11MNU6758413,24,26,18,8,1
SBI73XEY1074812,23,30,18,12,1
SBI82JSU8656041,76,29,28,1,1
SBI68TCT0297154,61,33,28,5,1
SBI65RWK2274603,80,19,18,1,1
SBI69CPK0474053,98,28,18,10,1
SBI70GEY4867506,77,23,17,6,1
SBI10JTP3696920,95,25,18,7,1
SBI57GSD8158001,68,14,9,5,1
SBI60OUB0584274,71,32,26,6,1
SBI82MVS7375169,68,24,20,4,1
SBI39JAQ1530189,93,23,22,1,1
SBI70BFJ8388949,75,22,14,8,1
SBI13PCC1443485,65,26,18,8,1
SBI28SWB6878426,77,24,13,11,1
SBI86FPY6300627,67,28,15,13,1
SBI83UYJ3124891,20,29,17,12,1
SBI98MSK3461845,96,22,15,7,1
SBI99QFP6961665,62,21,18,3,1
SBI94OPM6202701,60,26,18,8,1
SBI83IBK3531898,90,28,16,12,1
SBI07DES1038310,90,31,16,15,1
SBI30HSS1373628,81,15,10,5,1
SBI05IEL6229822,77,27,21,6,1
SBI19OVN0586845,89,22,17,5,1
SBI51LME5023977,88,24,21,3,1
SBI66OQD3170028,75,29,20,9,1
SBI33RAS4880980,92,17,10,7,1
SBI14NQP9410351,19,27,23,4,1
SBI18CKX1443795,70,23,20,3,1
SBI85OZQ0076260,74,26,16,10,1
SBI65OQG9994604,96,25,24,1,1
SBI91IMA3514346,23,22,17,5,1
SBI26JKD6605003,84,31,27,4,1
SBI91HPO2078601,72,21,17,4,1
SBI08TIW7587153,21,19,13,6,1
SBI89CBP1791698,22,29,22,7,1
SBI38ZZS1066751,21,25,20,5,1
SBI48BJQ0395841,75,23,19,4,1
SBI76ITA7959384,85,19,11,8,1
SBI92JOS9679713,67,28,24,4,1
SBI76LPC6191773,78,27,17,10,1
SBI40OPY3252262,64,26,19,7,1
SBI35RDM1588452,98,32,20,12,1
SBI57OWP5663287,24,34,30,4,1
SBI67UGU8375324,92,19,17,2,1
SBI66LYN3115219,99,23,19,4,1
SBI22UUP5991280,83,15,10,5,1
SBI75GOX9801007,73,22,16,6,1
SBI54VAC5487021,89,11,9,2,1
SBI72UNX8633924,61,23,22,1,1
SBI82HAF3042966,60,27,17,10,1
SBI56YUI2937369,89,29,24,5,1
SBI19VBT3976565,86,31,26,5,1
SBI71JAD2093952,91,26,19,7,1
SBI09VYP5667280,18,36,29,7,1
SBI66ZTW2298010,60,31,18,13,1
SBI85BEN5634504,60,27,26,1,1
SBI10QSK7668657,71,21,17,4,1
SBI61CDK0382411,97,22,20,2,1
SBI61UCM8579413,93,16,9,7,1
SBI12KQH2177279,24,20,13,7,1
SBI53SVH4393827,61,14,9,5,1
SBI40EMX0004655,61,28,27,1,1
SBI03GCB3502547,61,28,16,12,1
SBI80VDB8876416,98,26,21,5,1
SBI34HLL8644456,78,27,14,13,1
SBI49MXE2642778,94,34,22,12,1
SBI83FLT7243118,99,18,15,3,1
SBI43CNF9436549,95,23,17,6,1
SBI24EDH1526335,69,17,14,3,1
SBI32HVA3428302,78,28,21,7,1
SBI03ERT3114058,85,22,12,10,1
SBI76CJO8547816,81,31,25,6,1
SBI73GWJ8559864,85,18,17,1,1
SBI77QVI2339417,76,33,18,15,1
SBI40BBK4689874,73,24,13,11,1
SBI55DCI9404667,83,22,17,5,1
SBI20QEA2150682,91,21,13,8,1
SBI85IEM7903769,24,28,19,9,1
SBI50SNI0188355,64,23,22,1,1
SBI95JVU3567480,75,25,14,11,1
SBI86CBQ7006529,96,17,14,3,1
SBI77YLV1534481,73,26,16,10,1
SBI77XXJ1020478,60,21,18,3,1
SBI13CCY5370344,77,23,19,4,1
SBI17ZNB3004001,69,29,15,14,1
SBI41BXB0170768,20,22,12,10,1
SBI67MLI9137224,98,26,25,1,1
SBI15WEY4020699,86,25,19,6,1
SBI72WYL1383794,77,21,20,1,1
SBI42KSI3032842,21,26,15,11,1
SBI25EFH2576457,69,19,15,4,1
SBI29BHY0955496,84,26,23,3,1
SBI14MAA3278124,67,30,20,10,1
SBI57LPJ6675175,98,27,25,2,1
SBI93ECY8382724,79,23,22,1,1
SBI30KTV0875968,77,26,15,11,1
SBI81LQO1942792,69,24,18,6,1
SBI87JMF7819785,61,16,10,6,1
SBI65AKF2927504,71,18,13,5,1
SBI25QHV8644157,65,26,17,9,1
SBI29NZF2172112,62,25,14,11,1
SBI94VLB0326746,84,21,16,5,1
SBI16WCZ4338256,61,21,16,5,1
SBI48YAK4418152,62,29,27,2,1
SBI07FGU8874224,90,21,16,5,1
SBI87EWT5072742,23,25,22,3,1
SBI03HUN8340116,64,27,14,13,1
SBI12IQB3516376,73,35,29,6,1
SBI61IAF7079082,94,28,18,10,1
SBI33QBR7052417,94,23,21,2,1
SBI22LAJ2985170,93,25,14,11,1
SBI24QZE2888227,91,28,22,6,1
SBI13ODV1564545,72,29,21,8,1
SBI88OZI7530385,24,36,25,11,1
SBI79EKL1635766,25,27,16,11,1
SBI28LXI1095083,23,18,11,7,1
SBI67ROS4625065,96,21,20,1,1
SBI81GAH8134267,98,26,25,1,1
SBI63MNF0609678,72,30,19,11,1
SBI27MHO9642966,92,23,13,10,1
SBI03AHV7079616,92,23,21,2,1
SBI93WQG6960773,79,24,14,10,1
SBI67WDQ2699164,68,21,19,2,1
SBI60MPM1692974,20,22,20,2,1
SBI34TWV9984024,75,21,15,6,1
SBI08UVO1608182,22,22,18,4,1
SBI09BRQ0338632,20,31,26,5,1
SBI08FNR6595232,95,25,17,8,1
SBI25XVD2144665,64,19,17,2,1
SBI71YHM8311064,89,27,23,4,1
SBI37YHY2991260,92,21,12,9,1
SBI87IXP1685232,93,23,16,7,1
SBI74VJJ2596580,88,26,18,8,1
SBI02MZZ8095753,19,26,23,3,1
SBI81SQR1034201,95,29,21,8,1
SBI69UWU7633599,70,27,14,13,1
SBI08GWO6473129,25,23,16,7,1
SBI22EGT9929723,24,22,19,3,1
SBI73PXE7895958,71,20,18,2,1
SBI85OGN1261033,69,35,25,10,1
SBI78KMD2798615,94,33,24,9,1
SBI89CII0781103,92,29,25,4,1
SBI11HHT1795403,79,29,27,2,1
SBI50CPC5581874,83,37,30,7,1
SBI61PAK9214805,60,25,15,10,1
SBI34RVG3314993,22,23,12,11,1
SBI22ZND3075086,74,23,16,7,1
SBI86LBQ4224050,18,23,17,6,1
SBI60HEF4853116,90,25,18,7,1
SBI06SJK3350267,89,32,25,7,1
SBI10BYG4635275,21,14,11,3,1
SBI78EPN1689698,66,27,19,8,1
SBI70OOH6576493,99,31,23,8,1
SBI10TBP3395806,85,23,13,10,1
SBI18JSP1450123,70,23,17,6,1
SBI08NHJ2950941,65,27,22,5,1
SBI63UJD5880030,92,36,19,17,1
SBI09KTU9245927,20,11,9,2,1
SBI99WWG2765803,94,27,14,13,1
SBI72ZXZ1193412,83,11,7,4,1
SBI28QSG7534046,98,25,13,12,1
SBI65NID6724852,93,22,12,10,1
SBI42TOA4781458,94,23,14,9,1
SBI14LKZ0449304,94,17,11,6,1
SBI26XHM9938204,22,23,22,1,1
SBI25CTB6568402,72,25,15,10,1
SBI43JRM7589693,97,28,23,5,1
SBI47FTB9248689,19,28,26,2,1
SBI84TQP9015653,80,24,13,11,1
SBI73DCR6230494,97,24,22,2,1
SBI16LJT4649377,87,34,26,8,1
SBI08TLF1015755,93,27,22,5,1
SBI33AFK8170107,83,22,13,9,1
SBI10VPY4946604,91,26,14,12,1
SBI77UMU4156624,22,21,12,9,1
SBI60ORG9541647,22,23,15,8,1
SBI77SCS0846505,84,25,16,9,1
SBI97JTC6743299,85,30,27,3,1
SBI54JEB0598653,23,20,14,6,1
SBI83HQX5004303,91,21,12,9,1
SBI35VMA6405908,85,22,19,3,1
SBI68DCW7722486,62,32,22,10,1
SBI55YFJ8104109,67,30,26,4,1
SBI72IVY0809108,86,27,24,3,1
SBI79GNJ0047882,67,25,22,3,1
SBI37VWS8244977,21,20,15,5,1
SBI06AGH2678492,71,22,14,8,1
SBI07OJK4277534,62,30,23,7,1
SBI90YOS2777542,62,15,14,1,1
SBI70ZCJ7245502,64,18,11,7,1
SBI87VWY2035500,20,27,25,2,1
SBI04THG8332703,70,20,18,2,1
SBI29LHB6537646,68,27,24,3,1
SBI52DBL7020537,76,27,22,5,1
SBI80DTJ3256087,20,24,19,5,1
SBI24VEZ7785945,73,18,11,7,1
SBI26DCS6280317,93,26,17,9,1
SBI36DVE2286096,81,18,14,4,1
SBI36PAT1349167,74,24,20,4,1
SBI29NQM0948042,80,23,22,1,1
SBI48POX0275509,24,30,17,13,1
SBI52EQK0150989,93,17,12,5,1
SBI68CIN6209920,73,20,13,7,1
SBI69XFD7700860,77,28,24,4,1
SBI41EOB1507678,60,16,13,3,1
SBI99SWL1294778,84,28,22,6,1
SBI85JPA0437413,80,32,18,14,1
SBI25PRY7396002,75,28,23,5,1
SBI43KBK7870301,76,25,22,3,1
SBI54WCW7187047,60,25,18,7,1
SBI89WQU8326638,63,12,8,4,1
SBI20DNC3301738,63,18,16,2,1
SBI60DIO2627896,63,24,18,6,1
SBI61GMT2424402,81,25,19,6,1
SBI42UQE9504902,67,25,16,9,1
SBI63YHZ2695883,25,16,12,4,1
SBI73EWZ7707796,73,21,11,10,1
SBI29YVL6588921,25,23,18,5,1
SBI90NJF7895745,97,28,23,5,1
SBI86LDI1890572,68,27,18,9,1
SBI33DHG4673904,21,27,20,7,1
SBI87KHW1975284,85,22,20,2,1
SBI94LAT0158325,90,24,16,8,1
SBI27IQL7565920,21,15,10,5,1
SBI70ZBC4128966,81,24,18,6,1
SBI88SBO6766407,97,20,11,9,1
SBI94SOE2527820,62,30,27,3,1
SBI08FDC7487287,96,26,24,2,1
SBI83PVV4587795,94,29,26,3,1
SBI95BXQ4224162,73,34,18,16,1
SBI62NKI8612325,63,20,13,7,1
SBI24IRZ3666523,97,34,33,1,1
SBI16GUH5884808,83,16,11,5,1
SBI01LDO4239641,66,27,14,13,1
SBI90SEF0245667,23,17,16,1,1
SBI86PXN3793981,90,26,24,2,1
SBI38GVT4893905,66,27,22,5,1
SBI65BAU8779463,91,28,23,5,1
SBI99NXV1961665,21,17,11,6,1
SBI60QVR1831178,68,20,18,2,1
SBI81STT2690775,76,32,30,2,1
SBI15JTI5282049,70,29,18,11,1
SBI66UYF3574328,64,27,24,3,1
SBI24AOO0901146,74,22,17,5,1
SBI83XJS8279791,94,17,9,8,1
SBI26GNR0643617,88,22,19,3,1
SBI55HHD9984323,71,28,24,4,1
SBI29ZAC8772220,98,29,27,2,1
SBI97URE7197920,88,22,16,6,1
SBI09MOM9287078,19,32,22,10,1
SBI72WSP4023364,86,27,26,1,1
SBI30YPR6254733,22,23,22,1,1
SBI59EOM0583610,90,25,13,12,1
SBI54HOQ4189426,71,39,25,14,1
SBI11EAJ6059885,97,18,13,5,1
SBI86TZA3386135,19,19,11,8,1
SBI90VWH2847493,95,19,13,6,1
SBI42BPV1816065,24,29,26,3,1
SBI23ZPH1333113,20,17,15,2,1
SBI10CVF9147837,71,18,11,7,1
SBI05LOG7516318,78,32,31,1,1
SBI39UZH2577100,80,32,31,1,1
SBI74IVD7648162,62,37,24,13,1
SBI67UDC9305137,22,26,15,11,1
SBI33QMN2383890,21,18,15,3,1
SBI87JLQ5156010,61,27,20,7,1
SBI88MCW3716861,94,27,19,8,1
SBI54SRU2891300,82,23,22,1,1
SBI48ZIF5446901,81,27,22,5,1
SBI02BZK7292770,18,22,13,9,1
SBI26VUD2372399,99,22,19,3,1
SBI49RQW3928050,96,30,19,11,1
SBI96MVT2671146,21,15,12,3,1
SBI16VJD4360456,92,34,31,3,1
SBI58PSR1932783,63,26,14,12,1
SBI01ING2667149,66,28,17,11,1
SBI67JAO6125327,81,31,25,6,1
SBI37EHG5385221,94,33,19,14,1
SBI66UVG3862742,84,29,27,2,1
SBI01WAR0103524,67,22,21,1,1
SBI27RPA3084409,76,26,24,2,1
SBI67DCA7821497,94,20,11,9,1
SBI12GKK7266766,79,27,16,11,1
SBI60NIE8359899,19,19,15,4,1
SBI70WRA0553386,24,25,19,6,1
SBI55APG5438552,94,23,17,6,1
SBI26XQH3686705,25,19,18,1,1
SBI56LQM9926358,89,30,18,12,1
SBI88NXW7850910,79,24,21,3,1
SBI01FTZ8108022,25,24,14,10,1
SBI00FWZ2101558,18,21,13,8,1
SBI70ZFB7577465,95,26,24,2,1
SBI52IUC7045000,89,24,18,6,1
SBI37YNC2711046,86,19,11,8,1
SBI93JFO4463543,95,22,12,10,1
SBI55CEM0579543,69,20,12,8,1
SBI90KET9827136,73,25,14,11,1
SBI30GNE4597834,87,18,16,2,1
SBI07IJG2345865,88,30,29,1,1
SBI58WIP6971573,79,30,24,6,1
SBI49GSD5936405,79,27,16,11,1
SBI56LZJ5918491,89,26,17,9,1
SBI27OHW6039247,22,21,16,5,1
SBI55DCH2039513,63,24,13,11,1
SBI65BAN3483831,69,21,13,8,1
SBI31ULJ7328341,85,18,11,7,1
SBI63VWK3548695,71,32,22,10,1
SBI19ZCA3135654,66,32,30,2,1
SBI13NSN7282315,94,26,23,3,1
SBI93RWU3403335,21,21,18,3,1
SBI19EJA1364972,25,25,17,8,1
SBI99LRW7757652,65,17,14,3,1
SBI96OAE8021513,65,18,15,3,1
SBI86BHC8553145,86,12,10,2,1
SBI72RKY8311901,66,19,14,5,1
SBI14YOI9884454,81,27,19,8,1
SBI82AXC8907454,82,21,16,5,1
SBI90UMP4304142,93,28,24,4,1
SBI23BZS7188723,95,21,20,1,1
SBI43JNT8715971,87,14,13,1,1
SBI89AWD6841162,68,23,20,3,1
SBI88RCE1435998,70,19,12,7,1
SBI44RUN4256370,77,17,10,7,1
SBI66MIO4311070,62,19,15,4,1
SBI67LPG2699944,24,29,17,12,1
SBI49CGR0210383,98,24,22,2,1
SBI04IOE0558178,66,27,18,9,1
SBI41KIO4670259,60,22,18,4,1
SBI18AGQ9029215,24,37,30,7,1
SBI67ZMX5687342,96,15,12,3,1
SBI50ATB7325597,24,35,32,3,1
SBI69OQI3170849,93,16,13,3,1
SBI40WIN0769693,73,17,15,2,1
SBI09WMS2300803,61,27,19,8,1
SBI03KEP8383194,97,26,20,6,1
SBI62FGN6896595,65,23,22,1,1
SBI44LUJ8132717,64,16,10,6,1
SBI57DBR7038175,86,28,17,11,1
SBI24GOP9583613,87,30,21,9,1
SBI00PIR9542683,62,29,21,8,1
SBI36KBR3590515,24,27,23,4,1
SBI98TBS5817727,64,24,16,8,1
SBI52NYH6177273,83,21,18,3,1
SBI24OSW6750533,19,35,29,6,1
SBI47LRZ6402766,81,20,19,1,1
SBI90WAL2297457,63,27,19,8,1
SBI75HZL8093915,85,25,13,12,1
SBI36BVV6979492,67,22,18,4,1
SBI06BGF1177064,78,13,12,1,1
SBI70NOP1271804,61,30,27,3,1
SBI88GYJ1211916,90,23,14,9,1
SBI93CQS2043528,85,21,20,1,1
SBI80VTA5021411,78,25,22,3,1
SBI97UBC7973360,94,29,19,10,1
SBI36NRL0560381,97,27,26,1,1
SBI12VCS5460128,84,27,17,10,1
SBI57YOF2428654,68,28,21,7,1
SBI99FGP0747418,62,27,17,10,1
SBI77IPJ6299994,77,30,19,11,1
SBI44XGD1648971,75,33,20,13,1
SBI47QTG7390511,93,21,20,1,1
SBI71ICF9136055,71,29,22,7,1
SBI93LLG1048227,66,24,18,6,1
SBI56WMT2332071,86,27,26,1,1
SBI14BRR5326628,98,28,21,7,1
SBI76ARX4660296,72,35,30,5,1
SBI16PBN7940434,89,25,14,11,1
SBI09OSF7886796,66,29,15,14,1
SBI14ULH1693266,88,30,19,11,1
SBI64PSC9938104,69,26,15,11,1
SBI09WEF0845087,60,21,18,3,1
SBI41BYI9880680,64,22,15,7,1
SBI06HFS3743591,22,32,27,5,1
SBI26JCS2978994,74,26,24,2,1
SBI66DST7016826,74,28,17,11,1
SBI20KNT5758806,65,17,15,2,1
SBI17XDT5550700,86,24,14,10,1
SBI91HDT7639517,93,21,11,10,1
SBI18FTG8558520,92,30,16,14,1
SBI36GVM0263247,63,26,14,12,1
SBI23NNL0367183,60,21,14,7,1
SBI98VXC2571376,25,28,25,3,1
SBI83JXL1838277,75,33,23,10,1
SBI67KMS8981865,64,16,14,2,1
SBI32EHZ0017096,85,25,20,5,1
SBI86CEI1588931,81,16,9,7,1
SBI62EEU8570018,75,20,13,7,1
SBI64ZRR2043525,68,29,18,11,1
SBI37FCI8678513,87,28,27,1,1
SBI10RIB0786693,18,26,21,5,1
SBI99ZFR2498925,18,25,17,8,1
SBI87PGO0178800,24,20,11,9,1
SBI41KUP0548194,21,26,24,2,1
SBI70PRJ2403898,20,23,21,2,1
SBI82GIG1045331,96,28,25,3,1
SBI91WUE1818681,79,21,18,3,1
SBI17QXG8792577,70,19,12,7,1
SBI85GYS3328906,82,28,26,2,1
SBI64EGU4449324,87,18,16,2,1
SBI48AUC2114880,23,17,16,1,1
SBI87EDY4113855,23,21,14,7,1
SBI30HBE7754591,19,23,14,9,1
SBI11FLB6929155,90,28,15,13,1
SBI94HDS5817028,75,35,19,16,1
SBI64QCA5037219,87,23,16,7,1
SBI40ZHC7289462,81,21,20,1,1
SBI48NAQ7857250,89,18,16,2,1
SBI68BYX2417253,94,28,24,4,1
SBI56DDS2595777,68,15,10,5,1
SBI63CAP9737646,89,30,17,13,1
SBI31OEY6104169,22,19,16,3,1
SBI10NDR0237020,77,24,17,7,1
SBI17NMI8865714,87,23,20,3,1
SBI76GJH7308775,65,34,22,12,1
SBI15DEV2837845,75,26,24,2,1
SBI62NFB6682345,84,22,16,6,1
SBI79CGQ7785986,24,27,17,10,1
SBI75OOE1368548,79,27,23,4,1
SBI18QPN8627271,18,29,18,11,1
SBI30GRY1206765,18,22,17,5,1
SBI18RFM5702878,67,18,13,5,1
SBI22DKS8463128,64,24,16,8,1
SBI81VAU8494503,91,23,17,6,1
SBI58ILA4756884,90,23,20,3,1
SBI62NMI5149900,79,24,21,3,1
SBI81CZL2722253,21,30,29,1,1
SBI15XBN6681130,74,20,13,7,1
SBI21VKK0805488,85,32,26,6,1
SBI17NJT5139351,83,22,21,1,1
SBI36FYY0046821,74,22,16,6,1
SBI37FVX3395969,60,22,20,2,1
SBI55CKW9777479,71,24,23,1,1
SBI53ATC0131226,96,31,22,9,1
SBI72DIY5730531,91,22,13,9,1
SBI81FUI9274069,60,15,12,3,1
SBI22YTE3426464,25,25,20,5,1
SBI07NAI3721641,62,25,24,1,1
SBI25XKZ3649670,83,21,16,5,1
SBI34EUM6186569,79,30,16,14,1
SBI61VQI5263651,72,29,20,9,1
SBI18MCZ5924870,83,15,8,7,1
SBI22BAT7823906,90,25,20,5,1
SBI14EZP0273609,85,34,18,16,1
SBI70OXR1225401,93,27,22,5,1
SBI84LQO6575357,86,24,21,3,1
SBI79HEY1416678,81,23,20,3,1
SBI46TZP3686836,72,28,24,4,1
SBI19YVX0031775,82,16,15,1,1
SBI21NKO5737077,68,31,23,8,1
SBI97LVT3749972,93,27,21,6,1
SBI55JXE5440251,98,19,18,1,1
SBI95DET0844227,20,29,19,10,1
SBI74OPF6581025,18,26,16,10,1
SBI76OKE2621927,20,18,17,1,1
SBI93LJR7048895,87,28,26,2,1
SBI01KLO8770726,97,27,26,1,1
SBI31BCM7174537,85,28,21,7,1
SBI55MKE2774454,79,26,16,10,1
SBI49CPT9357745,97,29,22,7,1
SBI26WFQ0526407,21,18,10,8,1
SBI78UJP7571718,95,30,22,8,1
SBI54GJE7351061,22,22,12,10,1
SBI40KFL5928418,70,23,19,4,1
SBI13JBX7474340,78,27,17,10,1
SBI32EQD8129250,68,20,12,8,1
SBI49LRR3198572,80,19,11,8,1
SBI67YUO7741152,85,25,20,5,1
SBI63GER1900983,86,31,18,13,1
SBI20WYC7230053,81,35,19,16,1
SBI82EJK3165833,79,20,11,9,1
SBI63EOH2434730,20,23,18,5,1
SBI27FNL9675996,25,18,14,4,1
SBI36WAP2865960,98,26,23,3,1
SBI60KOT2843210,70,21,20,1,1
SBI52UJK0402278,76,22,14,8,1
SBI91NON0037065,74,19,16,3,1
SBI41KSO4962577,60,21,17,4,1
SBI90SPV5240225,85,28,19,9,1
SBI77DPW6745345,86,28,26,2,1
SBI33MGP8171102,82,17,9,8,1
SBI64TBJ7318381,74,29,16,13,1
SBI99QKV2375450,79,28,22,6,1
SBI12VMC9574085,93,32,28,4,1
SBI89OIK1709167,66,30,24,6,1
SBI69YIZ9712881,97,23,15,8,1
SBI90APD7221688,61,22,14,8,1
SBI19GLU9603439,19,28,25,3,1
SBI77SCK8770051,21,28,27,1,1
SBI48IFP4049596,85,19,10,9,1
SBI17LPE5611642,62,23,16,7,1
SBI47QHB7807062,24,33,32,1,1
SBI98KFU3807479,84,32,18,14,1
SBI37HFD8505602,63,28,25,3,1
SBI45WHP6041007,60,31,28,3,1
SBI64MGW9716309,96,25,23,2,1
SBI24CCS6757888,19,16,12,4,1
SBI92AHF8906064,99,24,13,11,1
SBI47YTL1515065,73,29,21,8,1
SBI79ASS7141983,66,23,18,5,1
SBI58IOU7146603,83,25,13,12,1
SBI94IZE8226118,75,24,16,8,1
SBI56HQS3661108,88,31,24,7,1
SBI07JPS7110447,92,28,23,5,1
SBI14BZW6225579,95,22,12,10,1
SBI92WLF3605243,67,26,21,5,1
SBI52QDO5539014,82,22,21,1,1
SBI30RUN0433634,21,15,9,6,1
SBI88LXX0648938,95,25,15,10,1
SBI90ASN9702256,88,26,16,10,1
SBI15VTA8058618,90,23,16,7,1
SBI29GSU8441043,84,24,18,6,1
SBI62WNS7226066,70,20,13,7,1
SBI31RQN4064065,82,24,17,7,1
SBI75VWP8066137,89,22,19,3,1
SBI45URW9684471,90,34,28,6,1
SBI41PWO8476753,61,28,16,12,1
SBI18ZVI1961941,86,28,22,6,1
SBI57PHD8028117,98,24,16,8,1
SBI13XMQ5154334,94,20,19,1,1
SBI43DMH7791577,77,23,13,10,1
SBI64VOE3713917,75,18,11,7,1
SBI55DTG1185264,89,17,15,2,1
SBI82LRB8100125,20,26,19,7,1
SBI20EYV0478661,97,19,15,4,1
SBI20PHM9075156,75,19,18,1,1
SBI33DTR4026638,99,27,18,9,1
SBI02PEJ6740733,90,24,20,4,1
SBI29IOX5774864,62,31,19,12,1
SBI05RNJ8745657,19,26,17,9,1
SBI95CLS2660467,24,24,15,9,1
SBI13JJP8193909,92,26,24,2,1
SBI17ELO9751297,69,23,17,6,1
SBI28ZLN0951894,90,29,25,4,1
SBI22ATI0639276,85,17,9,8,1
SBI71KVN6732556,69,24,17,7,1
SBI09ZDP6373458,76,20,19,1,1
SBI79CSE5070267,21,15,9,6,1
SBI94BYB6230956,77,25,18,7,1
SBI13SNE6859783,71,29,24,5,1
SBI89DTH7133282,86,33,17,16,1
SBI89FYN2919094,61,23,17,6,1
SBI84DWQ7386189,20,22,15,7,1
SBI06SCK4470740,66,24,17,7,1
SBI43SKN7014370,66,25,17,8,1
SBI35ZOZ0466251,94,22,21,1,1
SBI75AZW7132155,86,12,11,1,1
SBI97XTW2071157,79,14,11,3,1
SBI81OYO2256328,68,27,24,3,1
SBI75PML8786906,89,22,14,8,1
SBI59OZD8433595,79,16,13,3,1
SBI15FVH6929988,62,32,22,10,1
SBI08LQL6037279,83,23,18,5,1
SBI63XED1314860,61,25,21,4,1
SBI69XSK2262171,80,28,18,10,1
SBI61OHY0348368,69,19,14,5,1
SBI79KQH1897540,89,28,25,3,1
SBI47IWM2341587,23,26,22,4,1
SBI20ZAF1294639,92,30,19,11,1
SBI29BYG6712725,60,22,13,9,1
SBI66GDZ0269536,72,22,17,5,1
SBI15MWC6932459,83,23,15,8,1
SBI46PNL2618889,82,25,18,7,1
SBI03NHT4746123,97,29,28,1,1
SBI06LLJ4241201,62,22,18,4,1
SBI26HDX7401466,70,20,14,6,1
SBI13XIO4056029,63,19,17,2,1
SBI08UFD1547581,96,28,26,2,1
SBI25NQM8386802,77,26,16,10,1
SBI75VYZ4352141,76,26,23,3,1
SBI48LPY0251070,74,32,25,7,1
SBI13YHQ5145661,69,24,14,10,1
SBI10VMD0713591,88,31,29,2,1
SBI42BBW2932231,83,25,24,1,1
SBI77XZG8404239,76,28,24,4,1
SBI16EIQ0241427,68,25,17,8,1
SBI25ZOW2460859,60,27,17,10,1
SBI47RQI6605325,85,21,16,5,1
SBI39GRM3950473,68,23,22,1,1
SBI45GQZ0904320,73,21,16,5,1
SBI76VJV8985833,80,22,13,9,1
SBI60XRA2273141,82,23,18,5,1
SBI78LWT8904928,25,22,12,10,1
SBI97VFW6629009,78,21,17,4,1
SBI48GHM5492569,62,23,14,9,1
SBI22ZST8188292,91,21,12,9,1
SBI83GSY0653548,96,26,23,3,1
SBI17DND9440638,69,30,20,10,1
SBI74NIU2981373,68,31,29,2,1
SBI10WBB7147107,85,20,16,4,1
SBI54DDX9627405,78,22,21,1,1
SBI78WSR5788258,82,20,16,4,1
SBI66ETS3075396,99,23,20,3,1
SBI10MZN4131911,99,26,23,3,1
SBI68ILN5979778,23,18,16,2,1
SBI43VQH3578594,91,26,19,7,1
SBI82UPO4215000,97,33,17,16,1
SBI23XFK1671570,82,31,21,10,1
SBI66CPW5618445,60,23,15,8,1
SBI46LON2903064,82,25,17,8,1
SBI62KJJ6348610,84,14,12,2,1
SBI25VOT8433848,94,21,17,4,1
SBI21PQP0389821,75,30,21,9,1
SBI51ERP6324924,67,26,14,12,1
SBI50JFE8149664,25,36,21,15,1
SBI33BXW5957920,86,21,11,10,1
SBI26JBB0204867,94,27,19,8,1
SBI65SIL6777745,79,29,15,14,1
SBI42EVG7915550,78,24,14,10,1
SBI03BIF2265605,95,29,18,11,1
SBI05SUK2277646,83,32,26,6,1
SBI64EGB3787534,84,17,12,5,1
SBI88DFU4240978,68,17,10,7,1
SBI43ASD1255049,63,29,21,8,1
SBI26DJY3380169,79,21,17,4,1
SBI77SIO6735345,79,20,16,4,1
SBI67JCT2382948,68,21,14,7,1
SBI78ZJT8033600,92,32,27,5,1
SBI17ETS3355258,24,30,24,6,1
SBI40IIV5176660,24,30,23,7,1
SBI17KTR8458817,62,26,25,1,1
SBI02AJX2279667,66,27,18,9,1
SBI60WGL7613121,92,19,16,3,1
SBI07KQO2120844,82,31,17,14,1
SBI56CPI0051996,61,26,24,2,1
SBI32HLY7046223,96,17,10,7,1
SBI23ZEX4962240,65,20,14,6,1
SBI49QYO9670878,89,27,26,1,1
SBI93TXJ5453758,74,18,17,1,1
SBI66TOR1076235,73,32,29,3,1
SBI05SIQ9127128,73,22,15,7,1
SBI58SJG0088064,61,28,23,5,1
SBI52PAP0019668,67,24,14,10,1
SBI64WVI5940773,82,14,12,2,1
SBI10CMK5708427,89,25,18,7,1
SBI37FRH3282349,74,24,18,6,1
SBI44QTB7866431,87,21,16,5,1
SBI19WME8374667,79,25,14,11,1
SBI54ZRB7414530,81,24,22,2,1
SBI33YAH1943319,67,27,22,5,1
SBI48ZME0482149,86,30,27,3,1
SBI26XGX1896990,22,14,8,6,1
SBI66WJF7306220,70,17,11,6,1
SBI03GPK2684114,18,23,16,7,1
SBI19OFF7321540,64,25,23,2,1
SBI69GQM0512914,22,29,18,11,1
SBI10RVL7342376,89,14,10,4,1
SBI98PZR0600614,68,26,21,5,1
SBI87BJN6459930,68,23,14,9,1
SBI49KWC5111284,64,24,14,10,1
SBI05KBK4924000,23,23,19,4,1
SBI51VDA6879395,92,27,26,1,1
SBI58SOO7620769,69,36,22,14,1
SBI00LVT6076324,73,17,16,1,1
SBI22UXH4545458,94,28,25,3,1
SBI16IHK7963454,63,25,18,7,1
SBI00MWU7242792,88,21,12,9,1
SBI65UWO0900116,19,25,19,6,1
SBI90RVI7063789,73,24,20,4,1
SBI94XOD4992124,22,25,17,8,1
SBI29YZK6412449,79,21,18,3,1
SBI11IWP7901755,79,16,10,6,1
SBI43YRM9444626,85,20,19,1,1
SBI24ZSC6603125,89,28,24,4,1
SBI67BEQ0017731,70,23,12,11,1
SBI46IXZ5594809,74,24,20,4,1
SBI04SVS0991777,72,29,16,13,1
SBI11KBA1882765,18,26,22,4,1
SBI29WCL9886901,60,28,17,11,1
SBI21XVF7596133,72,23,19,4,1
SBI77JUN7091699,86,23,20,3,1
SBI10SGG3955859,25,31,18,13,1
SBI85YZD3465880,22,22,16,6,1
SBI40OMZ4452891,22,23,16,7,1
SBI57GDJ4553729,81,23,20,3,1
SBI12ESP9430988,62,28,20,8,1
SBI71OSZ6357252,63,24,21,3,1
SBI55WAH5785893,86,27,18,9,1
SBI24JFI2827885,88,27,23,4,1
SBI33ZAO1284221,91,31,30,1,1
SBI04JQT3215655,69,20,18,2,1
SBI07ZYE2425701,18,21,11,10,1
SBI53KBQ8717879,97,21,20,1,1
SBI21ZTR8028980,72,18,17,1,1
SBI91BAI6367895,66,29,27,2,1
SBI60URF9814616,98,33,30,3,1
SBI23XSL4607782,84,25,23,2,1
SBI33BYJ1308165,83,23,12,11,1
SBI67CLR4302043,60,25,15,10,1
SBI46VIK6593553,81,22,20,2,1
SBI38IHI0432612,62,21,20,1,1
SBI68FMG7169238,77,18,13,5,1
SBI95RXV2197273,83,33,32,1,1
SBI54BDQ4965794,87,19,12,7,1
SBI91CDH1313470,71,30,23,7,1
SBI15RTE5679571,87,28,17,11,1
SBI99PTJ0460926,21,27,26,1,1
SBI21MVM4748128,68,21,12,9,1
SBI51WDF0592798,71,25,19,6,1
SBI18YNZ4287817,62,23,17,6,1
SBI73JIA0050232,86,28,17,11,1
SBI69APR0611436,63,17,12,5,1
SBI94ZGR2066368,95,21,20,1,1
SBI64MQC7849657,86,25,17,8,1
SBI84BJF2969728,74,28,20,8,1
SBI41INS0950475,71,29,21,8,1
SBI19UIR4001777,87,28,20,8,1
SBI65ZWS5715365,21,19,11,8,1
SBI05TIZ5872441,77,25,20,5,1
SBI15FIG1603102,68,30,23,7,1
SBI37YFJ5737585,90,28,23,5,1
SBI51VGM1249892,22,30,29,1,1
SBI74WRX3464077,95,17,12,5,1
SBI01QGK6022689,63,25,20,5,1
SBI50WZX7145585,66,26,23,3,1
SBI41NAQ3730600,22,26,14,12,1
SBI61AMN1047941,89,20,15,5,1
SBI54FQI0481786,72,25,14,11,1
SBI83BNS1325577,82,36,25,11,1
SBI91GHM6507493,24,31,22,9,1
SBI20AIC3943412,94,19,13,6,1
SBI77XVM3959731,61,28,24,4,1
SBI53CVT9148179,88,23,13,10,1
SBI76VQF4481950,87,20,17,3,1
SBI21BTD9290921,95,30,28,2,1
SBI10QMQ2754611,77,36,35,1,1
SBI18GZG6132821,92,24,23,1,1
SBI86RSN1322607,73,32,30,2,1
SBI13BBW3174736,63,26,17,9,1
SBI49ZQI0389564,90,18,14,4,1
SBI19YTR4352876,76,33,22,11,1
SBI36YZQ1655077,78,21,16,5,1
SBI59RRI8618889,80,31,30,1,1
SBI85BAE7522277,93,27,19,8,1
SBI18XTM7573363,79,22,17,5,1
SBI55POQ2538529,72,22,13,9,1
SBI46JPC4071250,81,26,18,8,1
SBI04OUP8692254,72,15,11,4,1
SBI08EAZ1510281,92,21,16,5,1
SBI53UWS2806311,93,19,12,7,1
SBI25RBY8526333,71,28,16,12,1
SBI62HHY0380850,93,21,14,7,1
SBI07DSW4398263,75,21,11,10,1
SBI54SSG7823103,94,23,12,11,1
SBI76TTQ9688181,81,21,20,1,1
SBI68LHG7325747,75,21,18,3,1
SBI90WXA0222164,22,25,17,8,1
SBI94FTY1272786,77,14,12,2,1
SBI81HYM2985090,67,27,14,13,1
SBI25YVE1221085,90,24,19,5,1
SBI28FRY6328935,76,28,27,1,1
SBI45TCI9500482,99,22,21,1,1
SBI07HUV6080874,82,19,10,9,1
SBI93WMK1929758,21,32,20,12,1
SBI56UVV8197743,21,25,18,7,1
SBI29TPP8440645,81,19,14,5,1
SBI88UJF4879070,83,22,20,2,1
SBI79RDG7040780,88,20,17,3,1
SBI48JYN1246945,85,19,14,5,1
SBI94PAI0711985,95,27,25,2,1
SBI37OPW9692691,71,26,15,11,1
SBI21ENM4147098,70,17,14,3,1
SBI17VQB9177167,82,35,25,10,1
SBI93WJD5869084,97,17,11,6,1
SBI57LUB7379003,82,16,13,3,1
SBI17EXK6375376,25,21,11,10,1
SBI63SOY5044933,83,26,22,4,1
SBI35PDY9641209,61,22,18,4,1
SBI90UCE8489588,81,21,17,4,1
SBI63VZS4999668,98,23,19,4,1
SBI01YPQ4504406,22,19,12,7,1
SBI32WAJ7860865,66,26,22,4,1
SBI95UEQ8751112,74,19,15,4,1
SBI57KDB7176869,84,25,15,10,1
SBI93IWZ6848184,89,26,15,11,1
SBI56QGI4735126,64,19,16,3,1
SBI53UVF1581371,99,23,19,4,1
SBI65JXX9810315,66,32,21,11,1
SBI69WXK4939484,91,28,22,6,1
SBI35RUB7360420,76,28,17,11,1
SBI53KKF2891609,88,22,18,4,1
SBI00ZPO5286440,24,11,7,4,1
SBI21KUN5671093,65,24,17,7,1
SBI65CFI5568637,87,30,23,7,1
SBI55XXQ9699937,92,19,18,1,1
SBI99BLR9712206,94,31,30,1,1
SBI16XYW7311572,66,31,27,4,1
SBI40XRK9107636,19,20,17,3,1
SBI23NQM5482286,92,24,14,10,1
SBI55SDS7097634,64,18,10,8,1
SBI76TQO0204670,79,31,18,13,1
SBI83CTA4316301,69,25,23,2,1
SBI00JAH0995625,90,20,14,6,1
SBI87FDX5247899,65,27,25,2,1
SBI95GHT5079533,98,22,19,3,1
SBI39ORV9673186,63,23,15,8,1
SBI52DPN0696070,84,26,20,6,1
SBI81AOZ2001016,84,26,20,6,1
SBI04UVT8491625,62,29,18,11,1
SBI75WJA9907751,88,23,22,1,1
SBI93WFD2382306,24,26,14,12,1
SBI19RMP9916296,24,30,22,8,1
SBI10EWI5306769,95,26,24,2,1
SBI27RAW7376952,84,29,25,4,1
SBI62LPD9524949,80,18,17,1,1
SBI61MYM0668426,83,18,13,5,1
SBI31NJL6378742,82,21,11,10,1
SBI06VDU1483121,83,26,21,5,1
SBI16HAO5035424,81,37,29,8,1
SBI16GNO4648308,95,22,13,9,1
SBI80MMI3498062,22,32,17,15,1
SBI55XBU2246080,89,26,20,6,1
SBI37FOY9979576,77,20,14,6,1
SBI44GYM5697855,60,23,12,11,1
SBI76BMV3551904,60,19,15,4,1
SBI29UUA3542417,71,34,23,11,1
SBI98DJN3617193,98,20,11,9,1
SBI32UWR9773643,92,26,23,3,1
SBI78LBQ5079140,87,29,26,3,1
SBI10GCB2737517,25,35,28,7,1
SBI05VNK8815689,82,31,19,12,1
SBI77BXH1926022,66,27,18,9,1
SBI53QAU9267569,62,29,25,4,1
SBI22PFC2832825,84,26,20,6,1
SBI98ARE8674490,89,27,24,3,1
SBI73FJX8092358,83,28,25,3,1
SBI90VVK0225505,21,17,16,1,1
SBI04AHB7551609,61,25,24,1,1
SBI60TWI3008260,98,27,17,10,1
SBI31SLG3057684,79,29,28,1,1
SBI69SLN5796520,90,35,19,16,1
SBI04ROG7825728,64,23,19,4,1
SBI31XOP3404426,83,25,19,6,1
SBI93FHU7684532,81,26,21,5,1
SBI79QKZ9407104,88,25,22,3,1
SBI41TCZ4354134,24,21,12,9,1
SBI66ZRA1708611,23,23,15,8,1
SBI79GGI7737087,72,25,14,11,1
SBI30JKR6123659,74,30,23,7,1
SBI45GBL5059211,75,23,13,10,1
SBI59KNT3218323,20,22,20,2,1
SBI07HBY4849468,67,31,17,14,1
SBI71RWA6797997,71,20,18,2,1
SBI46XJH2774763,75,27,26,1,1
SBI78POL5871051,24,15,9,6,1
SBI16ITO9331930,95,20,12,8,1
SBI06YKK5910159,69,24,13,11,1
SBI07PUX3938333,67,29,18,11,1
SBI69WPK3986855,77,18,12,6,1
SBI96IFE5307729,22,22,15,7,1
SBI66VAD1470944,21,25,23,2,1
SBI40MOA0518391,70,23,21,2,1
SBI50KBI4647250,89,25,15,10,1
SBI75IVO1498187,66,34,21,13,1
SBI42WWH9103172,22,24,15,9,1
SBI53PNH0043354,82,28,17,11,1
SBI72UUR1835023,87,28,18,10,1
SBI15OFU3706352,95,23,16,7,1
SBI13UQK3632835,90,24,23,1,1
SBI90MDP4604427,84,26,16,10,1
SBI86MVF7567037,83,26,16,10,1
SBI81AJJ9269820,89,30,22,8,1
SBI99SGA8295910,96,25,14,11,1
SBI82MAW0672541,94,19,14,5,1
SBI84SFP5915247,70,27,15,12,1
SBI51WVG1479441,84,29,19,10,1
SBI08IWQ9383400,22,29,19,10,1
SBI22QAE4554019,85,32,21,11,1
SBI09AAF5245910,79,26,22,4,1
SBI55NWU0788573,69,37,29,8,1
SBI26AVS6732519,18,31,25,6,1
SBI38PST9584835,63,18,16,2,1
SBI54NRD6514287,22,28,16,12,1
SBI35BHF9534575,79,32,22,10,1
SBI77SQF2987307,73,16,12,4,1
SBI61AFR2274547,63,31,18,13,1
SBI92BZM5029723,82,26,16,10,1
SBI81AKY1336253,23,24,19,5,1
SBI56CIG5247378,62,22,18,4,1
SBI40ZJF7693084,72,25,23,2,1
SBI76HQB2591690,77,20,12,8,1
SBI62KII2430922,78,33,27,6,1
SBI93OEP9912358,76,27,25,2,1
SBI36IVE5480422,20,19,12,7,1
SBI55JDR5876169,23,31,19,12,1
SBI70ONT4022159,61,22,14,8,1
SBI64SLY4591162,25,21,13,8,1
SBI01APZ3423590,82,32,27,5,1
SBI29LUG6263066,82,31,29,2,1
SBI93EMB5914601,90,24,21,3,1
SBI06KAJ2957311,18,18,15,3,1
SBI10HIB1288554,92,32,31,1,1
SBI82WXH4897140,93,22,16,6,1
SBI16EAD7694071,90,30,28,2,1
SBI34CVV7188027,88,20,13,7,1
SBI47UBZ7046758,63,25,13,12,1
SBI60FIH9781219,21,29,22,7,1
SBI33UXQ7969715,87,20,18,2,1
SBI96UAW3276413,75,32,24,8,1
SBI79THB2682222,91,24,20,4,1
SBI13UPP6914353,65,18,16,2,1
SBI13UGT1192402,68,18,14,4,1
SBI66IBX2869367,82,30,19,11,1
SBI52XDD5512425,79,32,28,4,1
SBI55RPF9720345,87,21,15,6,1
SBI58GLI3833459,69,21,16,5,1
SBI02XPF8694699,60,39,31,8,1
SBI45QUY2403678,72,31,27,4,1
SBI55GSB8129586,73,36,25,11,1
SBI53JTC9838700,63,29,28,1,1
SBI61HGA4266159,95,28,20,8,1
SBI84AMB6723792,77,30,28,2,1
SBI64HKG8048347,74,21,15,6,1
SBI50QRI7027968,80,20,15,5,1
SBI37ZLT2684822,94,21,15,6,1
SBI65SIZ9358191,68,25,16,9,1
SBI23OKW0087529,73,28,27,1,1
SBI68KQD7772909,83,22,21,1,1
SBI70KRC5310722,82,18,12,6,1
SBI74NOE7481723,76,32,20,12,1
SBI25LPM9539704,70,21,12,9,1
SBI01DOM9857510,21,22,20,2,1
SBI97ZEB2375223,71,28,23,5,1
SBI90TJX3308906,76,22,20,2,1
SBI94WBO0388708,20,33,31,2,1
SBI53TKT2307704,97,14,9,5,1
SBI66OYL4755894,20,24,16,8,1
SBI54OSJ4260108,83,18,12,6,1
SBI71RLH6003530,19,20,19,1,1
SBI96RCB8582789,83,14,13,1,1
SBI97VMR2489161,25,16,9,7,1
SBI55DFC7182729,95,27,16,11,1
SBI96HBF0125183,74,21,15,6,1
SBI01CET4150296,81,19,15,4,1
SBI98HQF4495428,85,27,17,10,1
SBI92BEP9178644,72,24,14,10,1
SBI71USP0004287,92,23,22,1,1
SBI49WDU6902610,83,25,21,4,1
SBI74ETN1750943,70,24,20,4,1
SBI36DZH3383878,97,28,25,3,1
SBI18AKU8417045,71,14,8,6,1
SBI84QUC5761123,96,32,23,9,1
SBI81XAG5285064,64,20,11,9,1
SBI58EGO5520848,99,14,13,1,1
SBI71ARP5853829,83,19,15,4,1
SBI56ZAZ9480466,72,29,17,12,1
SBI95ZKS2951874,61,27,15,12,1
SBI57MFQ7044781,67,15,8,7,1
SBI75ABL1471350,60,26,24,2,1
SBI30UXL2221696,19,28,16,12,1
SBI42SRM3399669,75,29,26,3,1
SBI23ZHH8485472,95,27,14,13,1
SBI06CBR9987660,25,29,28,1,1
SBI61EBQ0772683,21,26,24,2,1
SBI98OEN4073545,82,28,24,4,1
SBI90VQF2759417,23,24,15,9,1
SBI28NEL6674461,79,29,28,1,1
SBI50FQM8820402,79,28,19,9,1
SBI43GUI6603765,73,25,15,10,1
SBI42XDS9587652,79,29,21,8,1
SBI68DAO9585641,78,27,20,7,1
SBI69URO4222764,63,29,28,1,1
SBI13VDC2402068,92,22,14,8,1
SBI07NOI8628482,66,16,14,2,1
SBI90FXL4531767,69,18,17,1,1
SBI08DYX0448677,93,26,15,11,1
SBI11PNW2136576,23,24,13,11,1
SBI48PJC7333430,96,31,27,4,1
SBI04KLQ1822371,23,32,28,4,1
SBI24YZE8728764,77,26,21,5,1
SBI44LXP8243372,79,25,21,4,1
SBI84HYY6710968,75,24,21,3,1
SBI58RQX6345050,63,17,14,3,1
SBI53LQN2037350,61,27,18,9,1
SBI31RDO6618283,66,17,12,5,1
SBI97CXE4783101,97,30,29,1,1
SBI36AJV7055042,99,26,16,10,1
SBI95GPZ6488991,86,24,15,9,1
SBI44QEL1128198,99,24,13,11,1
SBI14YQW5354569,20,26,24,2,1
SBI09YZQ2283670,69,25,22,3,1
SBI68GIX5960502,66,31,22,9,1
SBI13XUG4547945,62,24,22,2,1
SBI34MUW2641919,81,19,13,6,1
SBI15RUD5768563,87,25,13,12,1
SBI73FNV2440686,20,21,11,10,1
SBI11ZRG2577190,24,18,12,6,1
SBI77YUP2517232,77,24,13,11,1
SBI53WDT7336097,73,17,16,1,1
SBI30QNL2361097,22,30,16,14,1
SBI94WPS3037748,80,32,22,10,1
SBI99EWS5933265,66,23,15,8,1
SBI63CNV0074462,25,16,15,1,1
SBI42WQU1647983,98,22,18,4,1
SBI49ELG5813320,81,29,15,14,1
SBI49WLH5217240,72,24,14,10,1
SBI13YHU2213558,90,19,11,8,1
SBI07VET2620170,78,26,15,11,1
SBI66UIC2686967,77,31,22,9,1
SBI31ALY7363370,18,27,23,4,1
SBI15OHI2970137,90,24,13,11,1
SBI84UJN7441283,67,22,16,6,1
SBI95MDY4728670,89,21,20,1,1
SBI30NLH8098859,93,28,17,11,1
SBI24NQS5648944,75,22,12,10,1
SBI48XZO8978837,71,29,28,1,1
SBI67APZ0786593,86,20,16,4,1
SBI67IMQ8895579,93,20,13,7,1
SBI62GPS4906659,92,25,13,12,1
SBI21ZRG6606297,63,21,17,4,1
SBI19TRL2128344,95,30,26,4,1
SBI89GFU8777535,84,24,22,2,1
SBI86WGA6077137,84,29,17,12,1
SBI96YGV9751505,20,30,24,6,1
SBI17OUN6688529,87,28,18,10,1
SBI80CPZ1451608,87,18,10,8,1
SBI21EFI5676071,84,21,13,8,1
SBI27QWG8475553,97,26,19,7,1
SBI78JFZ8541190,74,16,10,6,1
SBI28JQA0461429,80,29,19,10,1
SBI83MVJ6991548,79,27,21,6,1
SBI29BAC5763413,88,25,19,6,1
SBI38QEG5234969,82,26,14,12,1
SBI64YVC3184288,19,30,27,3,1
SBI83UDD5780589,85,29,22,7,1
SBI28XKH6658069,23,24,21,3,1
SBI88TOK7940924,20,33,31,2,1
SBI40KFI5153515,64,30,23,7,1
SBI49MEJ4196071,70,26,22,4,1
SBI78MEO5629795,90,24,13,11,1
SBI40RJU0487909,97,17,16,1,1
SBI85GXB1786448,67,27,21,6,1
SBI68VUC2146195,96,26,21,5,1
SBI79MCJ9833500,19,25,20,5,1
SBI03JFP0460906,68,21,12,9,1
SBI73HSW9950536,62,30,19,11,1
SBI18SGH7766731,85,23,18,5,1
SBI58QHU0186168,75,30,21,9,1
SBI77TWS9092301,91,21,12,9,1
SBI14VIR3484996,70,29,18,11,1
SBI28EEP5320362,63,18,14,4,1
SBI09RUG9796050,67,27,20,7,1
SBI24PFM3582235,76,27,22,5,1
SBI89ENY3834993,82,24,23,1,1
SBI95QMF1112493,24,31,21,10,1
SBI41YLF4763422,92,19,12,7,1
SBI13VJN1343098,87,29,15,14,1
SBI33UIS1082709,67,29,24,5,1
SBI25ZIJ5937300,78,27,26,1,1
SBI50MSQ4314622,83,22,14,8,1
SBI06TWV3671815,22,26,25,1,1
SBI81NBH5182593,74,26,18,8,1
SBI04DYD7588993,90,25,21,4,1
SBI55JST4854395,92,29,25,4,1
SBI56VVP5526312,64,28,27,1,1
SBI42FPJ4399317,78,22,20,2,1
SBI81DDB4839510,97,27,16,11,1
SBI49GOT6597438,82,21,13,8,1
SBI67ODJ7936892,92,21,14,7,1
SBI00PJG2604345,23,30,22,8,1
SBI13QED6109706,93,32,25,7,1
SBI83GRY9699880,82,30,27,3,1
SBI82NVI1733288,95,31,27,4,1
SBI61KTK9151425,21,20,12,8,1
SBI33INR0752126,72,31,21,10,1
SBI96ZES4184635,62,17,16,1,1
SBI12ECW3806497,18,19,14,5,1
SBI79NXW3438769,87,21,19,2,1
SBI48GIP7640157,60,27,21,6,1
SBI73ORP1062664,90,25,16,9,1
SBI22DWB3030059,65,25,13,12,1
SBI58USO9070428,82,29,18,11,1
SBI89TUA5997550,75,22,12,10,1
SBI06PMM1934168,19,27,17,10,1
SBI22ZMW5069551,99,24,15,9,1
SBI59XIP2833777,93,25,23,2,1
SBI25MPU1229741,60,27,25,2,1
SBI71FML3501976,77,25,16,9,1
SBI59RAW3435407,62,29,20,9,1
SBI04PMO0120154,61,21,13,8,1
SBI44ADW0419427,61,26,16,10,1
SBI72GDO5620454,22,32,31,1,1
SBI61YGY3735633,99,32,27,5,1
SBI22HRK8521981,76,32,25,7,1
SBI83PHR9718791,70,26,14,12,1
SBI86LIW0272443,21,26,20,6,1
SBI05HTZ5801306,18,32,31,1,1
SBI09KMP5224375,20,20,17,3,1
SBI57BOV4311299,99,22,21,1,1
SBI58OOI1363651,96,24,16,8,1
SBI74TTG8580468,80,23,17,6,1
SBI22WSM5708422,75,24,19,5,1
SBI24KMX1208826,91,20,13,7,1
SBI90QNV2553248,98,24,21,3,1
SBI16RRI7718896,78,25,19,6,1
SBI67MDR1628810,72,23,20,3,1
SBI15BWK1238073,94,27,26,1,1
SBI29PBT3927265,98,26,21,5,1
SBI38NCN6298638,20,17,9,8,1
SBI38BPZ4623706,95,33,21,12,1
SBI79PCE0005764,71,12,10,2,1
SBI61OLZ0335584,65,30,16,14,1
SBI95EPG1478132,18,31,25,6,1
SBI93PMS6376248,82,20,11,9,1
SBI47BCQ4118801,24,25,16,9,1
SBI11NBM5184857,63,26,17,9,1
SBI09VLV0764951,19,20,13,7,1
SBI51ZIA0421084,62,15,11,4,1
SBI32FSC2056125,23,25,16,9,1
SBI30DNU7394244,93,30,27,3,1
SBI57TJZ3892522,72,21,19,2,1
SBI35NGH7552661,74,23,17,6,1
SBI05ZZU8285265,84,23,12,11,1
SBI32JJI0692828,25,24,22,2,1
SBI50KLL4505853,86,26,21,5,1
SBI80KOC9092384,21,20,11,9,1
SBI16BAS3070845,79,28,24,4,1
SBI11EZG6554892,67,24,15,9,1
SBI92OEV3551717,69,20,16,4,1
SBI09NZJ7617142,89,18,15,3,1
SBI57VOJ8446537,88,18,14,4,1
SBI69IHE2829310,90,18,16,2,1
SBI32KJZ5938518,96,25,22,3,1
SBI39YZG6091679,19,21,17,4,1
SBI16ORD9149182,97,24,17,7,1
SBI14QON8897937,67,24,13,11,1
SBI44KLF0751876,89,23,16,7,1
SBI89ARB7925353,86,32,19,13,1
SBI68TXD8378091,89,22,13,9,1
SBI96XQU0113956,64,30,27,3,1
SBI39XAU5536001,18,30,19,11,1
SBI19WNG9763186,92,28,27,1,1
SBI58WKB6078931,23,30,29,1,1
SBI72MYM5526742,79,30,26,4,1
SBI99IJG1418399,99,20,17,3,1
SBI39MIO0476456,88,21,17,4,1
SBI14HUZ4609177,71,16,9,7,1
SBI48BTQ8210501,99,32,31,1,1
SBI81DNI2338496,85,25,19,6,1
SBI69GDN4264606,90,15,10,5,1
SBI94DGR4379521,93,28,23,5,1
SBI71XML5491144,82,27,17,10,1
SBI16OMG4225287,19,22,21,1,1
SBI00UWA4562988,74,24,18,6,1
SBI64CBG0672834,21,31,28,3,1
SBI51XAI1146383,25,17,14,3,1
SBI67MWA5688584,19,27,15,12,1
SBI52LBM6790658,82,15,13,2,1
SBI97ABP2470159,82,20,11,9,1
SBI11FND7359812,69,29,26,3,1
SBI36GIT1973940,94,21,13,8,1
SBI24TVR8568113,22,21,17,4,1
SBI30OPR7986890,79,28,15,13,1
SBI15JNB7508574,74,27,22,5,1
SBI00JZZ2453108,24,20,18,2,1
SBI65QAI3514526,99,16,15,1,1
SBI78ARW2280882,86,27,14,13,1
SBI64DPJ6183017,62,25,15,10,1
SBI14FGO8775307,18,34,22,12,1
SBI29IEY0364310,88,35,31,4,1
SBI70TRW4769983,96,32,20,12,1
SBI92OSZ7862135,69,15,11,4,1
SBI72UFA4717919,77,26,19,7,1
SBI85WIW5304777,63,28,25,3,1
SBI94PZO8049783,70,19,12,7,1
SBI90XND4605013,70,26,22,4,1
SBI30IBG9897180,82,21,17,4,1
SBI04CWO7270647,24,24,17,7,1
SBI95XJT1661188,73,23,18,5,1
SBI31XHW8244567,99,27,14,13,1
SBI40VXZ1288535,18,24,22,2,1
SBI65AWF3025182,84,26,18,8,1
SBI36HBD6082415,68,18,10,8,1
SBI25VKJ6838697,24,23,14,9,1
SBI44RSD6345578,75,26,25,1,1
SBI56ICN7772943,97,29,25,4,1
SBI77DQP1831750,73,19,15,4,1
SBI68BAT0776749,62,29,28,1,1
SBI53DYZ7635702,61,27,14,13,1
SBI99QDZ4117291,79,29,20,9,1
SBI54RGY3120230,81,27,22,5,1
SBI60BKE6408617,93,23,15,8,1
SBI92NFE1800355,67,28,15,13,1
SBI16PFW5240735,24,33,23,10,1
SBI94RCU9371392,71,29,27,2,1
SBI01WUA7050349,72,24,19,5,1
SBI64XPL8674374,62,24,22,2,1
SBI37KYT8518349,61,19,12,7,1
SBI30DXJ3384808,79,24,14,10,1
SBI05NHK1966966,66,17,15,2,1
SBI33IZW9525695,96,21,14,7,1
SBI92GRD1524963,63,28,26,2,1
SBI08ONT8550290,95,24,21,3,1
SBI71KDO7641877,68,24,22,2,1
SBI62NTN8604680,86,28,19,9,1
SBI32CDE2321967,86,29,18,11,1
SBI15RAA1390163,67,23,21,2,1
SBI07RJR9505384,73,26,19,7,1
SBI61DVG9127135,89,28,19,9,1
SBI62XPP2019143,60,32,18,14,1
SBI34UGA5397100,99,29,26,3,1
SBI61NWH6305779,74,19,13,6,1
SBI53WVX3701498,80,21,11,10,1
SBI12OHG8019195,63,21,18,3,1
SBI17EKD8946922,66,24,19,5,1
SBI57ICP7844834,63,29,18,11,1
SBI21BZH4015841,74,26,23,3,1
SBI89AEK7489882,89,25,13,12,1
SBI63EYK7150608,19,35,29,6,1
SBI73DZU3778946,23,28,24,4,1
SBI98YJH6618557,25,21,15,6,1
SBI60JJZ2874856,86,30,17,13,1
SBI52ZRK3316353,88,17,13,4,1
SBI07RLD3533682,90,29,23,6,1
SBI79AMX1092078,97,26,22,4,1
SBI37XAQ1765102,62,32,20,12,1
SBI00XUZ0592216,60,25,14,11,1
SBI76DJS0098691,94,32,18,14,1
SBI13KGL1481541,22,23,16,7,1
SBI82KGS7439222,76,36,24,12,1
SBI48UOL2521792,95,29,15,14,1
SBI08IOX2759832,68,25,15,10,1
SBI87HJN0889847,20,21,19,2,1
SBI04CMR9203261,96,25,14,11,1
SBI13DUR5126636,82,29,21,8,1
SBI81NMX8560637,64,33,23,10,1
SBI84JCS3103834,70,25,17,8,1
SBI23AXT9041032,91,28,18,10,1
SBI77KDR7806967,62,21,12,9,1
SBI05RMW1529608,93,25,19,6,1
SBI37SSU2381228,75,19,10,9,1
SBI03OOG8101382,21,28,23,5,1
SBI52KLC0394391,87,28,24,4,1
SBI47HQI6701408,25,27,22,5,1
SBI33NWL8250122,73,31,30,1,1
SBI88HIJ9915690,81,17,16,1,1
SBI98NQN1621594,68,23,16,7,1
SBI87YSI4063815,97,15,9,6,1
SBI03EMR6896414,91,20,16,4,1
SBI30EKG9705253,65,24,20,4,1
SBI27UNJ3237142,19,31,20,11,1
SBI79NDE3429507,70,15,13,2,1
SBI78JDV3111667,86,27,24,3,1
SBI11WJC5233976,64,20,16,4,1
SBI30AVC3252795,62,25,23,2,1
SBI81IUZ2497754,91,24,16,8,1
SBI08RUR4099008,77,23,15,8,1
SBI91NGM0941996,99,29,18,11,1
SBI22QHY4494627,83,28,23,5,1
SBI00LWH3175612,97,26,19,7,1
SBI21MTI9255999,88,25,13,12,1
SBI47ZQP3746012,97,18,12,6,1
SBI92WXA3783454,75,20,11,9,1
SBI91KAA6983816,78,20,13,7,1
SBI28EIT3242168,23,30,24,6,1
SBI32UYL2073092,86,25,20,5,1
SBI55YJC6383369,85,27,20,7,1
SBI69BEC3437169,60,23,18,5,1
SBI18LFD6457160,85,33,23,10,1
SBI76UAR1068441,86,21,14,7,1
SBI49OEI3291775,78,27,22,5,1
SBI05HEU4096686,69,21,17,4,1
SBI39GXS1364122,22,24,19,5,1
SBI74NTL9653937,97,30,28,2,1
SBI98QCA9972403,80,30,29,1,1
SBI66QKP0071758,23,32,18,14,1
SBI15CBN8327156,20,31,26,5,1
SBI61OKQ2704358,81,28,25,3,1
SBI84ILM7314756,24,20,18,2,1
SBI63BPA3953931,21,26,18,8,1
SBI21XTC3377249,61,29,23,6,1
SBI73CJF8218730,75,23,20,3,1
SBI26WAE9255550,66,22,16,6,1
SBI76CAN8842118,24,19,18,1,1
SBI77KXA2813780,76,32,19,13,1
SBI21SSQ6851331,67,34,30,4,1
SBI44BYF0396756,61,30,24,6,1
SBI34DDT0225314,62,18,10,8,1
SBI31RJP2801898,72,24,20,4,1
SBI34RGY6259627,86,22,15,7,1
SBI95FQS1228160,64,24,22,2,1
SBI77QFB7857854,24,24,18,6,1
SBI33WBN4367955,94,21,15,6,1
SBI47CPB0009130,92,18,17,1,1
SBI82MWC2998500,92,20,15,5,1
SBI94RPS9478848,22,16,15,1,1
SBI26JBW2332683,68,28,26,2,1
SBI16XFL0813403,64,25,16,9,1
SBI45BQO6427759,24,19,16,3,1
SBI28XWK4108223,82,22,19,3,1
SBI34DQI3696824,84,23,18,5,1
SBI46GNS6006422,96,30,29,1,1
SBI58QRC0557639,71,29,16,13,1
SBI28MJF6592834,19,28,23,5,1
SBI00ONV3292080,79,21,12,9,1
SBI05BYP8137531,92,31,27,4,1
SBI33CJN2592055,60,29,17,12,1
SBI69RZN2760451,86,29,16,13,1
SBI79GNN9943471,66,17,10,7,1
SBI51AQJ8881793,21,20,13,7,1
SBI88PST0004007,93,21,15,6,1
SBI85ZXF8083467,60,25,14,11,1
SBI91PKF8001597,81,16,14,2,1
SBI54JII3649670,96,20,19,1,1
SBI57RSY1137465,97,25,21,4,1
SBI79NCB7511838,91,28,25,3,1
SBI85EZR3229570,25,28,27,1,1
SBI63XFS0483340,98,25,19,6,1
SBI54RMR9023187,93,22,12,10,1
SBI10XOJ9093192,93,29,21,8,1
SBI89WXP7677614,64,35,25,10,1
SBI43SNI4151374,66,29,28,1,1
SBI74DEA3659463,97,21,11,10,1
SBI49IWD7838353,93,19,12,7,1
SBI99MTQ2394239,64,20,16,4,1
SBI63LNX8737485,64,24,21,3,1
SBI56JOY9020674,65,31,23,8,1
SBI86EHH0358344,19,33,32,1,1
SBI91JNE5014574,22,22,13,9,1
SBI89STD3490089,96,34,23,11,1
SBI63RQY8347218,91,15,11,4,1
SBI38ELP5638642,85,21,18,3,1
SBI07QUW5912186,84,16,14,2,1
SBI24CNC5541616,67,27,23,4,1
SBI02EUY4368077,60,19,10,9,1
SBI49SKS3416813,90,32,19,13,1
SBI16QZX0208142,95,22,21,1,1
SBI11FZC2600832,98,21,15,6,1
SBI12BYG2507326,60,16,11,5,1
SBI92BCR6599377,21,26,25,1,1
SBI44GMJ2347006,60,31,28,3,1
SBI75NSO6566984,83,21,14,7,1
SBI74ZPF0942734,61,31,16,15,1
SBI45LON1512583,61,36,28,8,1
SBI43GUC4379641,24,21,13,8,1
SBI64AEL1331199,67,31,28,3,1
SBI82DBJ1541313,83,27,15,12,1
SBI98IYL5133245,72,26,24,2,1
SBI96VNQ4304274,71,20,15,5,1
SBI71IDY2643735,69,22,19,3,1
SBI92ZOS8204766,65,31,25,6,1
SBI15VZP5252236,24,25,21,4,1
SBI40LDI0818467,62,21,18,3,1
SBI76ZVQ4053350,89,18,15,3,1
SBI21JFF6345540,91,27,15,12,1
SBI74GFV5368137,96,23,15,8,1
SBI17AUM0936172,66,28,20,8,1
SBI02ZMC1322896,81,24,23,1,1
SBI35UPS7900020,62,27,17,10,1
SBI83UVO3773754,19,30,17,13,1
SBI11MLK6439830,70,21,14,7,1
SBI25FIT8793925,23,19,16,3,1
SBI95DAV3350197,78,20,18,2,1
SBI67SSC1819349,76,23,20,3,1
SBI82XEM1601946,21,16,10,6,1
SBI93WFX2675134,73,27,21,6,1
SBI66BRS0745154,20,30,17,13,1
SBI63JME8661807,78,23,22,1,1
SBI62ROC4048930,25,28,18,10,1
SBI65IKX6956238,92,26,21,5,1
SBI13FNA1355921,98,31,17,14,1
SBI02LNO9546797,95,17,14,3,1
SBI93WWC9706725,93,26,21,5,1
SBI64ENE4957587,73,35,33,2,1
SBI19XQE9877158,93,32,19,13,1
SBI26FFZ4273526,68,29,25,4,1
SBI31FGI9353661,62,23,21,2,1
SBI55DSS8250752,65,24,21,3,1
SBI85JZV8053107,96,22,20,2,1
SBI20HBT8505222,86,26,19,7,1
SBI20SDP2826419,81,29,24,5,1
SBI05LEQ2326905,67,27,18,9,1
SBI18MWE2901994,73,24,13,11,1
SBI33HRV1022153,74,27,20,7,1
SBI27WOY3630098,99,20,15,5,1
SBI72FWX0691012,98,27,25,2,1
SBI50VPF7722598,83,29,19,10,1
SBI58GAB1260375,98,22,19,3,1
SBI65ZMS6572882,94,22,17,5,1
SBI80WMI4936846,24,28,16,12,1
SBI42POF3484385,96,24,18,6,1
SBI59WID9111931,79,24,14,10,1
SBI98WYG8953355,90,26,21,5,1
SBI99TQS0855634,77,24,17,7,1
SBI18ZIO4586906,89,24,15,9,1
SBI26LPP6304536,82,25,22,3,1
SBI86XTE2238835,24,26,16,10,1
SBI31RRK0379419,97,20,15,5,1
SBI53RER1575356,82,33,22,11,1
SBI56DAU6208167,93,25,23,2,1
SBI75AYC7321087,91,23,15,8,1
SBI12GQG3278439,98,26,20,6,1
SBI24HOJ9800221,19,14,9,5,1
SBI81RMJ1807554,22,17,16,1,1
SBI59QXZ0059447,89,24,15,9,1
SBI42MVC2949144,77,23,19,4,1
SBI71GUP4492071,21,26,16,10,1
SBI12VBW2733513,61,26,21,5,1
SBI64ICP4288828,23,32,29,3,1
SBI81MPU6008453,20,22,18,4,1
SBI55NQA3334894,75,28,18,10,1
SBI29VKC7626053,18,22,16,6,1
SBI78ECW2190972,86,26,21,5,1
SBI15HRD4688342,61,25,16,9,1
SBI70YAC4561497,89,26,14,12,1
SBI18PXR4111793,76,21,19,2,1
SBI97QSY0680823,82,23,17,6,1
SBI73SXR2880740,91,21,17,4,1
SBI67FHE1771118,83,20,17,3,1
SBI17RCD5424805,20,23,22,1,1
SBI19WPL5840129,61,19,14,5,1
SBI81NBP6694736,79,28,16,12,1
SBI09MIO1563380,67,21,18,3,1
SBI73LSO2221931,60,25,18,7,1
SBI27ROK8773671,22,19,12,7,1
SBI35XBM2478499,72,20,11,9,1
SBI54BWM5042808,21,29,16,13,1
SBI96JQG6530175,61,20,15,5,1
SBI00LWM2722160,78,26,19,7,1
SBI49PCK4398011,63,19,10,9,1
SBI75ANZ2738104,83,24,21,3,1
SBI19JFK9167332,70,29,24,5,1
SBI35KFN8436798,91,28,24,4,1
SBI81XWO3316162,18,22,21,1,1
SBI60MXB3352702,82,21,19,2,1
SBI77IGU6926666,65,19,14,5,1
SBI66WIT6089841,19,26,14,12,1
SBI50LCS7193478,83,25,14,11,1
SBI31AAW7930127,61,18,14,4,1
SBI47DEJ0497425,62,20,16,4,1
SBI04JYM8643999,79,19,11,8,1
SBI83BDB6406627,92,24,18,6,1
SBI04VDU8576022,23,27,16,11,1
SBI59HCA1206456,94,22,20,2,1
SBI24UPQ3039495,24,28,22,6,1
SBI90YFB3869702,21,23,18,5,1
SBI17YYT9364303,98,26,19,7,1
SBI75EMJ0934054,63,21,16,5,1
SBI76DDU9745323,63,21,18,3,1
SBI62WBO2893032,91,20,14,6,1
SBI69KWG8047626,63,26,23,3,1
SBI45SHT8930175,62,23,12,11,1
SBI75ZTS5269105,66,37,24,13,1
SBI76JMC5397120,64,26,14,12,1
SBI21XQB4639248,79,24,19,5,1
SBI40BPY2381858,88,19,12,7,1
SBI16HXS0722253,63,24,16,8,1
SBI28OKV3031762,18,23,14,9,1
SBI20URZ9591549,23,27,25,2,1
SBI96IJL5614682,98,22,13,9,1
SBI58CQN9134263,98,25,19,6,1
SBI73YLV0896208,75,34,29,5,1
SBI66JUA0283581,66,22,16,6,1
SBI14AWI3963430,98,19,18,1,1
SBI73EWX0506468,66,30,28,2,1
SBI31HCZ4410663,88,26,14,12,1
SBI27YTH0661121,70,25,15,10,1
SBI70BGD5739618,21,33,26,7,1
SBI45NSZ4463587,75,19,18,1,1
SBI38BEJ5148383,88,21,15,6,1
SBI70KKZ7957207,97,17,14,3,1
SBI56GQL0412815,99,29,22,7,1
SBI20KUV9279630,75,35,21,14,1
SBI14PCB7866120,97,27,24,3,1
SBI43YIR8227309,88,26,19,7,1
SBI97ZVI3113272,91,29,15,14,1
SBI85NYH5434069,89,22,21,1,1
SBI95DDL8783882,65,22,12,10,1
SBI40VPL2184324,80,26,18,8,1
SBI67QZN3727476,60,26,22,4,1
SBI92SOD6155682,87,21,11,10,1
SBI47YYA8283719,74,28,26,2,1
SBI18EHZ5548881,89,20,11,9,1
SBI28UGP0184141,92,19,17,2,1
SBI10RCN0075770,64,30,17,13,1
SBI95GKO7707417,98,17,14,3,1
SBI96QMI9165075,68,29,15,14,1
SBI87HIK1707203,64,24,22,2,1
SBI67CWR0128808,94,19,13,6,1
SBI23KVI0712886,62,32,18,14,1
SBI97AWM2362615,83,25,21,4,1
SBI15BFB2601282,75,32,27,5,1
SBI59MCG4171094,87,30,16,14,1
SBI02ROY2532077,73,29,24,5,1
SBI51SQV2240462,85,35,19,16,1
SBI68JNV6624984,25,30,29,1,1
SBI38UKF1379075,71,24,15,9,1
SBI19CSC2144221,88,23,22,1,1
SBI20RZR3401631,22,28,25,3,1
SBI64RFB1960029,71,23,13,10,1
SBI47XFU5538541,90,27,18,9,1
SBI52QFQ1453687,94,28,17,11,1
SBI54KWS4027965,67,26,17,9,1
SBI87ZUN1501259,97,25,14,11,1
SBI80HHH5461613,82,23,20,3,1
SBI22KOL8094164,75,15,13,2,1
SBI76EQE4867781,93,21,17,4,1
SBI43QLD2537923,74,27,25,2,1
SBI74FIA7526965,93,27,15,12,1
SBI00ADS3056312,96,25,17,8,1
SBI30BGV3148115,70,24,18,6,1
SBI50PLT6565911,65,10,9,1,1
SBI06WIC8435488,18,23,12,11,1
SBI99DVB3585276,99,29,19,10,1
SBI73OWH4347370,21,24,13,11,1
SBI81ITQ1252145,85,23,22,1,1
SBI11UPN2846035,69,24,19,5,1
SBI41VSU8198116,84,29,15,14,1
SBI49LZV1690330,92,19,17,2,1
SBI30ERJ3277345,20,26,21,5,1
SBI61UXM2969894,18,23,18,5,1
SBI18MIP4736339,67,32,24,8,1
SBI97GMI2689305,68,19,18,1,1
SBI38RBK0753810,65,28,26,2,1
SBI99MAE5681277,84,26,25,1,1
SBI49PQS8392052,93,24,18,6,1
SBI61BXN3928874,83,22,13,9,1
SBI22RVH5726977,96,18,16,2,1
SBI30GQI7285263,83,32,28,4,1
SBI15XVF9492540,88,29,21,8,1
SBI80SVS0496757,62,30,25,5,1
SBI11JOS5133328,25,27,25,2,1
SBI23IXZ3800706,75,27,24,3,1
SBI89ALW6137635,93,21,11,10,1
SBI55VHL6043121,71,22,16,6,1
SBI23BKE3685369,86,25,16,9,1
SBI59XGO5819772,72,24,23,1,1
SBI63VWR4945522,62,18,16,2,1
SBI92QSU6343566,75,28,24,4,1
SBI23AYA8899388,89,16,14,2,1
SBI06FKI2002967,98,22,13,9,1
SBI25RUU0149131,66,35,26,9,1
SBI23JVF6777644,68,33,25,8,1
SBI89HVX3409027,68,19,17,2,1
SBI30ZVM5454125,83,15,12,3,1
SBI57HKM2231673,89,16,11,5,1
SBI50KKT8479823,77,21,14,7,1
SBI81PRX8330200,73,33,26,7,1
SBI71SSW6717604,94,29,20,9,1
SBI87CZD3092157,92,18,15,3,1
SBI83WMT0004247,60,28,26,2,1
SBI91GOG1919610,84,27,26,1,1
SBI07SLL3171558,84,23,21,2,1
SBI85EEI3368549,62,21,16,5,1
SBI24GCL0695603,91,25,13,12,1
SBI09GIO5492953,80,26,19,7,1
SBI30NKN2181170,70,27,21,6,1
SBI76OBP8482956,82,27,24,3,1
SBI09YGO5763313,82,24,23,1,1
SBI62ARZ4438554,91,33,27,6,1
SBI28UPJ8847167,61,25,21,4,1
SBI71QBC5391227,65,25,18,7,1
SBI37MPJ9113969,76,33,24,9,1
SBI90WFK1186437,91,31,30,1,1
SBI82FWU1202821,22,29,27,2,1
SBI38LGV1836235,61,27,20,7,1
SBI93VOD2684888,96,21,17,4,1
SBI15IDH9353956,74,23,13,10,1
SBI32KTO0951904,87,28,23,5,1
SBI90YTY8372387,97,32,21,11,1
SBI20LYF9431090,24,19,12,7,1
SBI18UKB1021226,74,16,13,3,1
SBI70VVG4369218,74,23,17,6,1
SBI64AOK5522073,85,29,19,10,1
SBI49TWT9947217,65,24,14,10,1
SBI54FYK3348211,81,29,26,3,1
SBI35FAR9549176,89,30,20,10,1
SBI31JIA1650308,72,22,21,1,1
SBI68JJG9217443,93,21,19,2,1
SBI25XSA3993707,75,22,12,10,1
SBI50TZH4413243,91,27,14,13,1
SBI70UFQ6152606,24,17,16,1,1
SBI80LSF7453792,80,28,21,7,1
SBI76KKR0968231,60,27,20,7,1
SBI83UCZ7910654,93,22,19,3,1
SBI07MJG3224079,18,28,27,1,1
SBI68DBG1730365,97,17,9,8,1
SBI25AZL7263847,24,31,22,9,1
SBI61FEO6932132,73,36,27,9,1
SBI61YHQ1467147,67,18,11,7,1
SBI61OQP7253030,75,24,19,5,1
SBI89ADU8847542,84,20,12,8,1
SBI87XAJ1834528,23,32,23,9,1
SBI28TDD2876656,73,19,10,9,1
SBI17QFL3561024,63,22,18,4,1
SBI68JRM8788253,85,25,21,4,1
SBI99VSD7933909,24,26,16,10,1
SBI25NXS8547706,99,19,12,7,1
SBI53MNU4632979,60,28,19,9,1
SBI40XQZ9948342,99,24,17,7,1
SBI94GOT7710940,93,27,15,12,1
SBI26UHK5676204,76,27,20,7,1
SBI68AZQ4533538,89,31,28,3,1
SBI05ANB3659699,96,29,17,12,1
SBI56WXL2507041,22,20,12,8,1
SBI80UEG3453327,21,28,19,9,1
SBI39UMN9084097,84,24,17,7,1
SBI94CFG4944115,86,29,26,3,1
SBI55KON2562795,68,25,15,10,1
SBI29ZCP0418561,21,17,15,2,1
SBI32ZJX4309625,22,19,12,7,1
SBI34YEM6880768,20,21,16,5,1
SBI85BSE6489571,75,24,21,3,1
SBI20DEI9161898,89,21,13,8,1
SBI16YJI6446666,75,30,17,13,1
SBI81OFY3793273,85,23,21,2,1
SBI06SOP5031570,62,31,19,12,1
SBI21NYC0370084,91,26,22,4,1
SBI69HIA3137784,23,17,10,7,1
SBI31TLB4460653,63,33,25,8,1
SBI46XVF0558262,20,23,22,1,1
SBI92SKH8121309,20,25,24,1,1
SBI71QYP6697753,63,33,25,8,1
SBI20YWZ0250709,23,30,28,2,1
SBI83HFR7112684,78,14,12,2,1
SBI45EDL2865227,81,23,18,5,1
SBI89JCJ0056370,81,32,22,10,1
SBI41DIY1671592,18,16,12,4,1
SBI72HRN3650301,68,22,13,9,1
SBI25OMR8440652,71,28,24,4,1
SBI19WXB6208210,73,24,23,1,1
SBI92QTR3720294,86,26,24,2,1
SBI90GYF3669148,76,27,22,5,1
SBI27MFZ7968001,94,27,18,9,1
SBI67HIX4099144,83,26,18,8,1
SBI35JFZ0476832,79,25,17,8,1
SBI08QPP2131918,92,26,20,6,1
SBI21MLI8256481,98,26,19,7,1
SBI31RYE8783140,65,28,23,5,1
SBI36SRL5202018,68,29,17,12,1
SBI61YIJ0724358,70,32,18,14,1
SBI74JQG8387168,66,32,29,3,1
SBI15RWF8509230,76,28,20,8,1
SBI54MBW9695220,90,20,17,3,1
SBI40LJV6518190,74,23,13,10,1
SBI17EZM4774862,94,17,12,5,1
SBI43LMB8008036,64,21,18,3,1
SBI34EAJ7824870,24,33,26,7,1
SBI53MEV1469373,89,25,16,9,1
SBI85JCK5956123,70,20,17,3,1
SBI67ZAH5344541,77,27,22,5,1
SBI48QQS2588563,19,22,20,2,1
SBI97IKK6832823,75,24,16,8,1
SBI37VUF3056336,78,21,19,2,1
SBI10OMW1847032,84,21,16,5,1
SBI41UXE9700335,69,31,25,6,1
SBI65RGG1497318,67,28,25,3,1
SBI34CBU4441005,99,37,23,14,1
SBI74FTX8433106,19,21,18,3,1
SBI61ULS8236301,96,22,20,2,1
SBI45YMH7088826,84,30,19,11,1
SBI34OUZ8541068,80,30,29,1,1
SBI93QCK2429855,20,25,15,10,1
SBI86ZKY7997220,72,22,14,8,1
SBI25WAL8737852,64,23,19,4,1
SBI40UUI8965859,77,16,12,4,1
SBI37CYE1358795,76,24,19,5,1
SBI24ZUL1148389,24,23,22,1,1
SBI36UMR5104638,85,36,31,5,1
SBI69IXN2311793,84,21,17,4,1
SBI37HJU1772222,63,20,13,7,1
SBI94EMH8783986,86,30,21,9,1
SBI81OFY3593423,22,28,19,9,1
SBI56MQZ6856672,81,26,15,11,1
SBI36HOY9052851,62,30,28,2,1
SBI50DKZ0862466,90,23,17,6,1
SBI59DSW6476020,79,28,16,12,1
SBI85RWT2751960,63,32,30,2,1
SBI36GNT0012190,99,31,17,14,1
SBI16OYR5453130,18,26,23,3,1
SBI25ENS2941463,61,24,15,9,1
SBI48BVM3897453,89,28,21,7,1
SBI20VPS8620941,91,23,12,11,1
SBI03CZE2207073,71,23,17,6,1
SBI35IXG4771798,63,26,14,12,1
SBI66PSV1686332,66,21,18,3,1
SBI49VZP4039599,88,18,11,7,1
SBI52YFF3799783,75,24,15,9,1
SBI45PTT4804766,92,22,14,8,1
SBI55ATT5295772,79,24,21,3,1
SBI03GFO0180570,24,20,14,6,1
SBI01JOY7780533,80,26,17,9,1
SBI36OYJ3799579,78,23,15,8,1
SBI95VXX5729831,65,31,16,15,1
SBI65VFP1166648,98,25,17,8,1
SBI58QUB9826211,23,16,10,6,1
SBI28ROG6990033,20,26,20,6,1
SBI87JCI2840048,66,22,13,9,1
SBI75FOX0671218,23,23,19,4,1
SBI21JIX5259375,88,32,18,14,1
SBI82RIX3349344,98,29,24,5,1
SBI61GGT3938441,90,23,14,9,1
SBI04WGR9416511,72,21,12,9,1
SBI54NPQ5910885,68,19,16,3,1
SBI93JAD5856356,96,19,18,1,1
SBI41YTN6305030,72,34,27,7,1
SBI63VSX1795896,80,25,21,4,1
SBI42FZD6180727,20,16,9,7,1
SBI93FHQ2151554,20,24,15,9,1
SBI38XUR6684544,68,19,12,7,1
SBI99QVF0537954,74,25,16,9,1
SBI03ADA6374144,25,27,17,10,1
SBI22EBT3650500,61,20,15,5,1
SBI78YYK8084154,91,33,24,9,1
SBI16TBE7068466,24,22,21,1,1
SBI40KZR0728669,88,31,29,2,1
SBI40NAG0427550,81,22,15,7,1
SBI41JTN5980342,73,33,26,7,1
SBI15XCS9444706,88,28,17,11,1
SBI16VIN9433280,85,23,21,2,1
SBI99XAW5382760,76,22,16,6,1
SBI66SIB3492181,64,28,15,13,1
SBI89ICI6622591,92,27,18,9,1
SBI81KCO8601325,80,26,17,9,1
SBI41ZKU6841925,78,26,23,3,1
SBI19LKT7568497,77,29,25,4,1
SBI65VEC6394237,98,33,24,9,1
SBI00KUI1785523,68,27,14,13,1
SBI10WDP6914640,23,22,17,5,1
SBI04XDZ9882938,67,19,11,8,1
SBI14ZCV5038961,70,18,13,5,1
SBI83ZLJ0758047,19,18,16,2,1
SBI68JNW3066520,93,35,31,4,1
SBI27XYS9851985,69,36,21,15,1
SBI49XJO1039161,71,26,25,1,1
SBI93RZV5248273,69,20,11,9,1
SBI31WTZ4398967,90,24,13,11,1
SBI87YML3411111,87,32,30,2,1
SBI45FHL9814003,76,29,24,5,1
SBI46RGZ9735558,67,11,10,1,1
SBI57OPJ7521444,24,31,19,12,1
SBI19BVT6054645,95,21,17,4,1
SBI68XES8642049,89,22,17,5,1
SBI93HHZ6936256,19,19,17,2,1
SBI26PGZ5010084,61,15,11,4,1
SBI36PGM9609847,91,26,24,2,1
SBI55BEF3591510,69,30,29,1,1
SBI06EYI5219836,92,19,16,3,1
SBI42WNT4545176,76,26,18,8,1
SBI57RTS0274117,70,13,11,2,1
SBI68GJR4236405,83,29,23,6,1
SBI79IAD9955869,62,19,15,4,1
SBI92ISX6729569,85,23,15,8,1
SBI00XZG6456449,65,13,12,1,1
SBI60FLH1426713,88,31,24,7,1
SBI70KIE5059562,19,21,17,4,1
SBI31WEC5942188,80,26,24,2,1
SBI59NAU4744874,89,33,26,7,1
SBI13RBS4900454,86,28,23,5,1
SBI31RQI3444877,79,25,19,6,1
SBI05NYT6966396,92,32,30,2,1
SBI52ZNX5575783,87,17,13,4,1
SBI43EQC9517842,79,30,26,4,1
SBI35XKF8246943,78,26,17,9,1
SBI34QVL7380645,93,20,12,8,1
SBI26CSF3307455,82,21,14,7,1
SBI35HZX1106014,23,25,13,12,1
SBI16AQI3856049,64,26,23,3,1
SBI69IZT9721183,67,27,22,5,1
SBI40AZS7363319,70,36,22,14,1
SBI66IOT1317545,25,30,23,7,1
SBI34HYK7205893,61,24,15,9,1
SBI76NKR7979172,85,20,19,1,1
SBI59MZK8891373,20,18,15,3,1
SBI65RHK1086270,61,24,23,1,1
SBI49EDU1543923,67,29,24,5,1
SBI95WBQ3188344,65,25,17,8,1
SBI65IED2490155,95,25,15,10,1
SBI30KQW1454984,81,31,21,10,1
SBI99UAZ5816813,98,26,22,4,1
SBI67UAG6627451,83,24,17,7,1
SBI92JCB4797553,81,38,21,17,1
SBI71UDM1336881,77,25,21,4,1
SBI63IBK9448493,79,25,18,7,1
SBI43HOM8213484,86,32,22,10,1
SBI54OLG8136269,84,22,14,8,1
SBI15HTV5260891,22,31,22,9,1
SBI46YQU1939444,69,21,14,7,1
SBI54EXT6139685,23,28,19,9,1
SBI12LRM0081327,73,24,23,1,1
SBI83SJE0770997,71,24,22,2,1
SBI29SMY2972546,22,31,30,1,1
SBI44PJH3807458,61,19,13,6,1
SBI48FPS3135380,62,23,14,9,1
SBI51LOB6738746,75,26,20,6,1
SBI05LEE1246367,88,24,23,1,1
SBI86SGY2793330,84,25,22,3,1
SBI65VBR9880922,98,24,22,2,1
SBI80UQN1220559,87,25,22,3,1
SBI29ARE1832610,94,14,10,4,1
SBI42CHB4771005,91,23,21,2,1
SBI71VDV8300702,79,23,12,11,1
SBI27NYC3617036,62,21,17,4,1
SBI65HQG4522379,18,21,14,7,1
SBI52DNU7645173,86,25,24,1,1
SBI11DGG3892402,91,28,26,2,1
SBI88NIO3624455,96,18,17,1,1
SBI21YRD4344737,24,21,18,3,1
SBI40IBZ0448335,63,25,17,8,1
SBI38CVL5000294,20,23,13,10,1
SBI64WPI6643146,91,23,20,3,1
SBI06NTS5946452,86,20,15,5,1
SBI29RAS3783157,21,35,22,13,1
SBI89OPC8955146,71,17,9,8,1
SBI04NOB9909616,23,30,22,8,1
SBI99UCC3330600,82,24,16,8,1
SBI01WTH1106258,24,30,22,8,1
SBI98VWQ9467095,21,27,18,9,1
SBI74RID0131173,78,22,21,1,1
SBI64KCJ1172371,24,29,18,11,1
SBI66RPB9945078,92,28,26,2,1
SBI12DXL2779598,66,22,14,8,1
SBI32YUU8905362,60,21,18,3,1
SBI81IPE8350005,88,26,18,8,1
SBI71DMP9097624,25,27,20,7,1
SBI21EDP1943171,99,28,25,3,1
SBI25ZJH9510949,79,24,22,2,1
SBI72QMD0218985,88,33,31,2,1
SBI60GIA9853544,76,20,11,9,1
SBI26NHV3480071,65,20,14,6,1
SBI58NKM5030330,69,25,17,8,1
SBI63HPG7731552,88,16,13,3,1
SBI16GIG0856453,68,22,18,4,1
SBI01GEL2308030,86,27,20,7,1
SBI64YTQ0710186,83,34,21,13,1
SBI30QOD5319976,95,14,8,6,1
SBI39BZO9360727,68,25,22,3,1
SBI44IVC5548645,91,29,27,2,1
SBI63JXP3003794,72,23,19,4,1
SBI21JRL5896077,86,27,15,12,1
SBI84ZWD9588841,77,23,17,6,1
SBI77XMU6248993,23,22,19,3,1
SBI73CMT3280396,82,26,24,2,1
SBI42DQT3670185,19,25,16,9,1
SBI07TFC1719890,94,27,19,8,1
SBI17QKV4530638,74,26,19,7,1
SBI60ZIN8829942,74,27,23,4,1
SBI00RSK5303814,98,22,20,2,1
SBI86JQW4923494,95,26,21,5,1
SBI91DQD7956094,96,24,20,4,1
SBI09DGU7433027,78,25,19,6,1
SBI44EMM4861953,24,22,16,6,1
SBI22HZB6667378,95,19,13,6,1
SBI33YCR1844904,78,31,30,1,1
SBI05MLP8484344,92,29,16,13,1
SBI00MTD5033624,66,32,17,15,1
SBI95RXJ9495377,67,28,26,2,1
SBI31SBO2826434,80,26,17,9,1
SBI95LTI5671842,93,24,23,1,1
SBI30FCG9654426,86,24,19,5,1
SBI18DLY1620892,95,24,19,5,1
SBI16OZA7522590,73,21,12,9,1
SBI07MJK3372759,95,24,16,8,1
SBI88NDV7744577,94,22,18,4,1
SBI67AGE6066462,97,29,23,6,1
SBI19QCU2671812,72,21,13,8,1
SBI44STY2671616,19,17,10,7,1
SBI33SKF6179332,18,27,21,6,1
SBI11MRJ7024612,81,18,16,2,1
SBI97SYO9998966,20,23,17,6,1
SBI00LAE0224189,96,31,29,2,1
SBI03SEW8461474,95,30,23,7,1
SBI77QWX4321480,73,41,23,18,1
SBI47RZY9141772,25,19,14,5,1
SBI79QKY8419418,92,38,33,5,1
SBI60CFQ8166631,94,24,18,6,1
SBI43DDH3536936,72,30,22,8,1
SBI91SHL5619380,75,30,20,10,1
SBI83KVE7103946,64,21,11,10,1
SBI68GWA4966476,61,29,28,1,1
SBI34NVA4099397,93,32,28,4,1
SBI28KGL6069620,96,29,15,14,1
SBI31YRQ5480813,94,20,15,5,1
SBI43IPR9420676,80,26,15,11,1
SBI57QHV8070925,63,29,24,5,1
SBI31BNW2743146,19,21,17,4,1
SBI86EJQ6255114,73,29,24,5,1
SBI95IDD5357465,90,16,15,1,1
SBI35ERY6133572,60,22,17,5,1
SBI11PSE9337737,23,31,17,14,1
SBI55COI6718482,84,28,27,1,1
SBI46JSM1845375,62,26,16,10,1
SBI41JPB6780090,90,16,10,6,1
SBI87RRA4814140,78,26,23,3,1
SBI32ZSB7259670,98,26,22,4,1
SBI03PVI8835642,81,23,14,9,1
SBI60XOS1565900,76,27,15,12,1
SBI72IAV6900131,79,32,25,7,1
SBI60NDU3756422,19,19,16,3,1
SBI58UKV4609491,23,19,13,6,1
SBI10GVT8511227,74,33,22,11,1
SBI36QVO4525039,99,28,25,3,1
SBI43YQU7805489,70,20,19,1,1
SBI78HRR7280943,65,25,21,4,1
SBI33WKE9151800,96,21,16,5,1
SBI59RHS9112055,93,24,22,2,1
SBI85QKM9992235,68,19,12,7,1
SBI70CQD5431540,82,23,12,11,1
SBI42ZZL5095567,65,18,13,5,1
SBI77AEE5627874,90,28,18,10,1
SBI49BTY6715676,89,26,16,10,1
SBI19TUE5229085,86,15,14,1,1
SBI34KKS3265959,96,22,17,5,1
SBI75BWA8379424,73,13,9,4,1
SBI02KXO2920297,68,23,17,6,1
SBI52GFE2824330,63,24,20,4,1
SBI77PTR0273209,97,21,17,4,1
SBI50OTH2837345,79,28,16,12,1
SBI60HQG2163527,97,24,21,3,1
SBI16CSO2267243,66,26,17,9,1
SBI65JCS8613548,86,19,16,3,1
SBI81FPJ3475979,86,19,18,1,1
SBI01VKE9036293,72,27,20,7,1
SBI41BVB3463082,63,16,13,3,1
SBI57NUR7878392,67,25,15,10,1
SBI94IVH6571164,60,24,14,10,1
SBI15GIV1888188,69,21,16,5,1
SBI18AQH2034442,97,32,22,10,1
SBI56XXL9269498,96,21,18,3,1
SBI85QRN4856109,94,20,19,1,1
SBI40NJT8199229,19,24,16,8,1
SBI98VYZ6321680,70,26,23,3,1
SBI23LAC1676758,98,25,15,10,1
SBI15HUE6840211,80,21,14,7,1
SBI56XHE0482708,73,37,21,16,1
SBI75LWQ6344214,78,23,17,6,1
SBI98WCR6752871,61,28,16,12,1
SBI04QMP7957620,25,21,11,10,1
SBI28GYQ9828435,94,27,19,8,1
SBI96JZI0375859,80,26,16,10,1
SBI55SOK8642481,68,22,12,10,1
SBI79MHS9163610,24,26,22,4,1
SBI37HVJ2757819,85,20,13,7,1
SBI51YPK2243756,20,19,16,3,1
SBI84NAP8735707,23,25,19,6,1
SBI51IMO7545277,79,23,14,9,1
SBI32OPE4934763,25,22,21,1,1
SBI03TJX3289726,88,24,23,1,1
SBI23YPS0141484,75,28,15,13,1
SBI36EYA3869522,96,21,16,5,1
SBI07OCU5543578,82,33,20,13,1
SBI63YTU1059331,67,20,19,1,1
SBI71GEH0747831,75,23,17,6,1
SBI32YHA6995682,88,22,20,2,1
SBI36IQT8949449,63,29,17,12,1
SBI91VEK0390560,95,33,31,2,1
SBI31UEX1787660,95,17,11,6,1
SBI78QLA4160761,71,22,19,3,1
SBI84YQS4051784,82,21,17,4,1
SBI90PLL4308737,61,19,11,8,1
SBI74NFZ3495042,64,18,16,2,1
SBI91KEM8143776,78,26,16,10,1
SBI10ORR2380409,94,33,29,4,1
SBI95SEG6682704,78,21,20,1,1
SBI65RCY8515089,93,23,19,4,1
SBI06QMB7566971,98,28,17,11,1
SBI16DUT5919749,67,33,21,12,1
SBI81BJU4913709,93,18,10,8,1
SBI45UVE1547031,67,21,12,9,1
SBI06QRF5897890,75,20,16,4,1
SBI03GNI4022068,60,25,23,2,1
SBI37SPO7810959,23,20,15,5,1
SBI32JXM3047063,74,23,12,11,1
SBI17HHP9733325,97,25,23,2,1
SBI06RCA4766200,18,27,25,2,1
SBI18BMS5841989,78,30,19,11,1
SBI89TQC1961200,89,23,16,7,1
SBI60ASP9249496,18,23,17,6,1
SBI38QHP5965224,25,25,13,12,1
SBI72PUT6942353,89,16,10,6,1
SBI03COU8337903,95,23,18,5,1
SBI48TBL0299379,69,25,24,1,1
SBI33WFB8219939,89,27,17,10,1
SBI24TZK5820454,69,26,22,4,1
SBI14WDB1587292,21,31,28,3,1
SBI64KOM1597999,73,22,20,2,1
SBI35GHQ9829820,24,27,24,3,1
SBI31MCS8265400,72,33,29,4,1
SBI26ZXY9200417,93,26,16,10,1
SBI86HYR7167944,80,21,18,3,1
SBI42JXA7717190,22,29,27,2,1
SBI03KXO4862615,20,22,12,10,1
SBI37GVT0453643,84,24,14,10,1
SBI62NNX4882915,96,20,14,6,1
SBI76COK0616006,79,19,12,7,1
SBI68IVD3173781,66,19,10,9,1
SBI75WQI2473281,76,21,12,9,1
SBI40CDJ2232275,68,18,13,5,1
SBI20OSH8347976,68,28,22,6,1
SBI99AFJ1322628,87,25,16,9,1
SBI59KUF5772277,73,27,26,1,1
SBI21MOZ9877775,79,28,17,11,1
SBI50TWD4498398,99,22,15,7,1
SBI51EDL1806673,89,22,18,4,1
SBI51CYP0236043,23,29,27,2,1
SBI14IVU8141332,65,16,13,3,1
SBI81UHO9127809,81,22,21,1,1
SBI39GAK4458783,89,14,9,5,1
SBI05EJB2250168,75,17,12,5,1
SBI82EMG1381706,92,20,14,6,1
SBI93YJC8560566,78,24,20,4,1
SBI69XRQ7344603,94,32,20,12,1
SBI87LBH0611975,18,24,19,5,1
SBI70HFF5916097,66,27,15,12,1
SBI48BNI5058615,64,32,19,13,1
SBI63EPP1994219,18,27,17,10,1
SBI78NML3898788,92,32,31,1,1
SBI14MJR5561116,70,30,16,14,1
SBI83XTZ7588960,85,29,17,12,1
SBI60LPA2510229,66,26,18,8,1
SBI13ITU4421479,72,40,25,15,1
SBI47MPX1167641,60,20,11,9,1
SBI38RGJ6320448,68,27,14,13,1
SBI30ISQ9810680,60,21,18,3,1
SBI65WXR6041355,25,22,13,9,1
SBI67VCQ0679454,20,27,19,8,1
SBI38ZWL2023595,80,30,26,4,1
SBI80GZE3676690,96,27,17,10,1
SBI94HHD5636487,86,19,15,4,1
SBI38XSB1957137,24,25,13,12,1
SBI48KSD2715659,82,20,15,5,1
SBI63NBA6784402,68,29,23,6,1
SBI60WTG9596116,94,32,17,15,1
SBI57PJF3788475,22,25,19,6,1
SBI87UCL5549880,70,30,23,7,1
SBI80XGU3295863,95,25,21,4,1
SBI63OPV8216635,87,25,13,12,1
SBI97XZK2387886,19,11,9,2,1
SBI83PZI8987826,92,21,18,3,1
SBI76VCC1412966,71,25,15,10,1
SBI16JEY0497152,22,32,28,4,1
SBI42HRP1786064,92,19,11,8,1
SBI32EUY8674346,20,31,30,1,1
SBI76DVX1130390,75,17,10,7,1
SBI42FPJ9300180,24,35,20,15,1
SBI55DHW2699807,78,29,23,6,1
SBI64RZH3165494,87,23,18,5,1
SBI66ZEP6299938,18,14,12,2,1
SBI52CEW0761607,77,18,16,2,1
SBI79AYB2236927,67,24,13,11,1
SBI44BMM3563045,74,29,16,13,1
SBI51ONB8937659,93,25,21,4,1
SBI85JUU6178902,70,20,16,4,1
SBI64GZT4253031,94,32,30,2,1
SBI74IAO0814107,21,17,13,4,1
SBI50BSH8094553,91,19,15,4,1
SBI85BHX8243188,90,23,18,5,1
SBI54JCW8365094,60,30,17,13,1
SBI36YSZ6059983,88,24,13,11,1
SBI37RIR8319019,84,23,18,5,1
SBI10YUK0949303,78,33,17,16,1
SBI87DGN1008297,75,26,21,5,1
SBI01KMU3170033,95,17,13,4,1
SBI16NVJ3404165,22,24,16,8,1
SBI79EIK1967844,92,20,13,7,1
SBI37CTR1827279,69,14,9,5,1
SBI64QQQ7617678,92,21,19,2,1
SBI00XNM4188078,82,22,18,4,1
SBI89CZS3965093,63,20,12,8,1
SBI31JBU8994010,84,25,24,1,1
SBI85QSX7470694,80,23,12,11,1
SBI47YYV1191620,90,16,9,7,1
SBI64WDS3002813,62,16,11,5,1
SBI76YQT4276962,88,13,10,3,1
SBI32CAP7489149,63,9,8,1,1
SBI06LPI0259425,64,28,20,8,1
SBI67MUX4069738,25,24,17,7,1
SBI77SBJ8050848,91,22,12,10,1
SBI24EPG7339867,64,33,19,14,1
SBI21DWF6771219,97,20,18,2,1
SBI54YTM5407164,65,21,20,1,1
SBI77MKK0839551,82,25,18,7,1
SBI72MKW5966273,19,29,24,5,1
SBI90EWG6128363,87,23,16,7,1
SBI61CAZ9195182,75,22,16,6,1
SBI59ZXQ5917077,96,24,22,2,1
SBI03MEN7504483,63,28,23,5,1
SBI01KBA0852420,91,28,18,10,1
SBI16HKV5188213,88,20,19,1,1
SBI54ZGO9350379,69,21,13,8,1
SBI08AJS9500947,19,27,22,5,1
SBI46AQP0313115,64,24,15,9,1
SBI64UEJ2563705,77,24,18,6,1
SBI84DHE9900298,93,32,17,15,1
SBI50IDI3612688,96,21,17,4,1
SBI02RIT7656024,21,19,13,6,1
SBI05LXR2064133,99,23,15,8,1
SBI52SAF3443053,25,26,14,12,1
SBI89ELG0119085,66,21,12,9,1
SBI67ICJ3852926,83,31,19,12,1
SBI79DYP5868786,96,23,21,2,1
SBI68FZZ2957625,64,18,12,6,1
SBI89RIL2416064,81,21,15,6,1
SBI85ACE5789805,72,25,13,12,1
SBI02OED0100706,95,20,14,6,1
SBI73MOT7366254,63,25,13,12,1
SBI31AGQ5161812,98,25,13,12,1
SBI58WCV7152443,61,32,30,2,1
SBI87IJI5199341,90,28,23,5,1
SBI66XNN7985539,70,26,22,4,1
SBI67JXY2271628,75,20,13,7,1
SBI62WGK7752608,80,32,18,14,1
SBI95GSM2413948,84,32,29,3,1
SBI85IBW5363194,72,30,26,4,1
SBI43XSK7138045,71,29,17,12,1
SBI61ZFR6727321,79,21,19,2,1
SBI95VVB2821491,60,39,31,8,1
SBI42JJA3531155,82,26,20,6,1
SBI23STE4606923,94,27,20,7,1
SBI12SBT4347098,61,30,27,3,1
SBI50LPW4983128,68,33,26,7,1
SBI53HOU5336634,90,19,13,6,1
SBI42JDC6521922,98,23,19,4,1
SBI56JRN1206007,73,27,14,13,1
SBI91NJO3674809,77,32,26,6,1
SBI64AZH4458316,86,27,16,11,1
SBI62YCZ8029975,61,23,22,1,1
SBI56HRJ7694515,83,28,22,6,1
SBI17PVR1891180,78,27,19,8,1
SBI43KTT6880672,99,25,23,2,1
SBI19NGS7656779,78,22,13,9,1
SBI59JGV1755563,96,14,8,6,1
SBI58KTJ7160944,61,21,13,8,1
SBI16WOK8517828,86,22,18,4,1
SBI09YWF3271958,25,19,11,8,1
SBI97KCH9060835,66,23,18,5,1
SBI57XIL7151539,67,26,22,4,1
SBI71UUS8907553,70,30,23,7,1
SBI05ZOE2850958,22,16,14,2,1
SBI11HZF1737822,89,30,27,3,1
SBI01BBN3284776,94,37,32,5,1
SBI44LXG8664069,61,35,18,17,1
SBI99EGY7992086,25,24,19,5,1
SBI49ABQ9314542,62,27,19,8,1
SBI69OEU3040403,64,22,14,8,1
SBI37SQO7186545,20,20,15,5,1
SBI07KJW8282009,67,20,18,2,1
SBI72AAF3907399,63,27,18,9,1
SBI38LAJ7337928,88,23,22,1,1
SBI89TJE3462407,85,29,21,8,1
SBI50EFC8785942,76,34,22,12,1
SBI88YEH4096593,22,22,21,1,1
SBI59PJG9122719,20,24,21,3,1
SBI89CXB5395472,94,23,22,1,1
SBI01GBT8114978,89,21,12,9,1
SBI75FCI8748030,83,30,26,4,1
SBI01QGP5896410,79,25,20,5,1
SBI87UKQ6740596,23,21,18,3,1
SBI35TVY6243804,72,25,23,2,1
SBI35RIM4297869,77,26,16,10,1
SBI31RFD5272288,69,22,20,2,1
SBI04DMZ5814508,19,26,20,6,1
SBI99XGC4224060,90,28,27,1,1
SBI45BRC7784027,60,27,25,2,1
SBI89XZK2754576,22,24,21,3,1
SBI71AHC5197261,99,23,19,4,1
SBI90BSA6132018,24,28,24,4,1
SBI63QYC2830944,20,25,23,2,1
SBI53VWX1456837,77,18,13,5,1
SBI88CKT2432530,95,28,26,2,1
SBI64UQO7312759,61,27,23,4,1
SBI59XND7756770,78,24,14,10,1
SBI02BBI0716971,68,20,19,1,1
SBI07WKY0018369,94,30,26,4,1
SBI96WYE9563383,84,28,18,10,1
SBI86MHD6481091,78,25,16,9,1
SBI19DRC3342204,82,38,33,5,1
SBI22EBC5466215,69,20,19,1,1
SBI08KAY2448665,72,20,12,8,1
SBI00EKK2055914,88,27,17,10,1
SBI02IIJ9617039,64,21,13,8,1
SBI68FHF4289430,87,17,11,6,1
SBI40QDG0806795,85,33,30,3,1
SBI47CTR6087672,87,20,14,6,1
SBI26CMJ9498521,66,28,17,11,1
SBI85VSO9430342,21,33,32,1,1
SBI61JRE2200019,81,28,16,12,1
SBI10JCU8823871,76,26,22,4,1
SBI06IAP7118152,67,17,14,3,1
SBI04FNW6662752,88,22,18,4,1
SBI70QGE4341371,90,20,19,1,1
SBI27UQM6208071,72,22,16,6,1
SBI37WMP8266938,69,24,19,5,1
SBI20BVN1433415,80,26,20,6,1
SBI21WJW6001178,88,26,22,4,1
SBI27FZP3077380,23,24,21,3,1
SBI12TQN3754594,61,31,20,11,1
SBI97VBM7221851,87,28,25,3,1
SBI17KVL0266144,24,29,25,4,1
SBI18NBB2813622,81,21,18,3,1
SBI88KYE1605580,63,25,17,8,1
SBI98OHV7581848,66,31,18,13,1
SBI36TJA5990786,60,27,15,12,1
SBI24PDD7665269,95,28,23,5,1
SBI57QSK2567478,68,22,18,4,1
SBI30DYJ0870978,86,29,16,13,1
SBI42JJP9994459,79,22,16,6,1
SBI81MAI7989577,24,31,24,7,1
SBI28AEP3806920,91,29,24,5,1
SBI42HFX9272175,62,23,16,7,1
SBI42GRN8330763,22,22,15,7,1
SBI36JNH9399057,95,27,22,5,1
SBI62LSB4274757,25,27,23,4,1
SBI44CMT1045528,98,25,19,6,1
SBI29DRG9463251,69,34,23,11,1
SBI39RNM8553833,69,25,23,2,1
SBI94AAJ1092788,94,20,18,2,1
SBI50ZOJ4104472,83,22,14,8,1
SBI07QMT1797228,96,27,24,3,1
SBI62OPB2362051,94,26,20,6,1
SBI16KZQ5070772,18,23,13,10,1
SBI50OFT3346186,68,24,17,7,1
SBI65GKP6692342,82,31,18,13,1
SBI47HBS9991888,18,25,19,6,1
SBI60ZPL3922779,20,27,25,2,1
SBI09TSW5699124,93,23,22,1,1
SBI28MUU1212442,80,33,19,14,1
SBI02NOK5397636,77,23,22,1,1
SBI18PIX6014713,64,29,25,4,1
SBI25XFZ8344388,82,27,15,12,1
SBI69IHZ2346531,94,23,14,9,1
SBI15UUV1909718,62,27,20,7,1
SBI30XTE8406476,99,32,21,11,1
SBI43PHT6408735,77,34,32,2,1
SBI34DHY8668334,96,23,21,2,1
SBI50XXI3485523,96,19,12,7,1
SBI53QMX9642853,69,25,21,4,1
SBI55BZT0929585,79,20,16,4,1
SBI75XOZ8502960,76,20,12,8,1
SBI85FCQ8315542,98,19,14,5,1
SBI16QZA8453212,82,23,14,9,1
SBI64DFP5368576,95,25,21,4,1
SBI75LVV2269134,86,38,20,18,1
SBI00VLY1686524,64,23,20,3,1
SBI89QNX8675401,68,25,24,1,1
SBI96DLO8289164,24,23,16,7,1
SBI26FXL5444866,18,22,19,3,1
SBI07XID8908427,25,22,15,7,1
SBI04ESC3766514,80,22,16,6,1
SBI08QML8474565,64,25,23,2,1
SBI37OGG1213094,80,28,17,11,1
SBI28PYI2986044,76,27,20,7,1
SBI88QYR3547469,89,19,13,6,1
SBI75MAJ9147145,84,25,17,8,1
SBI92JPW2070215,18,22,15,7,1
SBI21VJV8415410,25,32,26,6,1
SBI33VXJ4341655,96,22,19,3,1
SBI51HGW0402535,63,34,27,7,1
SBI95XPI9238673,96,31,30,1,1
SBI88KRZ8511603,71,25,18,7,1
SBI77COR6226568,81,17,15,2,1
SBI81SZE6907103,77,26,19,7,1
SBI53DZV2426738,92,26,25,1,1
SBI28TEH0606776,68,24,23,1,1
SBI22LFK8887417,95,25,15,10,1
SBI98WAU0146640,72,30,21,9,1
SBI25PLN7617984,20,19,14,5,1
SBI68ETM9096516,80,25,17,8,1
SBI25GEF5186405,21,30,25,5,1
SBI68CZV4911566,95,23,15,8,1
SBI56TQJ5412229,22,27,15,12,1
SBI87QLF2103679,85,20,17,3,1
SBI43CZK2317903,84,24,21,3,1
SBI36OVI6605574,97,20,16,4,1
SBI28SFV5226579,80,23,21,2,1
SBI45BAI4457497,83,27,22,5,1
SBI71RTF0791939,95,33,27,6,1
SBI28HYX9049622,67,24,13,11,1
SBI16UTQ8858709,68,26,23,3,1
SBI27BLX8479387,95,24,14,10,1
SBI62KYD2155624,89,37,30,7,1
SBI06GYG4574795,76,28,15,13,1
SBI53LPR3799787,70,19,18,1,1
SBI08PSW8957797,79,24,18,6,1
SBI88FFZ7195713,80,22,14,8,1
SBI57LMU3201933,25,21,18,3,1
SBI15MKM1593435,72,29,18,11,1
SBI56ADA0405128,66,23,15,8,1
SBI09RHL7263992,74,22,13,9,1
SBI94NMW7127713,25,30,23,7,1
SBI80VCT7224484,77,26,19,7,1
SBI11ZZK2795447,61,20,18,2,1
SBI86WNK6069642,80,26,22,4,1
SBI82ZLN4972726,93,22,18,4,1
SBI31ERW0543590,95,25,16,9,1
SBI75GJE9957787,74,14,11,3,1
SBI44YGO6265344,60,31,29,2,1
SBI63XUF9092545,73,23,18,5,1
SBI83DCG9946611,69,19,14,5,1
SBI31AAG5042583,24,20,13,7,1
SBI48RQH3816226,97,31,18,13,1
SBI84HNX6390605,23,24,14,10,1
SBI95NMV9420687,19,24,17,7,1
SBI78KME9602610,90,23,16,7,1
SBI84FNY1612429,63,21,20,1,1
SBI48ZXW2748877,62,17,11,6,1
SBI58OXA1386191,61,29,24,5,1
SBI32VSN1221709,18,23,20,3,1
SBI32GTQ5949867,61,20,16,4,1
SBI27GKD4699459,19,34,19,15,1
SBI79SRL5322687,78,24,19,5,1
SBI81RMX8570228,25,23,17,6,1
SBI20EKF6001199,89,20,18,2,1
SBI29DAE1911318,93,23,15,8,1
SBI01IAX5611386,91,32,31,1,1
SBI70LRK2705982,67,39,30,9,1
SBI02MPY0922206,88,24,21,3,1
SBI07WOI1433681,99,24,18,6,1
SBI40CWL5687898,86,30,19,11,1
SBI15BGB7529442,21,26,18,8,1
SBI00ZHL1940267,92,26,21,5,1
SBI94TLY6154640,86,17,10,7,1
SBI87KXY3256512,85,19,14,5,1
SBI29XBP4254089,21,21,19,2,1
SBI09FNW9845364,98,32,27,5,1
SBI97AEY6667107,76,32,17,15,1
SBI77FPD1374363,63,21,14,7,1
SBI69BBP1228072,70,19,16,3,1
SBI72QLK8671963,22,15,13,2,1
SBI20WTF2747670,91,24,20,4,1
SBI19PSF0533057,68,30,27,3,1
SBI23QCF0597952,96,25,21,4,1
SBI93BCM5259428,80,26,22,4,1
SBI79EYY7729070,78,24,16,8,1
SBI86VGL7728836,89,27,16,11,1
SBI92QPY6782982,89,25,20,5,1
SBI30VBN8753997,79,26,18,8,1
SBI35GGT9208020,98,22,21,1,1
SBI54GBX8479652,80,28,20,8,1
SBI09OES1003765,25,21,17,4,1
SBI87REV9163780,66,23,22,1,1
SBI26QYU7148123,89,20,15,5,1
SBI97SAX4733377,88,24,21,3,1
SBI70IMU6948774,99,17,9,8,1
SBI40HAL5648894,82,28,16,12,1
SBI30MML8520780,80,23,13,10,1
SBI30GNO9056413,84,25,24,1,1
SBI37FWI0778236,66,30,27,3,1
SBI07UZV1768270,78,23,12,11,1
SBI49HRW0334241,98,26,25,1,1
SBI14JNX4147862,23,29,26,3,1
SBI05NVD0614729,74,34,25,9,1
SBI50BNL5551162,74,23,19,4,1
SBI36OOW6282429,72,15,11,4,1
SBI49RWR7191496,90,33,27,6,1
SBI66YUO6615388,93,23,13,10,1
SBI11XVT6896343,67,30,29,1,1
SBI75NAQ3719019,97,26,16,10,1
SBI89QQQ2997567,85,27,15,12,1
SBI88JTI9441802,71,22,19,3,1
SBI04DUI3672757,68,30,21,9,1
SBI60JUH4861081,22,25,15,10,1
SBI34CJO0844214,24,21,16,5,1
SBI56QGD8052036,88,23,14,9,1
SBI70JQG8465802,77,19,12,7,1
SBI66PQA2845670,67,31,16,15,1
SBI85JMG6718020,69,27,26,1,1
SBI11IST9694007,63,20,19,1,1
SBI85PGD5460122,23,22,15,7,1
SBI06ULF2069942,63,29,26,3,1
SBI22YPH5821979,72,35,34,1,1
SBI53XDY8144894,69,24,18,6,1
SBI29MSP2752189,91,23,13,10,1
SBI46UGX6042447,69,9,8,1,1
SBI67FKG9898307,86,18,13,5,1
SBI90GWU8267500,74,22,20,2,1
SBI55BUE5479801,95,26,21,5,1
SBI40AKN0025219,96,26,14,12,1
SBI02MOO6604407,64,23,22,1,1
SBI64JBW5217705,77,30,29,1,1
SBI62VFM6827233,19,24,19,5,1
SBI07ZIW3253521,67,17,9,8,1
SBI86ESK5574613,20,20,14,6,1
SBI67EBY2251607,80,31,18,13,1
SBI48QBE7525244,92,15,11,4,1
SBI34ROO1241451,62,21,18,3,1
SBI23XWA9765994,87,22,13,9,1
SBI39YSR0576879,95,26,24,2,1
SBI76DJI4887438,82,27,23,4,1
SBI28ZTO7819005,71,30,16,14,1
SBI00ZWM5436040,77,24,19,5,1
SBI26TAT7720397,95,20,11,9,1
SBI21INK7738288,62,21,13,8,1
SBI22EOB1246716,91,21,16,5,1
SBI67PST1405043,67,26,23,3,1
SBI24ZXV1481921,96,22,19,3,1
SBI13QIS4545398,63,30,25,5,1
SBI36CNL4974043,91,21,12,9,1
SBI14SMJ3085007,91,31,20,11,1
SBI59QSJ5206009,70,20,13,7,1
SBI00BWI5971330,93,11,8,3,1
SBI22JAD1275227,66,15,11,4,1
SBI37KJM3221514,72,18,14,4,1
SBI28DOK1033802,79,18,10,8,1
SBI40JMG7694622,97,25,18,7,1
SBI34QIW4214050,60,34,30,4,1
SBI08LKY2482723,20,21,11,10,1
SBI05JAE7236843,79,31,18,13,1
SBI63LUE3136058,19,21,15,6,1
SBI17OET2220912,93,24,19,5,1
SBI99GBL6927762,95,32,29,3,1
SBI23XSS9592516,73,19,11,8,1
SBI17FKD6389970,78,26,16,10,1
SBI65RBK6125746,97,26,18,8,1
SBI39NSG4597642,94,30,26,4,1
SBI85UJZ0636792,93,22,12,10,1
SBI49ETC3173110,66,22,16,6,1
SBI84KRL2580529,86,28,15,13,1
SBI61YVY4278137,85,27,14,13,1
SBI74PRA3498768,95,22,13,9,1
SBI73QRD9440153,66,30,28,2,1
SBI78EMJ3638244,92,24,18,6,1
SBI51ETW6251950,64,25,13,12,1
SBI97VXZ3338297,64,21,15,6,1
SBI13WNY2845722,71,22,20,2,1
SBI00LEL3906694,69,28,15,13,1
SBI30ZBT8610673,80,29,24,5,1
SBI38PJP4182555,93,25,22,3,1
SBI88DQC1638430,71,19,11,8,1
SBI31SXU4164754,63,19,12,7,1
SBI26TAH6168411,97,31,25,6,1
SBI94QLV1146911,85,24,21,3,1
SBI63AAN7605299,83,18,13,5,1
SBI58KLB1776881,88,17,15,2,1
SBI33SIK7420318,25,27,14,13,1
SBI28NJT1754565,68,16,10,6,1
SBI36BAJ2236143,94,26,21,5,1
SBI18HSW9057283,25,23,18,5,1
SBI76JQO2709247,19,26,21,5,1
SBI09CIW3309432,66,22,12,10,1
SBI56THC4423253,25,27,16,11,1
SBI47QKN9276081,88,30,24,6,1
SBI84DXK6341196,61,16,15,1,1
SBI97AZP4876445,98,29,26,3,1
SBI92RQE8240371,93,22,13,9,1
SBI21XTU9015136,20,22,13,9,1
SBI89SDE4607493,89,26,18,8,1
SBI69OIZ5846809,85,30,19,11,1
SBI36QLJ0854734,24,21,16,5,1
SBI01AWL6825076,81,27,15,12,1
SBI47OIE4410596,90,32,24,8,1
SBI86CEM6890077,91,29,19,10,1
SBI12ZPM1393722,99,16,13,3,1
SBI12ABZ2489769,67,28,19,9,1
SBI49EGT0354358,97,14,9,5,1
SBI11PSK0850920,18,26,19,7,1
SBI65SRF6857807,99,32,23,9,1
SBI24HBB3873382,73,27,19,8,1
SBI63UPK1709331,73,27,17,10,1
SBI12TEV2138540,73,19,14,5,1
SBI11EZA6617782,19,18,10,8,1
SBI18EUT4832920,69,23,12,11,1
SBI18EHB4131371,98,23,19,4,1
SBI58LQQ5867761,69,28,26,2,1
SBI55SRF1565334,21,30,21,9,1
SBI82BIE3992239,93,30,28,2,1
SBI91GTB9306404,81,26,18,8,1
SBI16LHZ2534577,89,16,9,7,1
SBI99AQD6517311,97,20,19,1,1
SBI59GIV8915079,23,25,17,8,1
SBI17WSI7972726,91,30,23,7,1
SBI26GTZ0398972,70,15,14,1,1
SBI58ZWU7119065,21,25,13,12,1
SBI80DDE3735167,23,28,19,9,1
SBI91LCD0784090,66,20,19,1,1
SBI18OPE5883668,99,26,19,7,1
SBI57SBL8532252,65,15,9,6,1
SBI63LPK5627085,96,31,22,9,1
SBI18UJU3631924,65,27,16,11,1
SBI57LGS0406011,99,33,21,12,1
SBI40PME0642655,81,18,13,5,1
SBI32CGP6222666,70,23,12,11,1
SBI55VZT8879414,62,30,17,13,1
SBI29OLX9451415,63,29,18,11,1
SBI68CPY4455137,68,24,22,2,1
SBI75MYA8929772,68,24,18,6,1
SBI97HVG1045828,22,23,18,5,1
SBI56YZK2172197,99,28,16,12,1
SBI74LTI7720495,87,27,19,8,1
SBI78AKO9853547,76,26,22,4,1
SBI11NLH9181170,81,26,18,8,1
SBI07UMF2445516,25,23,21,2,1
SBI54RNG1577444,88,22,17,5,1
SBI98VIW1044434,69,24,22,2,1
SBI37FME7483062,18,21,17,4,1
SBI24WCF4342769,97,23,18,5,1
SBI16DUJ9908219,77,20,16,4,1
SBI57EYV1577245,75,28,15,13,1
SBI22TYZ3883939,93,27,26,1,1
SBI22WOE1036478,22,22,18,4,1
SBI99ZJO3318093,19,23,14,9,1
SBI22ZAO0346411,20,33,29,4,1
SBI51NKF9186658,90,24,17,7,1
SBI32KFO8502655,88,23,16,7,1
SBI36SMH5214133,81,30,24,6,1
SBI95RWR8552672,78,17,13,4,1
SBI64UFU8478033,79,21,18,3,1
SBI18KXN8128033,76,23,12,11,1
SBI07OVA0185415,69,26,19,7,1
SBI04GWN5629236,79,20,15,5,1
SBI61ECJ1761594,68,26,22,4,1
SBI26DXO8547487,68,36,26,10,1
SBI44FLM1829410,96,29,25,4,1
SBI31RRC7136896,83,32,30,2,1
SBI50TGL1791295,80,21,12,9,1
SBI64TOH0134132,89,23,17,6,1
SBI98XOO1663701,77,30,28,2,1
SBI43MRF3225001,92,29,28,1,1
SBI72LVP5373592,97,20,15,5,1
SBI77FAP4824685,84,16,14,2,1
SBI35QHE3674875,64,30,28,2,1
SBI37BGK9760405,71,36,26,10,1
SBI79MML8481578,69,23,19,4,1
SBI45ZOJ5039437,94,29,20,9,1
SBI35TRO6058268,22,28,18,10,1
SBI25XBJ8935077,79,21,18,3,1
SBI20QGX6944607,62,28,20,8,1
SBI01CAS4949728,87,26,14,12,1
SBI04RCM8748086,81,31,26,5,1
SBI33MHO3880458,99,30,28,2,1
SBI07OQW9520010,84,27,22,5,1
SBI13DWT4445086,79,24,16,8,1
SBI08EZB2961350,62,15,10,5,1
SBI12OWT8751295,95,25,17,8,1
SBI50GNJ5058853,86,21,17,4,1
SBI99ITH0034442,90,26,23,3,1
SBI75GWU5478580,65,25,20,5,1
SBI44WHP1548107,71,27,14,13,1
SBI46DWN1575383,20,11,6,5,1
SBI36NCY1066888,60,17,15,2,1
SBI82AJU2058650,62,22,19,3,1
SBI88FSE2879167,92,24,23,1,1
SBI67HPD4577413,21,28,22,6,1
SBI84ZUC3824801,64,21,17,4,1
SBI12BLU5876994,60,28,16,12,1
SBI82FZT5778595,65,27,17,10,1
SBI08DZD2821542,70,28,23,5,1
SBI65BDW1818055,99,30,24,6,1
SBI25BQA5077355,95,29,19,10,1
SBI07ZTT6228929,24,37,30,7,1
SBI85QJB8384844,21,23,22,1,1
SBI15UCI2443628,69,21,18,3,1
SBI63RAQ4042002,21,29,19,10,1
SBI95SUL3149667,66,27,18,9,1
SBI96FHP2860282,82,31,20,11,1
SBI76AXK3572675,80,20,18,2,1
SBI46MSL0660971,84,26,22,4,1
SBI57LYY3894576,76,20,14,6,1
SBI30GNI0001231,60,24,22,2,1
SBI19FKS1018703,64,24,19,5,1
SBI31GSK0033137,80,19,14,5,1
SBI58EEU9542513,19,30,29,1,1
SBI12STI6675893,64,28,21,7,1
SBI59KLV3602564,60,32,30,2,1
SBI71CVD1160567,19,21,14,7,1
SBI04GFO1025773,77,25,14,11,1
SBI39ZHX7148629,89,20,15,5,1
SBI88UTJ1445511,94,29,25,4,1
SBI25NVV2176218,67,27,16,11,1
SBI38PQX2433507,61,25,23,2,1
SBI52WMD9372378,92,27,16,11,1
SBI28IWM1709491,61,25,24,1,1
SBI16KIB1508452,86,22,15,7,1
SBI04OCK0833278,86,25,17,8,1
SBI92DHT2372795,68,25,21,4,1
SBI46USQ5861131,24,20,14,6,1
SBI43DWA0805943,79,21,14,7,1
SBI38MXJ3397998,94,19,10,9,1
SBI51IGD6533665,84,18,15,3,1
SBI63XIW2615113,71,28,18,10,1
SBI89AEL0894445,21,29,26,3,1
SBI75VLB6722228,89,20,17,3,1
SBI98UVL9831545,62,17,9,8,1
SBI43HUX8859491,77,26,16,10,1
SBI29FMP8377337,83,32,26,6,1
SBI02EQC0640768,68,27,19,8,1
SBI68BMW1930333,97,22,19,3,1
SBI94VWM3347112,63,30,22,8,1
SBI82ZCX1875741,21,32,25,7,1
SBI70AEM7430547,23,35,30,5,1
SBI76JVF7195331,62,26,25,1,1
SBI14XSB4708354,73,28,25,3,1
SBI99KFV4664432,18,26,24,2,1
SBI85PJF7615922,65,28,17,11,1
SBI63QIM8502659,72,14,8,6,1
SBI50BBE9977580,81,29,22,7,1
SBI44YWY9806876,73,23,17,6,1
SBI59QTU3809682,70,31,26,5,1
SBI26KDZ5575408,85,31,25,6,1
SBI75XIA4815953,93,24,23,1,1
SBI86WPV8301337,81,25,18,7,1
SBI65QSC7031164,67,27,20,7,1
SBI08RGG8132540,24,29,25,4,1
SBI67RMN7984234,23,26,19,7,1
SBI37QBG3003436,69,33,31,2,1
SBI69IYR0512489,99,23,17,6,1
SBI75TCK7192825,83,27,18,9,1
SBI42QLR2160317,77,23,14,9,1
SBI19YWI9990434,87,24,19,5,1
SBI68PKW1539172,75,18,10,8,1
SBI29PYP6386732,18,26,23,3,1
SBI50KDB6543509,64,26,21,5,1
SBI26AHF6525697,80,28,21,7,1
SBI48CAG1333910,75,29,27,2,1
SBI24ZOB3095978,18,19,13,6,1
SBI87VGV9095573,24,29,25,4,1
SBI04FHP7659029,72,39,24,15,1
SBI93IVO0201863,24,28,16,12,1
SBI51NIX1218357,87,19,10,9,1
SBI78FHO5197391,79,30,24,6,1
SBI65HAF0562439,81,22,13,9,1
SBI39JRX3528835,79,26,15,11,1
SBI33KHM3072543,22,32,17,15,1
SBI51RVR2575418,90,15,10,5,1
SBI74ACH5185741,71,25,13,12,1
SBI66KZG6906746,25,24,13,11,1
SBI68FBW4280569,65,21,18,3,1
SBI96NCP4439930,67,28,17,11,1
SBI86GRB2248879,96,21,15,6,1
SBI38TMS5371397,74,28,24,4,1
SBI47OHZ1181244,76,21,20,1,1
SBI24HTM3240967,62,19,12,7,1
SBI76XQB4183742,23,32,20,12,1
SBI81LMP2095009,68,19,14,5,1
SBI32MRE3659585,82,23,12,11,1
SBI71VSA0400290,23,21,15,6,1
SBI16MZB0424970,72,25,20,5,1
SBI12XYQ2234516,80,17,10,7,1
SBI10SDC7988504,22,23,15,8,1
SBI28IUR0105415,87,37,26,11,1
SBI60GEL2232031,98,20,12,8,1
SBI46OLD2931887,25,27,24,3,1
SBI50CKZ2660911,88,23,21,2,1
SBI76XSK5934802,68,27,22,5,1
SBI80EBH5635716,72,24,23,1,1
SBI41UFL8605823,81,19,17,2,1
SBI34CFK1163706,68,24,20,4,1
SBI90PBK2297882,98,24,23,1,1
SBI74ZIG0502181,92,31,28,3,1
SBI04OFZ2408740,93,25,16,9,1
SBI84FXG8860105,63,21,11,10,1
SBI42CMU1254661,76,25,21,4,1
SBI05YRK6745891,64,26,19,7,1
SBI17AAM1354240,73,33,21,12,1
SBI52JGU8788438,80,25,18,7,1
SBI11KUU9908349,76,22,12,10,1
SBI67YNW9237134,96,18,15,3,1
SBI76QON7596290,98,23,20,3,1
SBI28YOQ9092595,90,25,20,5,1
SBI29IMX0633644,75,24,16,8,1
SBI87WGP0683007,87,23,16,7,1
SBI09XDK6372741,82,25,15,10,1
SBI08XOA1605029,85,26,20,6,1
SBI39FMM9496101,23,21,13,8,1
SBI62LVB0423031,86,23,21,2,1
SBI82PEL6618996,95,33,20,13,1
SBI34KWB2985488,70,19,17,2,1
SBI27TKN9770704,78,23,22,1,1
SBI44MKW1963252,19,28,26,2,1
SBI39ZCT7412287,22,29,15,14,1
SBI43KCD2380221,25,24,16,8,1
SBI40BNW8088291,84,27,14,13,1
SBI06NFW8154722,82,26,23,3,1
SBI83HWC1501614,78,27,20,7,1
SBI87PUD5918737,91,27,19,8,1
SBI14GZA5239526,72,22,21,1,1
SBI98GIT0410287,60,20,17,3,1
SBI59DRU2203580,22,32,24,8,1
SBI53CUP6335728,67,26,14,12,1
SBI52QFN9968021,70,22,14,8,1
SBI25GJR8288451,71,17,14,3,1
SBI29CYP9978754,18,16,10,6,1
SBI87GYB6907249,93,33,28,5,1
SBI12HJG9924266,74,24,20,4,1
SBI44SKA3021360,25,26,21,5,1
SBI47YYG2729342,85,26,23,3,1
SBI23UYN7034907,19,21,19,2,1
SBI69WVW8222635,63,32,23,9,1
SBI31IYG0792550,75,27,14,13,1
SBI15JLP7305446,93,28,26,2,1
SBI13RNT3745117,65,27,22,5,1
SBI91CJY6684311,18,18,12,6,1
SBI05ZAS0514344,80,17,12,5,1
SBI79GEP2443536,68,23,12,11,1
SBI47RPD2464393,96,30,26,4,1
SBI57QRF7406239,96,16,10,6,1
SBI09PXC2196428,79,23,15,8,1
SBI11IJG8293407,70,35,34,1,1
SBI64MKM1274298,93,23,20,3,1
SBI99SLM4977097,85,28,23,5,1
SBI81YBC5733219,66,20,16,4,1
SBI10VMS7468856,25,31,21,10,1
SBI58FGF6447909,77,33,28,5,1
SBI65WLZ3044153,98,16,15,1,1
SBI82FHJ0088557,74,20,17,3,1
SBI85GSW0677960,96,18,17,1,1
SBI69FJF4843236,18,16,9,7,1
SBI83GAP7781679,76,26,15,11,1
SBI95XEL4653673,78,25,14,11,1
SBI12AOV7751163,66,33,21,12,1
SBI63TMO3031565,72,20,19,1,1
SBI15ANA4189022,80,27,24,3,1
SBI15CZM2957278,60,24,15,9,1
SBI30HHO9584740,93,33,21,12,1
SBI02UNQ7392694,20,21,14,7,1
SBI86CIT5918794,86,24,21,3,1
SBI92HOW6339347,18,25,13,12,1
SBI30RJN1618068,60,26,14,12,1
SBI83EMW0576593,84,29,23,6,1
SBI10DKP6919122,75,21,19,2,1
SBI62BXS4941707,78,22,16,6,1
SBI12KOT2132047,78,16,12,4,1
SBI87ZOX0622906,86,27,20,7,1
SBI48BKT0519586,20,24,19,5,1
SBI41VBM7851667,25,35,32,3,1
SBI59WFA3606813,95,23,14,9,1
SBI71HOW5307447,82,33,24,9,1
SBI58AJB6444507,22,29,24,5,1
SBI31KLY5887924,22,24,15,9,1
SBI67QBW4217022,18,21,17,4,1
SBI93PRH0433587,95,29,26,3,1
SBI25QAT8516956,25,31,17,14,1
SBI34FYT4086668,67,25,20,5,1
SBI76IDV5478828,79,28,27,1,1
SBI98HQM8160809,88,27,25,2,1
SBI09QQX3949605,68,26,24,2,1
SBI60JFY7284606,63,32,30,2,1
SBI98WFZ2136298,93,29,19,10,1
SBI07ASA4474586,79,25,19,6,1
SBI47TNZ2033921,83,25,21,4,1
SBI92PJG9692190,64,36,30,6,1
SBI94JZA3133467,78,25,14,11,1
SBI47OHC2690271,75,27,19,8,1
SBI45IPV6338999,69,27,16,11,1
SBI13ABJ6691760,61,18,10,8,1
SBI11RPA8199923,79,25,16,9,1
SBI58BKF7114790,92,25,17,8,1
SBI13CEU4862279,85,34,31,3,1
SBI24FHP3908403,66,18,14,4,1
SBI94BZR3077832,19,26,14,12,1
SBI84ZSB7926185,93,29,26,3,1
SBI31YGN2376393,76,23,20,3,1
SBI59GIA1816020,82,23,15,8,1
SBI24TXI0966705,79,30,25,5,1
SBI76UDN4984850,73,34,27,7,1
SBI78RLV4537253,63,21,17,4,1
SBI63VOA2376687,74,34,21,13,1
SBI69IBZ3404144,62,20,14,6,1
SBI15CCR8796137,60,29,15,14,1
SBI97FUJ8218751,86,28,27,1,1
SBI02UYO1263983,79,25,15,10,1
SBI31AXG0104761,71,24,20,4,1
SBI77KIS0433606,19,21,16,5,1
SBI59ZVH6122807,83,22,17,5,1
SBI91XWH1668709,24,25,15,10,1
SBI56KKF5112285,20,31,26,5,1
SBI28APZ5030957,61,26,16,10,1
SBI29YYU2850053,79,28,18,10,1
SBI89ZJB7016567,84,26,24,2,1
SBI61QAU1776778,64,22,18,4,1
SBI04TXT9052082,90,32,19,13,1
SBI31YOF6423921,25,26,24,2,1
SBI28PNL2427912,94,29,21,8,1
SBI85EGT9181895,65,30,20,10,1
SBI24ENN0679066,64,18,16,2,1
SBI45LWY2532339,65,28,19,9,1
SBI88IEA0203924,20,18,12,6,1
SBI86VAQ7238559,62,21,12,9,1
SBI49SWB7500070,69,25,19,6,1
SBI29NZK9025267,23,22,14,8,1
SBI95ORF5234624,88,24,15,9,1
SBI87VJT5183986,69,30,25,5,1
SBI08XPL0113052,62,29,16,13,1
SBI84CLO9530193,95,24,13,11,1
SBI18QVU8831386,93,29,26,3,1
SBI34AQB4445535,18,31,21,10,1
SBI58AMB4281600,71,25,16,9,1
SBI72THO6691166,95,18,15,3,1
SBI43GWT1154069,18,20,14,6,1
SBI50MPM8151492,76,23,22,1,1
SBI41SQH6594947,60,17,14,3,1
SBI87LFO7807340,71,23,13,10,1
SBI30RUC8092601,97,36,33,3,1
SBI14EAV1046302,75,26,22,4,1
SBI05OBL2494766,21,23,19,4,1
SBI94QTM9179183,85,26,24,2,1
SBI33FKU9771743,67,30,22,8,1
SBI00OWR2398179,86,18,13,5,1
SBI51DED6758214,87,29,22,7,1
SBI66QQC8048058,74,27,26,1,1
SBI37NTP1436114,73,23,18,5,1
SBI96WWL5949864,69,22,12,10,1
SBI51LHI8444455,83,20,17,3,1
SBI67GGJ3037697,78,22,13,9,1
SBI32NYX4213907,90,25,22,3,1
SBI75CRA5784612,21,16,11,5,1
SBI12JGL3713455,21,25,14,11,1
SBI05RYF4664168,73,25,21,4,1
SBI88MVY8766912,83,28,19,9,1
SBI99YMQ4353066,67,23,18,5,1
SBI51EBF3404309,71,21,16,5,1
SBI66HWO4307735,84,31,20,11,1
SBI88QNO1577464,23,18,10,8,1
SBI57GLE2895299,82,28,26,2,1
SBI26EYM0651108,18,26,21,5,1
SBI14VGR9292423,65,25,16,9,1
SBI88BEO0712697,64,17,16,1,1
SBI07EZZ1558059,20,20,16,4,1
SBI61YLR5321915,62,25,13,12,1
SBI50XQW6385403,89,23,18,5,1
SBI97GEC0966294,73,23,20,3,1
SBI47GLJ4182918,77,24,18,6,1
SBI50GSI1245418,62,27,17,10,1
SBI08TII9103375,93,23,16,7,1
SBI07UOZ4303166,92,25,16,9,1
SBI64GOI8024938,65,24,23,1,1
SBI07FNL7503897,18,29,23,6,1
SBI19CKR8824952,25,26,23,3,1
SBI74DDP5443806,80,27,24,3,1
SBI66JJK8217427,97,31,29,2,1
SBI61PQJ5999084,67,21,13,8,1
SBI07IDK5067327,66,19,15,4,1
SBI12OBT3116359,22,22,14,8,1
SBI76DDS4690709,88,30,25,5,1
SBI23NOR2732406,85,20,17,3,1
SBI82NSX4147487,70,27,16,11,1
SBI58YKJ4457929,61,32,21,11,1
SBI21EKL6487879,79,20,19,1,1
SBI33LQU8662556,94,18,13,5,1
SBI31FQL2898207,74,24,16,8,1
SBI85JKA8030766,22,30,24,6,1
SBI14WQY5963636,92,28,21,7,1
SBI76QRP2462532,22,24,19,5,1
SBI60WUV3191682,20,23,13,10,1
SBI26HAP7960447,86,26,21,5,1
SBI32HQN9617008,92,30,20,10,1
SBI12AGV4975926,71,25,16,9,1
SBI78PQW7061705,77,17,14,3,1
SBI89HDF2117631,78,19,10,9,1
SBI02HDN8085198,98,21,13,8,1
SBI49OMP4558748,82,22,17,5,1
SBI94TEM9973101,25,24,21,3,1
SBI28CDV1596444,98,29,27,2,1
SBI19YEV2470354,94,19,13,6,1
SBI36KRY9504671,77,20,19,1,1
SBI76WDH7919859,99,31,22,9,1
SBI51EWJ5613793,63,28,27,1,1
SBI18IIP3651338,81,30,21,9,1
SBI62CVN3302286,21,19,11,8,1
SBI15PWS0622428,24,21,13,8,1
SBI11QAE3307642,62,30,16,14,1
SBI72ZMF6072376,80,27,19,8,1
SBI49MZK1425441,91,24,20,4,1
SBI68HBF4230314,25,21,16,5,1
SBI76FLU0125882,61,24,18,6,1
SBI15CSS8550017,93,32,25,7,1
SBI01VRC8935399,98,29,24,5,1
SBI05DUU0737355,75,19,12,7,1
SBI97OIX3024002,71,34,25,9,1
SBI78PMS9229928,84,28,18,10,1
SBI64NLP9952298,23,31,21,10,1
SBI15CON6797970,79,16,11,5,1
SBI46FPF3704396,99,19,14,5,1
SBI70ZMD5852658,91,23,19,4,1
SBI58LKH2017528,87,27,18,9,1
SBI20ZSP4271512,24,18,17,1,1
SBI81DMZ8774396,60,28,23,5,1
SBI99WOY2365742,60,26,15,11,1
SBI75AGQ4456898,61,31,16,15,1
SBI03OSC3933959,82,23,22,1,1
SBI87NZL1485972,77,21,19,2,1
SBI91JBC0584080,78,19,11,8,1
SBI57VEX7233664,21,14,8,6,1
SBI03FWZ2496345,74,24,19,5,1
SBI25QIM3192888,99,35,28,7,1
SBI70ZRY7182140,75,26,15,11,1
SBI29AJE9308832,74,28,17,11,1
SBI13IKT9923659,22,26,16,10,1
SBI71GFB4395914,64,22,21,1,1
SBI35BTH6804937,97,22,12,10,1
SBI95KUX9775547,65,26,14,12,1
SBI60OCV4837325,68,29,20,9,1
SBI61COV6068043,25,28,17,11,1
SBI50SSC9812792,96,32,31,1,1
SBI43JLC3629571,85,17,12,5,1
SBI19JOC2750386,87,17,16,1,1
SBI50CRP7963442,81,24,17,7,1
SBI40ARB3309803,93,19,15,4,1
SBI90XHJ9564177,76,22,21,1,1
SBI82UIX5498273,80,18,17,1,1
SBI52VKL4187004,78,27,17,10,1
SBI81SRA0627110,82,28,25,3,1
SBI08SOK4287696,83,27,22,5,1
SBI34ROW5572107,71,22,16,6,1
SBI93ACL3144116,84,24,14,10,1
SBI31OKB6530622,18,32,30,2,1
SBI33KFQ4589978,77,28,27,1,1
SBI11YYK7800715,61,21,16,5,1
SBI19NQD9192109,90,22,13,9,1
SBI93QUP1385394,68,17,11,6,1
SBI31WEP4446630,64,27,20,7,1
SBI70UQY4858315,89,21,17,4,1
SBI27SIR6832728,93,15,11,4,1
SBI04NQZ5851870,97,41,23,18,1
SBI76JZA9866585,81,19,14,5,1
SBI84LZU6071174,77,30,20,10,1
SBI64BKS6590619,67,19,14,5,1
SBI23IZI3077365,61,25,23,2,1
SBI32PSF5009097,25,25,19,6,1
SBI80VPL2421814,99,18,16,2,1
SBI01FXW2610962,78,19,17,2,1
SBI32KFD9399293,71,26,18,8,1
SBI95SYV6214589,79,18,13,5,1
SBI63UDJ9577556,97,28,20,8,1
SBI91LDG3719717,21,17,15,2,1
SBI61GFW3594762,18,30,26,4,1
SBI04ZMT5836569,23,25,24,1,1
SBI87TPG4340123,69,19,15,4,1
SBI02KQQ7485428,71,30,23,7,1
SBI78VRC7066993,71,30,27,3,1
SBI15JGD1716707,73,30,22,8,1
SBI50YRE1855706,92,20,16,4,1
SBI89LNQ9036374,68,24,19,5,1
SBI98ISF5712114,25,28,17,11,1
SBI99UOG0182965,60,23,14,9,1
SBI58WJG8469920,65,25,21,4,1
SBI81FHP6795169,99,19,11,8,1
SBI76BNH4202396,75,19,13,6,1
SBI29VAT5700663,65,29,18,11,1
SBI83UKM5797238,87,33,30,3,1
SBI32MYO8632306,68,23,13,10,1
SBI85FJH6063112,91,24,19,5,1
SBI49EOU7121754,19,40,22,18,1
SBI27MDI8534397,23,25,18,7,1
SBI32XLG2415628,89,27,20,7,1
SBI16AGE6281174,69,23,20,3,1
SBI45TXV8282462,72,24,20,4,1
SBI81OCH7088247,20,19,15,4,1
SBI66QBE0213401,75,24,20,4,1
SBI21VVS9592693,90,23,15,8,1
SBI39PSA6496889,68,28,23,5,1
SBI97MXT2429575,19,33,25,8,1
SBI68NDL2747180,78,23,19,4,1
SBI15CPV4465219,92,20,18,2,1
SBI92RBH6674896,24,21,19,2,1
SBI45HAP0096468,91,26,22,4,1
SBI77BRR2367864,98,11,6,5,1
SBI06XKO0691663,91,20,19,1,1
SBI02HAO0942205,61,23,16,7,1
SBI01BYX3353255,84,26,22,4,1
SBI55UVF7962312,86,30,17,13,1
SBI15EYE4390905,82,17,9,8,1
SBI82MCX3392776,98,15,14,1,1
SBI67NOW8731469,65,27,25,2,1
SBI81ZZV5048564,75,14,11,3,1
SBI09LZD1115702,62,23,19,4,1
SBI64GYT5643800,67,35,30,5,1
SBI22IQG4209273,18,22,17,5,1
SBI01YVC4362637,61,25,21,4,1
SBI83ZIY3994694,98,26,24,2,1
SBI72NEW2017575,81,21,18,3,1
SBI55VIN0302059,73,25,13,12,1
SBI06SNC3832425,72,27,26,1,1
SBI38RDU7434772,74,27,14,13,1
SBI01RPG9999872,67,30,18,12,1
SBI56ZEO6982678,23,28,18,10,1
SBI73WES4188424,22,29,24,5,1
SBI19NGD3099019,71,12,8,4,1
SBI98MWP6718071,79,20,13,7,1
SBI33MCS3255688,94,26,23,3,1
SBI18BZQ3783643,70,21,14,7,1
SBI72RBI2938176,99,29,27,2,1
SBI71HBZ4406002,21,21,16,5,1
SBI63ZEI1256360,88,37,31,6,1
SBI63KTX1975869,99,15,13,2,1
SBI20JDM1791551,25,14,8,6,1
SBI95IGJ2150443,84,31,28,3,1
SBI30ZTP2397123,86,35,18,17,1
SBI01YFI6794374,88,25,14,11,1
SBI22XOQ2141738,19,24,23,1,1
SBI18ZBB6119797,22,30,20,10,1
SBI76WXE3406685,19,30,28,2,1
SBI39DGP3941918,79,36,22,14,1
SBI44IAY1744772,73,23,18,5,1
SBI92ZMT6777434,77,27,19,8,1
SBI84INM0009345,82,26,25,1,1
SBI30CON0276940,86,22,20,2,1
SBI05SSM9910853,74,22,16,6,1
SBI79GKU5434083,62,21,18,3,1
SBI62NPX3936130,72,28,21,7,1
SBI72YKU9335901,20,22,19,3,1
SBI57USW4029622,62,29,22,7,1
SBI78IUY6645757,86,29,27,2,1
SBI93MTS2576112,92,25,13,12,1
SBI65GGF3927743,91,22,19,3,1
SBI98GKK5353542,73,26,14,12,1
SBI08RZK0348714,60,31,22,9,1
SBI60UNM5437260,67,19,15,4,1
SBI43BQG4373955,96,27,21,6,1
SBI70MYL0821460,22,22,21,1,1
SBI91BMM6235244,68,25,19,6,1
SBI64GJV3653637,65,23,18,5,1
SBI64HFJ3071672,85,30,23,7,1
SBI22CON4918945,88,29,26,3,1
SBI13GYI8370673,25,20,19,1,1
SBI24UGG4133662,24,19,10,9,1
SBI73CID8176142,65,20,19,1,1
SBI23SRI4954715,87,30,22,8,1
SBI80NQZ1902119,95,19,17,2,1
SBI24TNO4573911,77,25,23,2,1
SBI86HYP8768677,77,24,15,9,1
SBI62MHT9123922,18,24,13,11,1
SBI98KIW7820316,69,30,26,4,1
SBI51KZH0708673,80,22,19,3,1
SBI27ZHB9509837,90,24,20,4,1
SBI50HBU0320252,72,20,14,6,1
SBI11LZR1406520,88,29,25,4,1
SBI55ZNO2213946,73,20,11,9,1
SBI32PPY1291109,74,23,12,11,1
SBI04KUO5505485,92,20,15,5,1
SBI47CHH5704075,83,23,19,4,1
SBI52XBT1408326,86,24,21,3,1
SBI23LXF4347591,65,16,13,3,1
SBI28ZFQ6343421,88,30,21,9,1
SBI14CUI3988045,84,31,23,8,1
SBI58MOD4313701,69,25,23,2,1
SBI68FAG7396662,81,14,10,4,1
SBI04VEX4572037,93,24,21,3,1
SBI68KMT4077965,21,23,21,2,1
SBI40ATS1097988,77,15,8,7,1
SBI55DLT9442296,19,27,22,5,1
SBI32RVX3520202,96,23,21,2,1
SBI00OGH1950532,85,34,32,2,1
SBI14TCJ6254679,90,17,16,1,1
SBI41CCW2722316,18,25,13,12,1
SBI08YPL0364360,90,18,10,8,1
SBI58LZF9449207,85,21,20,1,1
SBI93WHK1459056,24,25,22,3,1
SBI82GHO4584606,90,25,21,4,1
SBI98LSB8588269,65,22,21,1,1
SBI25IRS3358942,95,25,23,2,1
SBI43NCE8321218,77,27,14,13,1
SBI34ZRN2109113,69,26,15,11,1
SBI37YMX6166700,98,31,16,15,1
SBI21QYO0409792,99,32,27,5,1
SBI63RLH9760270,21,20,14,6,1
SBI80GFQ2924619,68,26,19,7,1
SBI25VFJ0058584,61,25,14,11,1
SBI08DVZ8758572,61,22,16,6,1
SBI25HLS6722056,76,24,19,5,1
SBI61NRY0340256,63,24,13,11,1
SBI74CDW5390004,22,30,22,8,1
SBI23BMA7450124,61,27,19,8,1
SBI23PGY1429480,83,26,20,6,1
SBI17MQV5215835,84,20,11,9,1
SBI88FCA0422886,91,28,17,11,1
SBI11KTO3416756,62,32,30,2,1
SBI69EFS0836987,99,28,25,3,1
SBI17XVS5483251,72,18,12,6,1
SBI40JBG7152658,62,27,17,10,1
SBI76POL5080714,81,19,11,8,1
SBI38QJI5270720,61,22,12,10,1
SBI79KRN9781135,92,21,14,7,1
SBI83ADZ4377075,78,29,26,3,1
SBI67NNV2882699,89,18,14,4,1
SBI10DAI6607854,90,34,22,12,1
SBI94ISR7311696,86,26,17,9,1
SBI69HDO3231750,91,24,20,4,1
SBI18AOO8959699,19,22,17,5,1
SBI56UAA3366619,77,20,18,2,1
SBI35USH1418922,20,27,25,2,1
SBI95YHO6990095,69,21,17,4,1
SBI35IZG5099505,63,23,22,1,1
SBI45EAJ8865390,18,39,32,7,1
SBI70UHD5385423,72,31,20,11,1
SBI41NBF9195031,85,23,15,8,1
SBI94SXS4504846,89,19,11,8,1
SBI26VHR4081122,82,35,32,3,1
SBI95WPC4066232,87,30,20,10,1
SBI94HGA2801846,23,22,17,5,1
SBI55YJE4887872,84,31,26,5,1
SBI40JMN0108638,69,15,12,3,1
SBI76RFH8647374,90,21,19,2,1
SBI64JXK4943949,91,29,23,6,1
SBI07TBE7916189,95,25,18,7,1
SBI29LZO4955541,70,24,14,10,1
SBI31ZNR0964088,76,26,19,7,1
SBI00ZUO0107071,80,29,19,10,1
SBI07ZJX2336372,84,28,21,7,1
SBI63MRT6493714,22,24,23,1,1
SBI02AEE1192126,96,24,22,2,1
SBI91YYH5035707,89,21,12,9,1
SBI42NWT0031882,97,20,14,6,1
SBI55GHK4195626,65,29,18,11,1
SBI89MWF6376312,79,24,18,6,1
SBI08WQC8789870,96,20,12,8,1
SBI06EDN4254708,73,23,21,2,1
SBI22GFF0068980,88,23,22,1,1
SBI46DJS0716682,78,26,15,11,1
SBI70IYT8881978,95,29,20,9,1
SBI86OFP7128844,99,29,25,4,1
SBI16JDF5066613,80,22,19,3,1
SBI62ZLO3458293,62,25,14,11,1
SBI00YUD3100759,24,23,17,6,1
SBI90MXD9308709,21,20,17,3,1
SBI65CVC8139703,62,25,15,10,1
SBI09EIN2856349,21,16,10,6,1
SBI27FUU8028764,98,21,17,4,1
SBI79NUY8131813,83,28,19,9,1
SBI34FAV9261680,65,21,16,5,1
SBI29OSZ6371461,79,24,15,9,1
SBI43IQG3089918,71,30,24,6,1
SBI28MXJ2591687,89,23,19,4,1
SBI56ALS2371918,25,29,24,5,1
SBI45LMI1511078,61,28,19,9,1
SBI33XXV8661567,67,24,21,3,1
SBI54OOE1749112,64,21,13,8,1
SBI02JWG8725497,87,25,17,8,1
SBI93SDN1357521,65,20,15,5,1
SBI15NIG4541498,19,19,16,3,1
SBI51MEG8345893,72,26,15,11,1
SBI24QZU9279769,93,21,17,4,1
SBI80MNK8722320,20,24,13,11,1
SBI16EWI6569754,19,28,21,7,1
SBI18LLQ4547210,80,39,32,7,1
SBI66SCO6463009,68,22,16,6,1
SBI50LMO0426624,87,24,13,11,1
SBI11ATV6859130,25,30,22,8,1
SBI78AQI2243943,71,33,28,5,1
SBI46PMN4156622,82,32,23,9,1
SBI15XRZ8068964,60,25,23,2,1
SBI45PFB8967537,81,19,14,5,1
SBI45FPO9545118,82,26,22,4,1
SBI97WQW3776143,72,29,25,4,1
SBI65TVL0902214,76,25,19,6,1
SBI92XRT0866261,87,34,31,3,1
SBI79IEI9754015,20,20,13,7,1
SBI26JLJ1795910,96,25,24,1,1
SBI55XPI9684539,75,19,10,9,1
SBI13TER1563347,61,33,28,5,1
SBI29ZYW8547784,92,20,16,4,1
SBI32KGQ0506901,19,24,18,6,1
SBI42QSC1728700,19,21,18,3,1
SBI03RQT7126303,81,27,23,4,1
SBI58OCK9012752,68,19,14,5,1
SBI20KXK8827798,25,28,19,9,1
SBI36QPN3778006,65,20,12,8,1
SBI28OEB1706595,60,25,13,12,1
SBI28OBF5617564,93,19,13,6,1
SBI73WSL0963441,67,29,24,5,1
SBI24PDB2181978,18,30,23,7,1
SBI41WQJ2306883,67,19,18,1,1
SBI41ZYS9057668,89,21,18,3,1
SBI35XHZ7857946,83,24,15,9,1
SBI58SDD7454934,89,17,11,6,1
SBI22UGQ1061420,77,21,18,3,1
SBI59GGH0881632,64,25,16,9,1
SBI74XXE5452257,90,16,13,3,1
SBI30JRO4508509,94,24,16,8,1
SBI39MZR1202059,69,19,14,5,1
SBI57LJY3013455,85,26,16,10,1
SBI40NZU0959050,67,26,23,3,1
SBI79ZGO0577388,76,24,22,2,1
SBI00XRF4177216,83,24,21,3,1
SBI84GUA8779825,85,22,12,10,1
SBI12CAH6466682,77,27,22,5,1
SBI54FZT7235105,60,17,9,8,1
SBI14AOT1951884,64,22,18,4,1
SBI80WJN3136500,98,24,20,4,1
SBI18FTK4429376,70,30,18,12,1
SBI32LEU7099801,63,22,19,3,1
SBI80GIZ8719749,18,28,20,8,1
SBI54UOZ3655301,99,21,11,10,1
SBI28TDX0492513,18,31,29,2,1
SBI12GBU1527204,75,21,17,4,1
SBI43HAD2310815,77,21,14,7,1
SBI21ARA3805742,83,28,22,6,1
SBI47LOE8856684,89,29,19,10,1
SBI56BQD9111082,74,32,25,7,1
SBI63SXX9002263,64,25,20,5,1
SBI97BAZ4298439,68,29,15,14,1
SBI18FXI4650572,93,28,27,1,1
SBI93HXD8338097,81,26,16,10,1
SBI76HOI4359505,78,26,25,1,1
SBI04OYI9252882,64,15,12,3,1
SBI44XBW5576029,79,21,18,3,1
SBI00IXG3283900,86,22,15,7,1
SBI54UCI5070846,80,20,13,7,1
SBI24EHN3181686,64,18,15,3,1
SBI87RRR9893881,19,21,13,8,1
SBI16KPC7680992,81,24,16,8,1
SBI57LEB7354237,91,20,11,9,1
SBI75VNX4683963,78,21,17,4,1
SBI46ABB6493307,79,20,12,8,1
SBI42TYZ4245225,73,16,14,2,1
SBI30EDM7734094,69,31,30,1,1
SBI33JAX7330821,92,22,14,8,1
SBI07CMM3012449,18,25,18,7,1
SBI08CRE2613112,82,16,10,6,1
SBI76DBX5998152,84,28,18,10,1
SBI71NVY2410965,23,22,15,7,1
SBI12SVP0831136,83,21,14,7,1
SBI84FNG7463290,79,15,10,5,1
SBI95UZW8731498,66,23,20,3,1
SBI38YGR9442277,98,27,24,3,1
SBI86JVQ0405645,64,22,13,9,1
SBI22ZXL9572775,62,22,17,5,1
SBI30ZTG5983898,69,21,11,10,1
SBI85UQH4553067,81,32,31,1,1
SBI05NWS6343745,97,26,21,5,1
SBI64YTZ9376264,23,20,11,9,1
SBI84XJZ6596837,84,23,21,2,1
SBI89TYD7032865,70,24,20,4,1
SBI99OGC5373779,72,23,13,10,1
SBI22XXY2407011,24,20,14,6,1
SBI07HIB9011981,89,32,23,9,1
SBI31FJU3585422,85,19,16,3,1
SBI43HJD5634787,67,31,23,8,1
SBI56ZVP9431964,88,19,17,2,1
SBI67SMC9236771,23,18,16,2,1
SBI98ESU2674864,92,28,27,1,1
SBI71QOO9197007,72,22,17,5,1
SBI73ZCF4059593,90,24,15,9,1
SBI81SZH8062414,88,20,14,6,1
SBI00TEL0294887,63,30,19,11,1
SBI84HQQ9618468,68,21,13,8,1
SBI56IFP1573665,77,25,16,9,1
SBI48IGT1400117,77,28,20,8,1
SBI83IJR2876587,75,26,24,2,1
SBI33CDH3186595,60,24,14,10,1
SBI32GKU1415885,85,33,19,14,1
SBI81GZI6805465,71,17,15,2,1
SBI12GFH3711565,83,32,23,9,1
SBI02RDQ1609400,69,26,19,7,1
SBI98ESY4515336,93,21,16,5,1
SBI96EGP2769998,87,21,17,4,1
SBI11NLE1943518,86,23,19,4,1
SBI64LBP0781110,68,24,14,10,1
SBI27LBM8192686,19,23,20,3,1
SBI84FJH5386067,67,23,15,8,1
SBI34UYD8694650,99,21,18,3,1
SBI67VSY8697229,84,30,26,4,1
SBI68FNH0255495,78,20,14,6,1
SBI35GKT8751665,89,23,17,6,1
SBI69MDG8663839,77,33,26,7,1
SBI22DLD7318659,70,14,9,5,1
SBI31YVG7453156,19,30,27,3,1
SBI95UWD9104487,96,34,32,2,1
SBI97CUG7502852,69,15,11,4,1
SBI75QEJ0252388,19,27,26,1,1
SBI32HSR9688627,83,27,20,7,1
SBI93AZQ7159844,67,26,18,8,1
SBI25VAP0340855,75,21,20,1,1
SBI45XQP9151040,68,22,12,10,1
SBI00UFJ3141484,25,25,15,10,1
SBI75ZDF1453805,71,28,26,2,1
SBI77RAI2759426,62,20,11,9,1
SBI89LHD2049825,62,26,23,3,1
SBI43CVP5889200,81,27,20,7,1
SBI91BTS0022477,64,28,17,11,1
SBI44FYY9450289,65,25,18,7,1
SBI13BKR7537879,92,30,18,12,1
SBI12HQF2045638,25,21,17,4,1
SBI17JPC5943070,69,25,23,2,1
SBI56FOE6385895,25,24,18,6,1
SBI82BLK2451863,79,23,16,7,1
SBI61IBY9901678,82,28,27,1,1
SBI78VMU9800969,94,29,27,2,1
SBI50WUP6601879,98,18,10,8,1
SBI91TXV7925135,96,27,18,9,1
SBI04GGH4846643,19,26,14,12,1
SBI83BTU9249166,80,31,19,12,1
SBI34ROF9254738,25,15,11,4,1
SBI77DHS0166754,25,22,18,4,1
SBI87ZIZ7962936,71,18,11,7,1
SBI23SIL1645065,71,27,26,1,1
SBI74YXA5186851,21,29,16,13,1
SBI36YOU2431920,61,19,12,7,1
SBI12OUR1588676,83,25,19,6,1
SBI98KSX3253608,87,27,16,11,1
SBI94ZOT8817603,91,17,15,2,1
SBI66GTW1281181,65,18,10,8,1
SBI95GNS7039094,68,28,18,10,1
SBI57XZG6246329,19,22,16,6,1
SBI64RAM2078933,83,24,15,9,1
SBI87KOK4493864,61,31,24,7,1
SBI38ZRR2629471,96,11,6,5,1
SBI08MOU2745511,66,32,28,4,1
SBI79IUH3898384,92,29,28,1,1
SBI29HCW9761799,71,24,21,3,1
SBI84CVK0202513,91,22,13,9,1
SBI05ADW8263849,70,24,15,9,1
SBI75JGF8972064,90,25,15,10,1
SBI38MPI4864033,96,24,18,6,1
SBI80BZD9088889,91,18,16,2,1
SBI10YBS9970607,24,27,24,3,1
SBI59KNN2935621,21,25,18,7,1
SBI13WYB9544250,91,19,16,3,1
SBI91VGZ1090799,88,25,24,1,1
SBI41CIZ0045489,79,19,14,5,1
SBI70OWR1304403,98,35,25,10,1
SBI72SVQ3389461,87,27,26,1,1
SBI81ZPE4623019,25,23,17,6,1
SBI55NJQ8283393,22,25,13,12,1
SBI01QEI7798934,60,30,20,10,1
SBI88FTH0284970,70,18,10,8,1
SBI08HCD3808515,24,30,24,6,1
SBI90TYC1627457,73,19,15,4,1
SBI32XGN4871204,91,20,13,7,1
SBI49MRY9714778,22,20,17,3,1
SBI12FKQ0008109,93,25,16,9,1
SBI87CJC5287530,95,22,19,3,1
SBI33DZH4833611,96,28,27,1,1
SBI32DYO0063058,89,25,19,6,1
SBI07TAK6591172,82,27,22,5,1
SBI66OSO1514679,62,28,20,8,1
SBI47YMB4847612,99,20,15,5,1
SBI09VOS0492582,76,22,19,3,1
SBI87ICA7171288,64,21,18,3,1
SBI29DYC6693123,92,23,15,8,1
SBI74BCD8098635,60,21,20,1,1
SBI17EWB9083008,23,31,22,9,1
SBI90MAL9021525,78,27,25,2,1
SBI46XYM7907053,96,19,14,5,1
SBI99LAA8269004,66,16,9,7,1
SBI97BIB1493950,18,21,13,8,1
SBI32EZI3526108,78,25,15,10,1
SBI63QJD1430961,67,19,13,6,1
SBI76PDY8450871,73,17,12,5,1
SBI68XRQ8939499,71,22,14,8,1
SBI54ZNJ9923218,83,29,25,4,1
SBI62NMC6201732,18,30,26,4,1
SBI92LEN3307379,20,14,11,3,1
SBI48PQY9121007,96,28,24,4,1
SBI27XTG5887533,74,22,18,4,1
SBI23UMY7217969,85,20,11,9,1
SBI75HUK5416283,19,28,27,1,1
SBI36NWF2715264,23,20,13,7,1
SBI40JXQ7166523,76,26,17,9,1
SBI57FHV0170570,69,22,21,1,1
SBI20JXT6931257,69,26,15,11,1
SBI41YRZ9171895,95,22,21,1,1
SBI09QLV8504006,64,33,25,8,1
SBI36FXJ5776569,91,15,10,5,1
SBI49EEV5198961,98,9,6,3,1
SBI28BFX6711817,20,18,14,4,1
SBI99RWH5418295,67,25,22,3,1
SBI55LTM7609069,72,26,17,9,1
SBI48HWJ0334098,63,33,27,6,1
SBI77FCX0088185,24,22,19,3,1
SBI61EXS8560222,90,17,10,7,1
SBI00TLJ4985871,67,23,21,2,1
SBI30TSA3664632,71,28,23,5,1
SBI18YVO3648951,19,32,20,12,1
SBI99NQJ3024224,62,24,13,11,1
SBI56KQC6537331,64,23,18,5,1
SBI15ZKK3079197,18,27,17,10,1
SBI63NFU7080466,79,26,21,5,1
SBI42MYU8673715,75,27,26,1,1
SBI44SBV5390950,76,17,13,4,1
SBI44UCU6215047,67,29,24,5,1
SBI17XLB3875639,98,17,15,2,1
SBI76PCY9667750,62,23,15,8,1
SBI57IAM7099138,68,26,22,4,1
SBI03PZU2795248,78,30,21,9,1
SBI38YWG9538074,85,25,19,6,1
SBI59MMV3932735,63,21,19,2,1
SBI74HLY9890645,83,21,13,8,1
SBI73PGC0808103,81,29,25,4,1
SBI40PGA2394956,87,23,15,8,1
SBI92GEN6619073,61,14,12,2,1
SBI93FVA1930929,90,22,15,7,1
SBI55DKC9448240,70,24,15,9,1
SBI62OTT3294558,66,26,19,7,1
SBI95MNV5891387,25,28,22,6,1
SBI55JGH9768266,95,34,24,10,1
SBI60QDX1775097,18,13,10,3,1
SBI64RSY0689995,75,30,21,9,1
SBI15GTP9186973,63,21,16,5,1
SBI58YGY8846277,71,24,23,1,1
SBI66LJX8044388,88,23,12,11,1
SBI43OVU6517576,88,30,17,13,1
SBI77ERS0963954,98,27,16,11,1
SBI63LME1866574,24,27,21,6,1
SBI01BHY0757160,88,23,15,8,1
SBI32YFC2877636,73,23,22,1,1
SBI27EOX7433295,78,22,16,6,1
SBI94XQY3029244,73,12,10,2,1
SBI53EVE2278963,76,27,14,13,1
SBI99WMP3310496,86,31,16,15,1
SBI54RRI2142984,78,21,14,7,1
SBI51JWM7679431,72,20,16,4,1
SBI17EIP3267607,72,23,22,1,1
SBI02JPD9863301,91,17,10,7,1
SBI61CYJ8617088,96,29,16,13,1
SBI32DJL9304824,77,24,21,3,1
SBI78XYC7754045,75,32,25,7,1
SBI14CSL3903300,81,28,22,6,1
SBI88KPU5733884,21,28,26,2,1
SBI29MRP3656677,90,23,13,10,1
SBI16RCP5133763,25,27,14,13,1
SBI14SPG6011890,89,26,21,5,1
SBI55XXK6676578,24,21,17,4,1
SBI38NSS9567664,72,23,21,2,1
SBI95BJY5256623,89,24,20,4,1
SBI77PVX6383944,83,25,24,1,1
SBI02FAQ7083007,66,29,22,7,1
SBI73ZHE8332427,94,28,26,2,1
SBI75SHQ4112783,25,18,15,3,1
SBI82ZUW9183501,66,25,20,5,1
SBI09WHQ3010839,67,34,25,9,1
SBI95HTU4922415,83,30,17,13,1
SBI33ZSI2884406,24,21,11,10,1
SBI10UBK8906770,71,16,14,2,1
SBI90AME7590498,82,21,13,8,1
SBI07LBB5279149,97,29,25,4,1
SBI47FTK1470268,20,23,19,4,1
SBI20BSP9033782,23,27,18,9,1
SBI87SVM3237489,90,22,13,9,1
SBI06AHO5502341,73,36,20,16,1
SBI58KYG4054629,92,27,17,10,1
SBI50JHV5856416,19,25,21,4,1
SBI29NTK1305872,83,25,15,10,1
SBI48QCO8492546,69,28,21,7,1
SBI27ZFA3186269,85,34,26,8,1
SBI17AGF8930005,98,28,18,10,1
SBI18TLQ0051308,65,30,22,8,1
SBI09QRO2453284,22,21,20,1,1
SBI90IRU2761774,99,25,21,4,1
SBI82JLP4016876,20,26,15,11,1
SBI93URZ5406953,95,17,12,5,1
SBI94SWY3740249,20,17,12,5,1
SBI89ZYQ3093210,75,13,12,1,1
SBI86MXC2099824,65,28,20,8,1
SBI82SAQ5668077,68,24,15,9,1
SBI19IUW1610102,86,23,16,7,1
SBI31CWY8376934,68,21,20,1,1
SBI13DYT9537131,69,25,24,1,1
SBI12GXS0860692,23,23,14,9,1
SBI10VCM3482055,89,22,14,8,1
SBI71NLG8045950,69,25,13,12,1
SBI90KLH7284839,87,25,18,7,1
SBI73QAO5711342,92,30,21,9,1
SBI89MYW9392875,97,29,26,3,1
SBI43SAV6711520,93,29,26,3,1
SBI66LQU6880777,84,25,22,3,1
SBI83FLX2569072,98,29,24,5,1
SBI84GWC7054154,85,28,15,13,1
SBI06IZS9437089,87,34,28,6,1
SBI06IBX0847498,73,22,20,2,1
SBI61TTB3977926,83,14,12,2,1
SBI66XVF3782571,78,23,17,6,1
SBI66DUR2028504,64,21,18,3,1
SBI34CYJ2640501,23,28,27,1,1
SBI35OJF9210301,60,28,23,5,1
SBI19HDR2765166,90,27,19,8,1
SBI69AOS0408766,85,35,29,6,1
SBI92UGL2555633,65,22,21,1,1
SBI53VNN8686656,69,22,20,2,1
SBI01BRY7823331,92,22,13,9,1
SBI67KRT1995539,70,21,11,10,1
SBI22WND7276361,81,19,10,9,1
SBI36AHU3313936,72,32,19,13,1
SBI19TAY7822552,67,22,12,10,1
SBI53FGZ5661838,73,33,24,9,1
SBI37CXX8593656,83,28,20,8,1
SBI69BXS8499445,87,25,16,9,1
SBI13QSH3265746,86,19,11,8,1
SBI51FDC3603191,86,26,25,1,1
SBI41YAH5095531,79,13,9,4,1
SBI52TYS3549598,68,24,22,2,1
SBI27YGG2597129,76,29,19,10,1
SBI70IEA7214354,72,25,17,8,1
SBI85YUF3821907,69,26,19,7,1
SBI28TUS6734872,74,22,18,4,1
SBI53BQZ8897121,69,21,20,1,1
SBI50JUC2253325,81,24,14,10,1
SBI95PLN8348264,66,23,14,9,1
SBI46ELD6509756,65,28,16,12,1
SBI59AWO0105654,77,16,14,2,1
SBI95VMQ2041692,87,24,18,6,1
SBI86ZNQ9275275,83,20,11,9,1
SBI47UNK7041522,22,27,22,5,1
SBI21VZQ6334001,86,20,14,6,1
SBI53BOF2490570,84,7,6,1,1
SBI69IYK1500750,21,19,11,8,1
SBI39CHA4504416,88,20,17,3,1
SBI16GNT7019231,79,25,14,11,1
SBI60NPC8953151,82,25,14,11,1
SBI94DZX4682614,98,24,15,9,1
SBI36DHY0867978,91,27,24,3,1
SBI59SHU2690083,60,23,15,8,1
SBI95XOB6853472,25,29,22,7,1
SBI55NIY0916762,93,26,25,1,1
SBI62YEK6115136,71,25,19,6,1
SBI01NTR8747368,89,23,12,11,1
SBI34TNF4916848,85,30,26,4,1
SBI89AFC2454968,67,29,24,5,1
SBI21LNN3056424,67,31,25,6,1
SBI60DYK1657373,19,23,14,9,1
SBI56XYJ1698029,83,21,20,1,1
SBI95YVB3380771,99,25,24,1,1
SBI15XBY2609343,84,25,18,7,1
SBI38ELC3587306,73,28,21,7,1
SBI10HIQ3524746,82,25,24,1,1
SBI45IDT5807269,97,28,18,10,1
SBI24EDB2607234,74,16,15,1,1
SBI14ZJR7055023,85,21,18,3,1
SBI36MIR7887422,96,28,23,5,1
SBI32UFM3622102,94,21,11,10,1
SBI86FMW6014281,18,23,22,1,1
SBI68TFM3188567,61,27,22,5,1
SBI50KXD3344904,62,27,17,10,1
SBI76ZMK8658048,98,22,20,2,1
SBI28OMX5743675,73,22,16,6,1
SBI36VXT6854944,68,23,18,5,1
SBI10PCX2787458,22,34,28,6,1
SBI20CCQ6577197,84,25,13,12,1
SBI57UVJ7219232,82,13,11,2,1
SBI00YSH7946557,69,24,23,1,1
SBI81FMO4071763,95,30,22,8,1
SBI24TMI9847271,84,22,21,1,1
SBI86KRK2848650,23,25,21,4,1
SBI63SGD9725985,83,25,21,4,1
SBI80NQZ8218035,81,26,19,7,1
SBI25IAD7394315,60,25,18,7,1
SBI76GCA6361822,84,18,15,3,1
SBI46IMZ5079011,90,22,19,3,1
SBI22HOK5991455,88,23,17,6,1
SBI29JCC6929611,92,23,17,6,1
SBI25TIP0321896,94,18,15,3,1
SBI07ZJL5261286,21,19,13,6,1
SBI12MRH3394961,20,23,14,9,1
SBI52CAF7350103,86,27,21,6,1
SBI67IJL3632853,93,27,17,10,1
SBI43VGP0361505,92,22,15,7,1
SBI10IYC8635654,88,27,19,8,1
SBI68JLM9206091,90,21,15,6,1
SBI11KRW5453529,64,24,14,10,1
SBI07WNS7637163,74,26,24,2,1
SBI43DEY4678491,91,28,27,1,1
SBI33PRU4441740,78,29,25,4,1
SBI88XOQ5932637,62,29,17,12,1
SBI45GHV9697123,96,22,15,7,1
SBI77DII6320305,21,26,15,11,1
SBI10CEO7004690,70,32,27,5,1
SBI22HVT4483510,18,23,17,6,1
SBI39ZAS7615339,85,25,14,11,1
SBI55NVU4606141,94,24,17,7,1
SBI73ATW8128397,97,21,17,4,1
SBI30IAK9805760,88,17,15,2,1
SBI21BUN8674160,72,28,23,5,1
SBI54ISG0185608,19,27,23,4,1
SBI08XUC5758323,18,32,25,7,1
SBI36BZD5985923,82,23,20,3,1
SBI12HKC7120252,95,17,16,1,1
SBI23YWV2034402,79,24,14,10,1
SBI33UKW4261350,88,19,10,9,1
SBI81TWE3681427,21,30,23,7,1
SBI27AZI3673192,62,29,28,1,1
SBI15GHL5434573,21,24,14,10,1
SBI80IZU6076712,77,30,23,7,1
SBI92MKM3910107,77,29,18,11,1
SBI47TLC5682056,73,28,21,7,1
SBI26NUM6227180,77,13,8,5,1
SBI40VLT0538069,88,30,26,4,1
SBI26ITL5113864,93,23,19,4,1
SBI78KBI0467213,84,19,10,9,1
SBI63UDO6640085,61,27,25,2,1
SBI80VGT4971592,24,23,12,11,1
SBI18LWR7190448,95,33,29,4,1
SBI03VRJ8634065,24,25,19,6,1
SBI94IPL3665396,86,19,15,4,1
SBI54ISZ5819115,18,24,20,4,1
SBI18OMV4943257,69,23,12,11,1
SBI58UZC9216239,80,22,17,5,1
SBI42MCH1302486,78,21,18,3,1
SBI42RQT9883126,83,22,16,6,1
SBI17UUG6621331,18,38,34,4,1
SBI57XAJ5093699,92,19,11,8,1
SBI53UAX5974871,67,30,24,6,1
SBI56GFP4227082,69,27,24,3,1
SBI09DPK0860618,20,25,21,4,1
SBI40GAC7744954,91,21,14,7,1
SBI05TZP7057597,18,23,18,5,1
SBI00EKO2813229,72,22,17,5,1
SBI79XKL7045338,18,30,25,5,1
SBI40TQO0614352,19,21,16,5,1
SBI43GCC1739887,87,29,17,12,1
SBI98ESP7281205,83,18,14,4,1
SBI45EVH9676456,91,26,25,1,1
SBI60GSU6318259,18,25,18,7,1
SBI06LVT1105111,65,29,17,12,1
SBI95RYG9602703,78,25,19,6,1
SBI24FTS4664504,75,33,32,1,1
SBI61VMS3500903,86,29,26,3,1
SBI26FIP1068122,75,22,12,10,1
SBI33LGI1268491,84,30,17,13,1
SBI70TCH4380995,65,29,18,11,1
SBI04OHR6537819,64,26,14,12,1
SBI22GFZ6246771,23,22,12,10,1
SBI08FJD6818332,82,25,17,8,1
SBI65KPS7724548,99,26,18,8,1
SBI68RAH7473714,69,22,19,3,1
SBI86BXX6842581,23,22,13,9,1
SBI25IGZ5255219,86,26,18,8,1
SBI21MLJ1364563,19,28,25,3,1
SBI30IYB1331946,67,23,21,2,1
SBI57BNH7651578,94,30,28,2,1
SBI10OZA1671938,80,29,19,10,1
SBI06KDN3307063,70,26,22,4,1
SBI02XWV4113553,20,24,17,7,1
SBI69YYM7431397,68,30,19,11,1
SBI12PFE2742374,20,20,15,5,1
SBI04EFN1931123,94,37,19,18,1
SBI98ETD2110285,86,21,20,1,1
SBI76PVG4574966,71,27,22,5,1
SBI43PJE9791818,87,23,21,2,1
SBI87VGB3229625,81,20,15,5,1
SBI43KUN7885671,96,28,17,11,1
SBI89ITB9718373,69,31,23,8,1
SBI28CMJ4558083,98,22,16,6,1
SBI22VSU7901703,86,22,18,4,1
SBI90CAN0236750,65,26,18,8,1
SBI97OIL8400572,74,30,20,10,1
SBI09LFP2360098,61,23,15,8,1
SBI49HMA5848792,77,29,17,12,1
SBI56EZU7995946,75,26,14,12,1
SBI44KUB9917947,75,19,17,2,1
SBI36PPC1831232,62,21,11,10,1
SBI22NBP8804046,69,17,11,6,1
SBI16BZZ1017498,68,24,20,4,1
SBI97VZZ1771518,65,27,23,4,1
SBI73WWM6816698,22,21,13,8,1
SBI24CDR3863309,80,26,17,9,1
SBI26NLN4055048,91,24,23,1,1
SBI79ZON1754569,64,30,17,13,1
SBI82AOL3056490,78,22,20,2,1
SBI69RKL2019482,98,32,21,11,1
SBI81WJO4490972,68,32,17,15,1
SBI55IFW0550502,98,26,25,1,1
SBI64LEU7585140,76,35,34,1,1
SBI38IPC7096603,71,33,22,11,1
SBI78NMO7102297,70,18,17,1,1
SBI77VCL3910513,73,24,21,3,1
SBI65PAH4540364,19,21,19,2,1
SBI09XUF6907594,71,20,11,9,1
SBI38YAQ0432941,97,27,18,9,1
SBI78REJ6229358,85,27,23,4,1
SBI84SXF1687083,22,21,13,8,1
SBI43UOR7553619,99,19,18,1,1
SBI81GXP8854537,64,13,9,4,1
SBI70DVS7523281,75,13,8,5,1
SBI47FPQ3054312,19,22,14,8,1
SBI76BPA8214276,69,32,31,1,1
SBI24ZHZ3897159,92,18,13,5,1
SBI85CSM7501259,23,19,10,9,1
SBI11MMH0138633,81,26,14,12,1
SBI37FJC6615420,71,26,14,12,1
SBI81DLI8842603,74,28,19,9,1
SBI55BYH5395802,90,25,18,7,1
SBI15OWS1193844,65,25,16,9,1
SBI10KYD3229217,75,25,15,10,1
SBI44FRG5918834,62,24,21,3,1
SBI82XTC1829669,67,21,15,6,1
SBI18PSG7848540,23,32,30,2,1
SBI86RWW9789744,62,24,17,7,1
SBI37WPX1414941,74,23,15,8,1
SBI63GDX8677948,76,24,21,3,1
SBI16MJB2929698,77,29,21,8,1
SBI48QYR5211522,64,27,16,11,1
SBI97KNG2314569,80,28,22,6,1
SBI70VOT2350862,90,23,12,11,1
SBI60BEH9471248,94,25,19,6,1
SBI08PTN6481954,21,37,31,6,1
SBI80VAM9932693,77,22,18,4,1
SBI68BAZ4498118,85,16,15,1,1
SBI93BYS8188907,73,22,14,8,1
SBI00DCZ5306591,96,24,22,2,1
SBI14OCA7736327,76,20,18,2,1
SBI83EUA9265619,19,25,23,2,1
SBI52XWG6118555,77,24,16,8,1
SBI63PUA7165567,84,23,20,3,1
SBI57VNT0790094,74,27,14,13,1
SBI07CIX8090194,85,24,15,9,1
SBI75YHC4657840,74,25,19,6,1
SBI44OYP4556024,71,27,22,5,1
SBI82TPC1110018,76,23,13,10,1
SBI57IVU4438079,22,24,19,5,1
SBI69TZP3684861,69,28,16,12,1
SBI36MAO7273650,70,25,19,6,1
SBI27WIT1267293,77,21,20,1,1
SBI04OGJ5168149,65,19,18,1,1
SBI53FCV8469461,22,25,18,7,1
SBI11DQY9834871,68,21,15,6,1
SBI65PPB2729605,83,24,15,9,1
SBI67LUM5057024,94,8,5,3,1
SBI87OAL1336334,98,15,8,7,1
SBI36YVV5171866,71,22,15,7,1
SBI66AIC6182402,92,29,25,4,1
SBI02HJS7503126,93,24,14,10,1
SBI12LAP9863856,99,26,15,11,1
SBI69KIG8217198,93,31,21,10,1
SBI43XGX9946369,84,14,10,4,1
SBI34DOT3153130,77,29,28,1,1
SBI80UFQ0401082,86,29,27,2,1
SBI88RKW7260210,95,23,13,10,1
SBI39IIF9461248,65,24,20,4,1
SBI54PFJ0225364,90,18,15,3,1
SBI83IWQ1757656,94,31,19,12,1
SBI20OLQ3841641,92,30,24,6,1
SBI35ZEO3322611,96,18,10,8,1
SBI81YTF1834380,63,26,24,2,1
SBI60QEA2524542,71,30,16,14,1
SBI07RWN9390975,77,28,23,5,1
SBI89GEA3926005,82,26,21,5,1
SBI69JEB6438893,75,22,12,10,1
SBI46OJI9146134,70,27,18,9,1
SBI97AUI3564779,19,18,16,2,1
SBI97XBP6095400,70,36,22,14,1
SBI05WJJ7319944,21,20,15,5,1
SBI37ZXK6971972,84,30,18,12,1
SBI35HEX1188342,21,28,20,8,1
SBI92VDT9657118,93,17,12,5,1
SBI90KEV7366735,21,35,20,15,1
SBI66HJE5335285,91,24,20,4,1
SBI98SQE2950252,72,28,18,10,1
SBI85LUM0488182,70,27,14,13,1
SBI01XMU9362749,78,23,16,7,1
SBI94FAG7346870,78,24,16,8,1
SBI45KVS2115819,92,21,20,1,1
SBI90KES8709722,80,28,25,3,1
SBI26CRX2473910,75,18,17,1,1
SBI03QZJ8337752,25,29,19,10,1
SBI28VCF2680340,83,24,22,2,1
SBI04KRV2402801,99,34,18,16,1
SBI15XJY9067911,97,21,12,9,1
SBI97FJL7310620,96,27,24,3,1
SBI11HIL7832665,88,20,17,3,1
SBI06KSY4920177,93,23,21,2,1
SBI42OPY2297220,84,30,18,12,1
SBI16DMO6904779,61,20,15,5,1
SBI33CBK4760437,97,30,23,7,1
SBI93AFB6626770,62,16,9,7,1
SBI24IEO5593809,82,24,23,1,1
SBI24FLD4392812,72,26,24,2,1
SBI75WPN9556537,63,31,28,3,1
SBI92TNE9745845,98,30,27,3,1
SBI49YEG0481580,60,26,15,11,1
SBI75TMP4351217,87,20,14,6,1
SBI36TQP5106886,87,22,12,10,1
SBI91JFQ5028577,97,20,19,1,1
SBI69BWW3073106,63,28,21,7,1
SBI24PIO6173843,71,21,19,2,1
SBI96EUA7332994,25,19,17,2,1
SBI01FBV2200352,21,23,12,11,1
SBI73YGL3749382,86,27,25,2,1
SBI47RTW8091000,75,23,21,2,1
SBI30XYV8962732,90,33,17,16,1
SBI99PQZ7669456,91,27,14,13,1
SBI82FRM0921432,73,26,25,1,1
SBI28MWF9873954,84,22,17,5,1
SBI81TRH5017611,60,23,17,6,1
SBI90GQN9688548,72,19,14,5,1
SBI18KQC6380234,84,25,18,7,1
SBI42VRS3047407,80,20,19,1,1
SBI75TBW9029544,18,29,28,1,1
SBI78ZLI5185937,18,19,12,7,1
SBI92APZ2316945,87,27,23,4,1
SBI35BLS2285747,81,27,20,7,1
SBI41APP9348489,84,35,26,9,1
SBI47WSS8694718,67,15,14,1,1
SBI73ZBC8823829,95,21,15,6,1
SBI21KAL6949566,82,21,11,10,1
SBI73WEM2087922,95,21,19,2,1
SBI36LSM9209195,75,25,19,6,1
SBI93EAZ8888075,80,21,19,2,1
SBI18KQK1861220,76,21,16,5,1
SBI15FKO7724677,71,20,18,2,1
SBI55NJP5421011,60,21,18,3,1
SBI65ZAG2423782,65,24,15,9,1
SBI77QQN7996619,67,33,23,10,1
SBI72PGM5053076,89,25,22,3,1
SBI15YMG7939409,20,22,21,1,1
SBI57PUW4515037,96,21,19,2,1
SBI95RXQ1400840,62,27,23,4,1
SBI98PCW8242491,91,28,20,8,1
SBI64DFT1695507,93,23,17,6,1
SBI05BZW2228639,63,24,23,1,1
SBI56FYY0111572,99,26,21,5,1
SBI34AQD1513822,66,22,19,3,1
SBI75CQO0810931,71,27,16,11,1
SBI20ZHE3416877,22,30,21,9,1
SBI74QBR4433589,66,17,14,3,1
SBI95RZB2442656,85,25,13,12,1
SBI58BQS7812679,83,33,29,4,1
SBI43JON8112038,74,23,22,1,1
SBI07FSC7643766,83,25,19,6,1
SBI30VCQ2345487,62,23,20,3,1
SBI68LJS0420371,86,21,12,9,1
SBI67ABP0019748,77,29,21,8,1
SBI95QGV7545005,70,16,13,3,1
SBI00HYA0366563,79,33,24,9,1
SBI24AXD4814059,24,19,13,6,1
SBI32DLE5586497,81,32,18,14,1
SBI85JTN2680203,75,19,15,4,1
SBI84WUN7431494,87,20,14,6,1
SBI06DCB6440973,79,18,12,6,1
SBI85AEM1762912,69,20,17,3,1
SBI29JIP2106642,69,26,17,9,1
SBI42YXQ1741500,92,23,12,11,1
SBI93HYK2132861,79,27,16,11,1
SBI87BAL0750324,85,25,13,12,1
SBI88RAR4531581,96,20,13,7,1
SBI09KBG0089702,98,18,12,6,1
SBI41JFC3983407,96,31,19,12,1
SBI08PVP8832697,75,37,30,7,1
SBI56CEK0876082,67,26,20,6,1
SBI36IJI7296668,94,19,13,6,1
SBI15XWP0961443,89,23,14,9,1
SBI64QWS2656287,23,25,16,9,1
SBI10FCY3655207,95,23,21,2,1
SBI92PXW5990793,94,27,20,7,1
SBI29QZH8282234,95,28,24,4,1
SBI27KZZ5783758,65,15,9,6,1
SBI72ACT3033556,20,27,22,5,1
SBI92GDN3223178,89,15,10,5,1
SBI50FUP6497268,90,22,17,5,1
SBI22JXW6311443,75,23,17,6,1
SBI76AKJ4996702,74,25,13,12,1
SBI02MYM0191110,77,34,28,6,1
SBI81IBF1267930,72,31,27,4,1
SBI90KGE9179018,63,24,19,5,1
SBI66LGR3278701,18,23,14,9,1
SBI07FVY9743877,80,29,20,9,1
SBI73ABA0852585,60,25,24,1,1
SBI87QGJ4207389,75,30,25,5,1
SBI57QMP5632850,91,25,13,12,1
SBI13RWB1266090,22,22,18,4,1
SBI81OAD6395746,25,33,27,6,1
SBI60ATZ3230831,81,34,29,5,1
SBI79JOP3267847,93,16,10,6,1
SBI35VZF8870140,80,21,19,2,1
SBI09MNK2240773,81,23,16,7,1
SBI56ZBK0127549,68,26,16,10,1
SBI33XQD2123186,80,27,14,13,1
SBI98IJO2438161,92,25,20,5,1
SBI45IYI6967100,76,19,12,7,1
SBI08SWF6502044,87,21,20,1,1
SBI20IRR2145197,92,24,14,10,1
SBI17NKC1481793,25,28,18,10,1
SBI27HSR3818138,22,24,19,5,1
SBI68RBO3257987,63,25,15,10,1
SBI17QSM7242728,72,29,21,8,1
SBI03OXD3419464,97,21,13,8,1
SBI33SXA8468655,73,19,18,1,1
SBI97DNX8748575,85,20,15,5,1
SBI03XIM9665520,21,25,21,4,1
SBI39XTY6872687,87,17,13,4,1
SBI71JAF1166463,76,28,23,5,1
SBI19CQR5079845,19,28,16,12,1
SBI79EDL1008211,79,19,17,2,1
SBI22YHQ1869988,96,20,16,4,1
SBI92YVE3187326,98,28,18,10,1
SBI06TLZ5631980,72,17,13,4,1
SBI15JWC6326056,89,28,15,13,1
SBI41YIK3356834,88,34,33,1,1
SBI47WJB3111357,82,20,19,1,1
SBI34UOP2457300,89,25,24,1,1
SBI86DZJ4678473,97,29,21,8,1
SBI57MEG6038338,96,29,19,10,1
SBI64OSO7519141,80,23,22,1,1
SBI93MFB4663168,95,24,20,4,1
SBI56UYB9683293,73,17,11,6,1
SBI43RPM6350464,19,22,16,6,1
SBI70JXE0753818,18,20,15,5,1
SBI61XSI2329149,99,26,25,1,1
SBI07DTU4862977,94,20,18,2,1
SBI17DAM0947402,97,23,16,7,1
SBI26TVK1832908,76,34,19,15,1
SBI53AVI6520867,76,20,18,2,1
SBI30EXY8876586,94,26,14,12,1
SBI50PTS7883807,99,21,14,7,1
SBI53SJA4875108,18,21,19,2,1
SBI87LXI8457693,89,30,28,2,1
SBI76CMM6240855,61,34,28,6,1
SBI44IUC7307480,95,28,16,12,1
SBI57SBL2957487,91,24,20,4,1
SBI15FCP1967446,80,34,22,12,1
SBI50PAF0837776,95,27,20,7,1
SBI80QXM8276730,73,27,25,2,1
SBI31PCZ7933469,63,22,12,10,1
SBI24LYR1741969,25,28,19,9,1
SBI13FBI7524177,84,29,28,1,1
SBI93HGM6220187,82,29,25,4,1
SBI63OAD5060762,85,22,15,7,1
SBI77UGS6535866,83,19,16,3,1
SBI21NGW3993325,71,21,14,7,1
SBI13ZCN0188721,78,33,30,3,1
SBI24YUK3403844,96,29,25,4,1
SBI82JJF1374794,69,24,14,10,1
SBI06AOU0655947,94,32,27,5,1
SBI61KZJ1783786,20,18,10,8,1
SBI73LYQ0717652,66,21,19,2,1
SBI26XJS2675830,70,19,16,3,1
SBI11VAE7200970,73,30,23,7,1
SBI46KWE6570518,19,33,21,12,1
SBI79QEW2269927,67,25,18,7,1
SBI92YRR3781665,75,26,17,9,1
SBI03JTR5713898,80,20,14,6,1
SBI88SKH7722720,63,30,26,4,1
SBI13UND0564193,19,31,23,8,1
SBI73TGD0849111,85,23,18,5,1
SBI53XXD2585757,66,26,14,12,1
SBI51SRV7610755,25,29,19,10,1
SBI72BXQ1452306,71,39,31,8,1
SBI27PQG7343120,19,36,28,8,1
SBI29BYB4032967,21,28,16,12,1
SBI75YMW8833330,99,28,18,10,1
SBI48RKS6432257,63,35,28,7,1
SBI04FJX0570334,74,30,25,5,1
SBI59UOM0540547,99,22,21,1,1
SBI00UVQ6633944,79,34,31,3,1
SBI37IUG5029009,19,30,17,13,1
SBI08QZT2407330,74,28,22,6,1
SBI40NNO7291034,88,17,15,2,1
SBI99IES7160396,71,21,20,1,1
SBI85YEJ0525470,25,17,11,6,1
SBI96YNK6841368,62,25,17,8,1
SBI62MYY7585079,97,37,22,15,1
SBI97DOR8050165,24,22,21,1,1
SBI14GUF5158193,61,19,15,4,1
SBI74CYS8946113,19,11,10,1,1
SBI21OFW9026421,89,21,19,2,1
SBI24WYW1942736,25,13,7,6,1
SBI41HFD2419370,63,31,21,10,1
SBI30XQB3097930,88,30,28,2,1
SBI44AGQ3095404,69,31,23,8,1
SBI37CYQ5481393,76,31,24,7,1
SBI68ILV0533153,18,30,20,10,1
SBI39SAV9729078,85,27,21,6,1
SBI88MRY6661053,24,18,14,4,1
SBI92FQD6307351,24,21,19,2,1
SBI67KMW7169705,70,29,24,5,1
SBI35LBE4441585,94,22,12,10,1
SBI13IWB9457509,68,30,25,5,1
SBI14BDH0125790,18,16,10,6,1
SBI72ZLN4112436,74,20,19,1,1
SBI96VXV7079097,79,24,18,6,1
SBI83TBY8282879,19,26,14,12,1
SBI47PLB6809053,64,18,13,5,1
SBI76BJQ8550658,86,23,16,7,1
SBI76EXQ7279636,84,24,15,9,1
SBI83CST7624727,73,11,7,4,1
SBI16TWD5451984,77,20,16,4,1
SBI74CTP3881050,96,27,19,8,1
SBI64VAD4367892,81,20,14,6,1
SBI51KMM7964457,98,27,15,12,1
SBI99SLY8041773,87,24,21,3,1
SBI07CME2637948,79,19,18,1,1
SBI44QQG7910821,64,26,19,7,1
SBI03TRD0645122,87,22,15,7,1
SBI88LNA7148870,84,21,13,8,1
SBI09JEY3074597,69,21,14,7,1
SBI47LFK1058587,64,17,16,1,1
SBI66KEH7618501,24,25,18,7,1
SBI66EKQ6894544,98,20,13,7,1
SBI00AHZ1477101,99,14,12,2,1
SBI84MTZ6006245,98,30,19,11,1
SBI87LEX6497553,70,23,17,6,1
SBI69UQX7386619,98,21,15,6,1
SBI71IHR5295289,23,30,21,9,1
SBI76WGD0752242,21,27,16,11,1
SBI97QKS1451074,94,22,18,4,1
SBI05FYQ2090993,25,21,13,8,1
SBI25PFM6682147,79,21,14,7,1
SBI87DDC7082191,68,25,15,10,1
SBI92AOI4538669,84,29,26,3,1
SBI68CZR4674948,71,19,12,7,1
SBI70ZYJ7315462,74,25,17,8,1
SBI23QLC7779279,25,16,13,3,1
SBI59UHH9991633,94,22,21,1,1
SBI95QFO5794821,24,21,17,4,1
SBI12ZXE7690629,23,23,14,9,1
SBI53YBZ9152103,77,28,22,6,1
SBI42GCC6867052,23,31,30,1,1
SBI14RPN2426898,80,29,15,14,1
SBI68DNQ0471265,60,29,18,11,1
SBI52CZY4117040,60,25,14,11,1
SBI64FRZ5408394,73,26,14,12,1
SBI21ULT7922884,80,27,20,7,1
SBI62LCP6365732,80,14,11,3,1
SBI06APS4145933,61,33,24,9,1
SBI99RNX8047479,60,22,14,8,1
SBI50TQI4323397,61,26,16,10,1
SBI01ETQ9628555,78,29,22,7,1
SBI42KJK5479257,94,26,20,6,1
SBI86XUV1261732,92,20,16,4,1
SBI13UZR1560344,76,35,24,11,1
SBI63KUZ7880267,62,23,13,10,1
SBI68QZT7185943,65,20,18,2,1
SBI17SZD0674522,82,23,21,2,1
SBI51PMU8618322,60,29,17,12,1
SBI34UUN4802918,92,20,17,3,1
SBI64KNE8656528,65,25,18,7,1
SBI61PJY8387071,98,22,21,1,1
SBI82IGG0445679,97,30,23,7,1
SBI76WST5921237,65,30,17,13,1
SBI90OJA9421491,18,29,19,10,1
SBI43TWA5618850,99,21,17,4,1
SBI14KIO6618416,87,30,22,8,1
SBI97MYZ9229407,74,15,11,4,1
SBI03WJA8911925,62,30,28,2,1
SBI78REC2576757,23,30,22,8,1
SBI53YDT0578335,98,33,28,5,1
SBI70BUG2581825,24,16,9,7,1
SBI35XBI2063100,79,30,18,12,1
SBI32YCC6968699,84,23,16,7,1
SBI55UUE0071702,97,23,20,3,1
SBI14GJK7842330,92,17,12,5,1
SBI65AXP1704168,86,25,18,7,1
SBI34RBQ3489052,72,23,18,5,1
SBI41CVX7549665,86,33,24,9,1
SBI83CUG9132287,63,31,18,13,1
SBI49XLJ8180198,21,18,10,8,1
SBI80UUC1344723,77,24,17,7,1
SBI74WSP0634945,19,27,16,11,1
SBI94TZP7850402,20,25,23,2,1
SBI57YWK3843786,65,21,13,8,1
SBI83AHK6039447,22,30,23,7,1
SBI37UEE5136398,21,17,12,5,1
SBI91CQC9628234,67,31,24,7,1
SBI32TGQ4916191,81,21,15,6,1
SBI70MGA2632318,63,18,13,5,1
SBI15PNL5945659,80,23,12,11,1
SBI37KTL4628778,20,20,11,9,1
SBI67WSR2476728,60,22,19,3,1
SBI13HIC0816017,93,21,16,5,1
SBI40CLC9618270,66,25,23,2,1
SBI70TQZ9876238,90,22,15,7,1
SBI14GBG8321816,89,29,27,2,1
SBI90PYH1177624,94,25,24,1,1
SBI27GWR3005241,83,31,30,1,1
SBI17RWF3343993,87,24,15,9,1
SBI54RMV0663422,69,24,16,8,1
SBI89VOY1280192,22,22,15,7,1
SBI73SIB3818015,99,17,16,1,1
SBI56ATY7367314,75,24,20,4,1
SBI23MYW7315608,93,23,17,6,1
SBI30CVV5961677,76,25,19,6,1
SBI16WTN4396817,95,21,15,6,1
SBI71YQW0209911,63,23,13,10,1
SBI45LIS9372954,21,17,16,1,1
SBI50UVD9192732,91,16,14,2,1
SBI03PWL7174753,25,23,17,6,1
SBI13OYX1737914,89,23,15,8,1
SBI83KQR8591092,74,22,19,3,1
SBI67AQD7984570,97,28,17,11,1
SBI15ZVZ2722164,65,18,13,5,1
SBI15RXK3766894,68,29,19,10,1
SBI60RNG9956214,79,14,8,6,1
SBI52GBH0874110,88,24,15,9,1
SBI79HDH1853554,60,35,32,3,1
SBI25VQW7285559,19,27,15,12,1
SBI96WWQ7067976,21,22,16,6,1
SBI62TSM2093253,93,27,14,13,1
SBI03BMO7841180,93,26,18,8,1
SBI73UIH5896023,70,24,20,4,1
SBI38AFP8365812,81,26,24,2,1
SBI60ZTN1448459,60,23,19,4,1
SBI26UVM1448061,76,27,24,3,1
SBI53RCD6450049,25,33,30,3,1
SBI08PQL5870197,87,37,32,5,1
SBI88HWE8304695,23,29,22,7,1
SBI55AXS4535147,95,29,15,14,1
SBI70ZSQ6444348,98,25,13,12,1
SBI65DPC8364814,70,33,28,5,1
SBI15NWL5966787,99,23,16,7,1
SBI27MXN7955614,60,19,15,4,1
SBI80HQJ7917801,80,26,19,7,1
SBI27JLH2305782,68,18,11,7,1
SBI24PAS2908570,96,28,21,7,1
SBI39FOC5048423,98,17,12,5,1
SBI71QNV5847465,87,25,18,7,1
SBI62JBU8482200,92,20,17,3,1
SBI19XDJ5820022,92,18,12,6,1
SBI41IPF1411955,82,29,24,5,1
SBI98CCH5618793,86,32,20,12,1
SBI93BDF7382854,22,18,13,5,1
SBI85EYF2050501,95,27,15,12,1
SBI84UXJ5157385,68,13,12,1,1
SBI64BLP2287053,70,22,18,4,1
SBI37FYX3874464,87,28,17,11,1
SBI60LAY9520997,88,26,22,4,1
SBI85VCV6369495,78,27,24,3,1
SBI68IYQ9791332,65,32,23,9,1
SBI35DBF3689545,67,25,24,1,1
SBI65XIG9811332,89,32,29,3,1
SBI86CNV8347479,19,19,10,9,1
SBI20BXU8634239,72,20,16,4,1
SBI61UOF3395549,62,24,15,9,1
SBI49LIO6294297,92,30,17,13,1
SBI54PEG2377691,19,18,10,8,1
SBI69ELY9480564,99,15,11,4,1
SBI11LXV9623703,60,23,15,8,1
SBI78XXU6902867,21,28,22,6,1
SBI01QZK1192545,64,27,26,1,1
SBI97UAG3508838,63,22,19,3,1
SBI02KIH5098027,22,27,16,11,1
SBI24MLL1717349,68,29,16,13,1
SBI14HJL6490543,96,33,19,14,1
SBI18PPX4308908,81,33,28,5,1
SBI43NOD9409402,61,24,21,3,1
SBI01KBO6903825,76,23,16,7,1
SBI27PZP6649474,95,24,19,5,1
SBI41TMX4422322,18,21,15,6,1
SBI13CAW1437040,82,27,20,7,1
SBI21LON5871027,73,23,14,9,1
SBI00VKT8015718,24,28,24,4,1
SBI66PEY7429002,76,21,14,7,1
SBI74GJG6987439,77,23,13,10,1
SBI80WUH4559808,68,24,13,11,1
SBI08WSR9127001,62,22,21,1,1
SBI52WLB4327351,75,25,21,4,1
SBI59CXX2980904,23,21,18,3,1
SBI47RNQ6954516,20,30,27,3,1
SBI03RYQ8995859,65,23,22,1,1
SBI88QKZ1542604,73,20,17,3,1
SBI59CES8792870,72,31,20,11,1
SBI69NFA5303390,76,25,14,11,1
SBI06VEA8041207,78,9,6,3,1
SBI28IBD1989203,71,24,19,5,1
SBI63RAR2966831,64,25,13,12,1
SBI35RVV0641591,99,28,18,10,1
SBI39SAD0599086,88,26,21,5,1
SBI47JPM3762998,60,22,19,3,1
SBI36LWB2600716,90,28,25,3,1
SBI40IWT1423654,83,23,18,5,1
SBI59CQW7462076,62,34,19,15,1
SBI89KMY7566128,63,28,18,10,1
SBI05LPB2203652,70,26,24,2,1
SBI24UOP4767675,99,24,18,6,1
SBI62SIS6496448,90,31,18,13,1
SBI60WLB5473823,60,28,23,5,1
SBI68JRM0098043,88,27,14,13,1
SBI20LKQ8188851,97,18,10,8,1
SBI00ZEX3172574,19,29,28,1,1
SBI86SSX5935001,21,23,19,4,1
SBI30VKN2496712,83,27,16,11,1
SBI33IBG4667730,76,29,28,1,1
SBI20CID4852521,74,24,19,5,1
SBI06AHK5943696,23,25,18,7,1
SBI44CYE9786942,91,31,30,1,1
SBI17EJV8583110,21,24,18,6,1
SBI58XXB0045401,69,29,28,1,1
SBI36UPV4183426,61,35,22,13,1
SBI35TST2756730,81,29,18,11,1
SBI83PVO4403909,22,23,14,9,1
SBI50CNT1796406,99,26,22,4,1
SBI50AZA6391715,77,27,18,9,1
SBI79ZYG6508579,22,28,25,3,1
SBI17MWS8249729,21,24,20,4,1
SBI24QBE7477161,92,23,14,9,1
SBI73BIG6226234,70,21,17,4,1
SBI45BLN9510981,87,24,23,1,1
SBI72ILM2570067,88,28,17,11,1
SBI59ZGB9484849,74,33,30,3,1
SBI91UVK8074087,19,14,8,6,1
SBI51PDT5080261,75,26,22,4,1
SBI95VEU0141384,89,28,21,7,1
SBI07ISJ1150657,62,19,13,6,1
SBI14VLZ3273803,19,22,12,10,1
SBI87ZGO7709242,25,12,9,3,1
SBI63XGU7335123,70,23,20,3,1
SBI24ATG5172235,76,21,14,7,1
SBI47ZSK3936412,23,31,22,9,1
SBI30IPV3855506,63,23,15,8,1
SBI70VQD5250732,69,20,13,7,1
SBI50BMA0196083,85,26,17,9,1
SBI99LGK2419737,92,22,12,10,1
SBI33OTC2738740,69,25,20,5,1
SBI32LLE3163768,96,26,23,3,1
SBI42XKO3046305,87,28,16,12,1
SBI11NNA3283298,61,27,25,2,1
SBI20WKO6085042,79,22,16,6,1
SBI95SAY6878690,68,15,12,3,1
SBI33UDK7984521,95,25,19,6,1
SBI36CNZ1947668,90,22,19,3,1
SBI67CJO5862491,92,31,20,11,1
SBI74DLV5104117,75,39,23,16,1
SBI24BXX1761235,77,20,11,9,1
SBI60CEX7561495,86,26,15,11,1
SBI13NGR9352074,77,19,15,4,1
SBI07MOJ2667071,93,36,24,12,1
SBI52MTQ1871018,21,26,24,2,1
SBI01UWI7974679,96,29,20,9,1
SBI68TIN4132878,66,21,16,5,1
SBI52HDD5699351,95,25,22,3,1
SBI52OVM5173970,76,19,10,9,1
SBI15ZMI0255234,90,31,30,1,1
SBI85DQD4154627,73,23,22,1,1
SBI61FNB3124022,67,27,14,13,1
SBI91CUF3320506,75,34,29,5,1
SBI23JYX6803480,21,21,11,10,1
SBI88DOC9284688,64,29,17,12,1
SBI60IYW6043600,85,25,21,4,1
SBI62GCG2056356,64,34,20,14,1
SBI72NVP2430721,67,27,25,2,1
SBI07AMC1314174,71,28,15,13,1
SBI66INY1129471,83,24,13,11,1
SBI79ZVQ0769508,93,27,22,5,1
SBI42KZE0464385,97,23,19,4,1
SBI99RBY9649879,78,24,16,8,1
SBI66AUB9578219,97,24,18,6,1
SBI65UGF4375703,90,25,22,3,1
SBI43FIL7378099,60,32,28,4,1
SBI22QNI3215015,88,37,23,14,1
SBI68DUQ7440557,66,26,15,11,1
SBI95OTO4180474,73,20,15,5,1
SBI67KML9276466,93,26,19,7,1
SBI39PIT6951715,73,27,18,9,1
SBI16OMD0405596,76,17,10,7,1
SBI80POQ9605377,83,26,14,12,1
SBI13PZB2531817,84,22,17,5,1
SBI13NRD7918403,89,29,15,14,1
SBI18NKX1679354,96,20,19,1,1
SBI99ZQZ3261482,91,14,9,5,1
SBI27ADJ1880123,18,22,14,8,1
SBI40ENH7928607,64,24,15,9,1
SBI45QVE6169353,80,28,15,13,1
SBI44UQA0770866,77,25,19,6,1
SBI52BZM6538366,23,23,12,11,1
SBI99VXO9155980,77,25,16,9,1
SBI94TOC2256802,73,24,20,4,1
SBI80JYE3667116,73,26,17,9,1
SBI13YNP8032827,91,19,13,6,1
SBI53ABL7431427,20,21,20,1,1
SBI95YJG8958688,64,30,20,10,1
SBI01YLM2110940,65,35,18,17,1
SBI63RHK2364227,91,19,17,2,1
SBI92PMX9748459,77,29,16,13,1
SBI01TSK3258030,83,22,16,6,1
SBI83RCQ4666325,18,23,18,5,1
SBI09XKE5342176,81,17,10,7,1
SBI38IAX9178753,96,20,13,7,1
SBI37LUK2008129,22,26,18,8,1
SBI86KOO9396666,74,23,22,1,1
SBI46FSE6934496,92,18,16,2,1
SBI58PCP3664620,96,18,11,7,1
SBI30JTJ9940759,80,24,16,8,1
SBI91SPZ1814910,64,33,29,4,1
SBI34IRR9614488,82,18,15,3,1
SBI04FDS3674320,67,31,30,1,1
SBI60FGO8605070,73,24,17,7,1
SBI89ZUW5901344,81,16,15,1,1
SBI02YSB4489155,74,17,12,5,1
SBI17XKV5714982,95,29,15,14,1
SBI24DBM9865327,91,32,27,5,1
SBI58DCQ0151221,71,25,16,9,1
SBI91URZ8630879,61,25,16,9,1
SBI81ELM1446387,20,24,20,4,1
SBI68SXM8913234,98,27,26,1,1
SBI27ARE7890443,74,24,14,10,1
SBI08GBH3793361,88,30,20,10,1
SBI95FLH2145075,88,31,16,15,1
SBI22CBJ4296081,97,23,15,8,1
SBI50DCK0707635,85,32,27,5,1
SBI22DLP2603236,23,24,16,8,1
SBI80TPB5200908,68,26,23,3,1
SBI74DKC0852514,23,27,21,6,1
SBI78HBK9034466,72,24,17,7,1
SBI46GHK1679751,77,18,17,1,1
SBI90JHI9147738,77,21,12,9,1
SBI15RVP3910712,94,20,14,6,1
SBI80DPS0902017,68,15,14,1,1
SBI01CLD6999871,66,25,17,8,1
SBI29VQQ4213891,99,33,30,3,1
SBI33GUZ0467172,74,18,12,6,1
SBI08NNT6254253,23,20,11,9,1
SBI33EMO9122635,91,16,12,4,1
SBI11EXK9787366,22,19,11,8,1
SBI41PUZ1968022,97,16,9,7,1
SBI60JUH2776652,21,24,20,4,1
SBI03FSO0680881,70,29,19,10,1
SBI25IST0699231,75,24,17,7,1
SBI00ADR3998484,65,23,20,3,1
SBI33YQK4086469,63,29,18,11,1
SBI75HHP0136931,85,25,24,1,1
SBI38ZXJ2497480,22,27,20,7,1
SBI32QDJ3399291,24,20,19,1,1
SBI82JWX0885129,64,25,23,2,1
SBI06SSR8625022,99,24,18,6,1
SBI25AVY6824455,19,28,25,3,1
SBI42RLU0281099,89,22,16,6,1
SBI21ROM1114975,76,24,14,10,1
SBI04CMX9597815,66,23,13,10,1
SBI10QFW9415420,75,31,25,6,1
SBI26HJK9315271,72,29,19,10,1
SBI34DBU3052717,99,24,21,3,1
SBI39KWL0166047,83,22,18,4,1
SBI43TGL2601834,84,27,22,5,1
SBI86LEG0022379,80,27,18,9,1
SBI86YOT1763088,61,20,14,6,1
SBI44SEW7145923,21,26,15,11,1
SBI92LYV5468596,69,26,24,2,1
SBI58TDY7039669,81,32,18,14,1
SBI49MPB0336249,94,30,25,5,1
SBI39ZUG0269485,70,30,19,11,1
SBI34EJY3379961,83,25,14,11,1
SBI00LNH8450547,62,20,14,6,1
SBI99UWY2450997,80,24,20,4,1
SBI28GZC6162714,70,26,25,1,1
SBI78DXX9243771,88,22,21,1,1
SBI35EEM1503859,97,29,17,12,1
SBI52GEG6527034,68,22,18,4,1
SBI34NNY6092041,62,15,13,2,1
SBI51VSC9592541,82,27,16,11,1
SBI80IEC4435577,67,30,28,2,1
SBI17VLM2845839,24,23,18,5,1
SBI09XTR9325477,87,22,21,1,1
SBI96JUF3791939,71,23,22,1,1
SBI82FOV4230593,82,24,13,11,1
SBI49WLJ6060414,81,23,16,7,1
SBI12VFO4547822,63,30,22,8,1
SBI79GEE5212792,96,34,26,8,1
SBI05VRN8021617,74,24,14,10,1
SBI58DWU0836447,72,26,19,7,1
SBI61JRW0906733,81,30,21,9,1
SBI94EYS8471554,98,27,15,12,1
SBI94KTN2229914,20,22,19,3,1
SBI13CXI2769044,24,25,20,5,1
SBI89VOW2147763,62,27,19,8,1
SBI68FOV4437955,86,21,19,2,1
SBI20QUF7108693,63,27,23,4,1
SBI02VZD4798624,72,24,22,2,1
SBI74MTO0420378,83,32,27,5,1
SBI54RHV2399174,77,18,17,1,1
SBI50JEQ6474653,86,16,13,3,1
SBI01DJR2743385,20,18,13,5,1
SBI35WLK1227720,25,22,17,5,1
SBI28NOL6545848,91,32,22,10,1
SBI46QPE9528161,78,17,12,5,1
SBI22DPY2684882,82,21,20,1,1
SBI01VLR0534684,18,17,11,6,1
SBI51IHF4196553,91,26,23,3,1
SBI72CJK5380585,68,36,22,14,1
SBI04ODM3546914,24,34,25,9,1
SBI20BFF9351945,61,24,16,8,1
SBI65GWM4537288,78,24,23,1,1
SBI62TFA3410433,95,25,13,12,1
SBI81AZD7555119,70,16,12,4,1
SBI30OIS7533336,91,24,14,10,1
SBI56ASW4376581,64,23,21,2,1
SBI44HGV2368165,80,20,16,4,1
SBI73FYB5049619,19,32,21,11,1
SBI50FWQ0024947,21,27,24,3,1
SBI41GKT7514653,74,20,11,9,1
SBI00ZTA0217062,93,36,34,2,1
SBI73XGP9027644,65,19,14,5,1
SBI09KDW5179676,80,24,17,7,1
SBI33BJE8414961,70,29,22,7,1
SBI31OUU0095321,81,33,25,8,1
SBI83ZDW1322818,63,21,12,9,1
SBI82COO1229519,94,28,15,13,1
SBI70NXF9556678,84,31,29,2,1
SBI53DVS4438195,67,29,25,4,1
SBI47JAZ4634397,97,32,28,4,1
SBI76PYT9707803,77,27,21,6,1
SBI41XJN7868373,68,32,23,9,1
SBI29EIU8915290,67,25,13,12,1
SBI83VPZ3914548,62,32,25,7,1
SBI30URV2014020,71,23,18,5,1
SBI80DEE8614365,83,32,23,9,1
SBI23PWU0868966,65,24,18,6,1
SBI04RIR9815803,65,18,16,2,1
SBI59KBT6848519,75,22,14,8,1
SBI91QDW4694055,70,28,23,5,1
SBI92HQQ8422259,95,26,17,9,1
SBI51NUU2233932,86,25,14,11,1
SBI23AWM5125318,62,17,10,7,1
SBI90NGX5677839,87,24,22,2,1
SBI55TCJ5870896,64,28,23,5,1
SBI54OZK0335745,23,19,13,6,1
SBI49SVS9247874,20,22,12,10,1
SBI69WHF4057192,95,27,24,3,1
SBI78NED6991044,77,32,27,5,1
SBI33ZNA0841638,96,24,15,9,1
SBI13XTI5148205,72,25,16,9,1
SBI51ZGU2550525,63,24,18,6,1
SBI70IBF4205354,70,25,17,8,1
SBI57IPL2223262,84,21,14,7,1
SBI48ICV4402609,64,27,20,7,1
SBI24HFS9328650,83,22,20,2,1
SBI21FFE9976817,92,26,19,7,1
SBI01TMA8931473,60,27,22,5,1
SBI99AZD0874037,77,23,17,6,1
SBI77HMX9752953,71,25,18,7,1
SBI22WJM1697266,95,28,25,3,1
SBI64CFB4893040,87,16,14,2,1
SBI24HXZ0592285,20,28,24,4,1
SBI23BDN5621108,93,26,16,10,1
SBI86OWX0896398,70,23,15,8,1
SBI86PYX6939934,63,23,21,2,1
SBI59WUP3928561,70,24,16,8,1
SBI88YCY2208602,20,18,16,2,1
SBI94ZPI2257039,95,25,19,6,1
SBI35LWF7177686,76,20,18,2,1
SBI71DAT0345203,25,28,17,11,1
SBI56ZUX4833802,71,22,15,7,1
SBI79XIR1478191,83,30,28,2,1
SBI20BKF9646924,85,25,18,7,1
SBI86NAZ4308877,60,32,21,11,1
SBI11URR3160658,97,28,15,13,1
SBI60MQR4684652,18,21,18,3,1
SBI08TLS0337106,98,21,16,5,1
SBI71VDL2409007,77,21,13,8,1
SBI05CFD7636963,60,27,15,12,1
SBI67HQH2766320,74,23,21,2,1
SBI72YUT1305466,88,30,17,13,1
SBI24YVX2506649,79,26,20,6,1
SBI11NJO1981663,79,16,15,1,1
SBI23IUC5604272,69,23,12,11,1
SBI19UDH7167121,75,21,11,10,1
SBI49CBJ5930806,23,21,18,3,1
SBI57TXQ1219444,93,23,14,9,1
SBI92KUZ9387880,94,22,14,8,1
SBI32LOE6055478,66,28,24,4,1
SBI03BFG9857573,69,22,14,8,1
SBI89CHD9772509,98,27,23,4,1
SBI73QVV9278514,92,18,15,3,1
SBI01CRA9534653,95,24,21,3,1
SBI74AGX9716221,71,27,24,3,1
SBI73HLB1184041,72,27,18,9,1
SBI54DNA7060990,88,14,11,3,1
SBI11NSA2306613,86,22,19,3,1
SBI81FYJ0407949,81,16,12,4,1
SBI68DRI0500980,61,31,17,14,1
SBI15QLC8149417,73,15,9,6,1
SBI74HXB5438667,85,23,20,3,1
SBI51DEL8663935,19,20,15,5,1
SBI46PSZ3653879,23,25,15,10,1
SBI58DBW6393847,66,22,13,9,1
SBI09HUT4331673,83,24,16,8,1
SBI85EMJ6022793,73,33,30,3,1
SBI83QJP8531718,69,35,25,10,1
SBI49RUW3263155,65,25,14,11,1
SBI07DWW9655337,76,22,21,1,1
SBI56WLK2907080,75,31,25,6,1
SBI03EVE5022934,61,31,28,3,1
SBI69MBO3087927,60,24,13,11,1
SBI11RXQ1532499,84,30,23,7,1
SBI44VDN2068687,24,23,16,7,1
SBI19GZJ9210444,93,23,19,4,1
SBI38TSR3082468,97,24,22,2,1
SBI10BOL7395534,82,29,19,10,1
SBI64INJ6226521,80,33,28,5,1
SBI06CNY2242230,86,21,14,7,1
SBI35LDN8145861,64,28,24,4,1
SBI74UBO3975574,60,27,20,7,1
SBI52XQI2877220,68,27,22,5,1
SBI87XYI9641530,78,23,18,5,1
SBI81BGQ0067890,62,20,13,7,1
SBI43TKB4145880,98,31,20,11,1
SBI46QQC8269318,81,23,12,11,1
SBI24GAK5965254,98,23,16,7,1
SBI75EDF7180558,60,26,16,10,1
SBI55ONP4873557,69,26,24,2,1
SBI56LRO8862729,62,19,15,4,1
SBI30HSZ0792345,63,21,14,7,1
SBI83GEN5668638,68,24,13,11,1
SBI93PRX7993890,66,18,16,2,1
SBI98HUB6922129,93,24,20,4,1
SBI73TQR6608928,24,16,15,1,1
SBI31QXN4468036,60,21,13,8,1
SBI02XRQ4100908,79,26,24,2,1
SBI77JWP4436142,65,27,26,1,1
SBI46ERF1218387,78,25,19,6,1
SBI80EXC4704314,62,21,20,1,1
SBI95HSF9206816,62,20,16,4,1
SBI23KKB8771512,20,24,18,6,1
SBI59LBN6495215,72,28,26,2,1
SBI65KVQ9923275,84,24,17,7,1
SBI02XBE6912751,60,28,23,5,1
SBI49PPJ7478135,60,24,20,4,1
SBI90FAD5523026,24,22,19,3,1
SBI07ZDG6494074,70,23,21,2,1
SBI01MKR4631816,19,35,32,3,1
SBI00YBN9286091,78,28,21,7,1
SBI76PMH7426814,76,21,11,10,1
SBI72REE6154212,91,21,14,7,1
SBI66AUI2156266,86,23,12,11,1
SBI39EDW2635048,90,15,9,6,1
SBI04PLI8293843,87,29,20,9,1
SBI01TBF2670596,83,18,12,6,1
SBI45TBH0283203,99,22,12,10,1
SBI84MRE1297556,86,29,17,12,1
SBI42VML3091638,68,17,15,2,1
SBI59SSP3197077,63,23,22,1,1
SBI23YJB2746067,68,23,14,9,1
SBI97QWO9462267,18,26,18,8,1
SBI56MFQ6556456,95,20,19,1,1
SBI60VVV4610104,88,24,16,8,1
SBI53RVK6683362,76,24,16,8,1
SBI33FMR2283051,69,30,29,1,1
SBI78LOH4108320,25,25,21,4,1
SBI29WPN8126882,71,17,13,4,1
SBI21UAH7204324,83,31,18,13,1
SBI38ZDC4469975,85,23,14,9,1
SBI46BPS4749342,22,27,26,1,1
SBI72HTX3027912,25,32,26,6,1
SBI51EWV7404064,68,24,16,8,1
SBI82GKI8696194,99,25,20,5,1
SBI83BJM6126995,88,20,16,4,1
SBI19MOC6889777,95,23,17,6,1
SBI49HQH8370514,94,20,12,8,1
SBI81GIS5183337,88,33,20,13,1
SBI87PAS0814304,90,26,19,7,1
SBI87PXN5475147,60,24,20,4,1
SBI96TPW9596947,68,25,17,8,1
SBI89RUW4855257,67,27,15,12,1
SBI21XRZ8351537,97,22,21,1,1
SBI19WIW5929547,71,33,27,6,1
SBI97KOV1939269,63,26,16,10,1
SBI24HZB6636105,93,23,13,10,1
SBI92FYC1404543,71,25,15,10,1
SBI74GOA3776605,18,33,28,5,1
SBI12MQI0217162,77,32,30,2,1
SBI23XUL2696630,94,18,11,7,1
SBI69COF5914916,24,19,12,7,1
SBI95HSS5354103,95,24,15,9,1
SBI74VAQ8467269,61,23,18,5,1
SBI59QIZ6576268,91,35,32,3,1
SBI09KKO9785435,73,22,12,10,1
SBI96GCS4005117,81,26,23,3,1
SBI42LMG9410067,99,30,29,1,1
SBI66NHG8295157,62,29,26,3,1
SBI49DPQ2179782,85,21,17,4,1
SBI69HYK0463542,77,18,16,2,1
SBI68XTM3642718,79,17,13,4,1
SBI27TAK3338522,92,34,32,2,1
SBI35AFW5871847,67,35,29,6,1
SBI71SMF7578848,67,25,15,10,1
SBI49DTA5290776,77,25,14,11,1
SBI75AHE3059284,77,25,18,7,1
SBI78IWG7196256,78,24,23,1,1
SBI78GYY4172149,24,24,21,3,1
SBI84WWY8637534,90,19,12,7,1
SBI44ZEA2799634,78,24,13,11,1
SBI90MEA3998626,70,21,18,3,1
SBI55RKU3784476,61,24,17,7,1
SBI98YYV4185007,90,26,22,4,1
SBI18TEB7870513,69,24,16,8,1
SBI60KCF6905842,85,16,11,5,1
SBI79DFP4749956,65,31,19,12,1
SBI18FQD3463010,91,15,9,6,1
SBI66LQO7220336,86,28,22,6,1
SBI85YIL2062703,67,31,27,4,1
SBI29ZUX7746803,88,27,14,13,1
SBI86ORL1736361,80,27,23,4,1
SBI60GXF1933605,71,29,17,12,1
SBI09WJD9354243,77,24,13,11,1
SBI58CPJ1274518,72,32,25,7,1
SBI39IXC9648507,25,27,20,7,1
SBI92VHN1885250,20,26,22,4,1
SBI54HRI2456066,80,33,17,16,1
SBI12FDT2363597,75,18,10,8,1
SBI85YOO5052507,62,28,19,9,1
SBI15SMJ3694597,20,23,16,7,1
SBI66MRX6849728,70,32,19,13,1
SBI03GFF8664125,66,25,19,6,1
SBI16NKJ8016551,20,27,20,7,1
SBI30KUU8114812,84,25,13,12,1
SBI28SUE9225302,98,26,21,5,1
SBI64SRW6661191,79,19,15,4,1
SBI26AJM3415469,98,19,13,6,1
SBI87GGN5076009,99,24,15,9,1
SBI91GQZ3669551,97,19,12,7,1
SBI89YCI0900009,97,25,17,8,1
SBI13MGT7131641,19,19,18,1,1
SBI83XVC9649736,92,22,12,10,1
SBI82RXI5791712,70,28,21,7,1
SBI56ATH8570189,81,27,24,3,1
SBI21XLV1669096,92,31,22,9,1
SBI96CEQ9042796,91,24,19,5,1
SBI27SLS5820391,25,27,24,3,1
SBI87CRP2980349,70,25,21,4,1
SBI00EUL4422804,87,31,22,9,1
SBI43TKO9340775,19,33,29,4,1
SBI96NOR1460630,92,16,13,3,1
SBI83QYC7906789,20,29,18,11,1
SBI68OTN9899357,90,27,25,2,1
SBI14HTB1639750,87,29,16,13,1
SBI17AWN7063620,96,26,24,2,1
SBI08XMH0719118,86,30,21,9,1
SBI81PHV5991145,79,23,15,8,1
SBI28ISP0049602,88,26,19,7,1
SBI39RMX7485019,76,33,22,11,1
SBI71RXT5428008,85,21,19,2,1
SBI63ZWL2362331,65,15,8,7,1
SBI16FLK4452543,19,19,17,2,1
SBI25HVE4910474,74,34,28,6,1
SBI70NOG8187496,86,26,15,11,1
SBI99RSK4254370,98,22,13,9,1
SBI24MTE8553527,92,27,17,10,1
SBI12GVY5704613,98,26,19,7,1
SBI13BOD4247405,19,26,16,10,1
SBI09CPM1574392,79,27,21,6,1
SBI22NWV8495044,25,20,16,4,1
SBI08PDY4493436,84,19,11,8,1
SBI26UMN6634983,78,23,19,4,1
SBI65NAC8110441,87,27,15,12,1
SBI27PBO8642083,72,32,24,8,1
SBI99MKE4388773,21,28,20,8,1
SBI09CYD1929350,89,20,15,5,1
SBI83KGD2965295,97,19,13,6,1
SBI66PTN7276349,76,29,17,12,1
SBI25KLY3011715,91,18,12,6,1
SBI64AKF6414875,73,16,15,1,1
SBI85EOM9749673,95,21,15,6,1
SBI63HKM0137764,78,27,25,2,1
SBI27FQM9518415,69,27,15,12,1
SBI97VAT4370315,98,27,16,11,1
SBI31VDR9708877,70,24,22,2,1
SBI95JJE8559577,61,22,17,5,1
SBI03XSW6325102,77,22,21,1,1
SBI58IBM1665096,85,23,20,3,1
SBI58YCL5114698,24,24,14,10,1
SBI83EEX8527189,95,24,19,5,1
SBI64XEE9700505,24,24,21,3,1
SBI42NTJ4940636,91,26,22,4,1
SBI33WJD7865504,84,20,13,7,1
SBI27WRZ9999943,94,26,25,1,1
SBI43AEL8160081,66,20,17,3,1
SBI65WLV6667696,25,21,18,3,1
SBI73EKR7867597,65,23,14,9,1
SBI11ACG5624507,87,31,24,7,1
SBI31NWQ4413408,81,30,26,4,1
SBI12JBU4103314,24,29,17,12,1
SBI73KTT0484924,67,22,17,5,1
SBI76CHX4358562,70,29,19,10,1
SBI71HCG4200585,73,25,24,1,1
SBI88UEO9085295,66,31,23,8,1
SBI98RSJ4810102,91,23,16,7,1
SBI67XGX8216239,61,33,23,10,1
SBI79UBC6333817,86,25,20,5,1
SBI59XQZ6460666,80,20,13,7,1
SBI99LYW3348131,23,29,23,6,1
SBI59KAC1283438,62,25,15,10,1
SBI27VAW1793489,84,29,20,9,1
SBI12FUF4270551,92,8,6,2,1
SBI36EIB2496423,69,25,13,12,1
SBI44QXF4754609,21,15,12,3,1
SBI62HRF4680959,23,21,13,8,1
SBI91ACB8380048,61,25,13,12,1
SBI50CNP0471589,78,19,14,5,1
SBI61VLX7245849,73,28,16,12,1
SBI38GEF3498791,96,14,11,3,1
SBI43CES8923646,24,29,26,3,1
SBI98EHE3585664,61,24,23,1,1
SBI86AVA1269394,91,24,14,10,1
SBI16ZXE6065634,78,25,20,5,1
SBI01CCR9933642,84,25,21,4,1
SBI51LJR9741006,75,24,16,8,1
SBI10UDW0254465,93,20,11,9,1
SBI48ZUH1622783,68,20,14,6,1
SBI89BKE5384744,93,28,15,13,1
SBI57YDA7530722,20,24,22,2,1
SBI12FCM4470281,68,19,15,4,1
SBI00YTB8779409,80,33,30,3,1
SBI63AYD6982320,93,14,11,3,1
SBI09QXZ2096901,99,35,24,11,1
SBI46MQP5120304,95,22,17,5,1
SBI60AJW2656390,74,31,28,3,1
SBI08BBN9826122,97,25,23,2,1
SBI21PHL0383535,84,27,25,2,1
SBI65DPG9383081,72,19,17,2,1
SBI78RVW7144417,73,23,14,9,1
SBI93MUF0711330,82,21,20,1,1
SBI68YHZ1976608,86,24,22,2,1
SBI26AMD5246094,78,25,16,9,1
SBI58OBU0423230,98,19,13,6,1
SBI96LZB4820126,70,24,19,5,1
SBI24UZU8548222,20,19,18,1,1
SBI46OMH6599887,90,25,13,12,1
SBI19ZQU5388728,87,29,15,14,1
SBI16GUQ4622621,86,28,18,10,1
SBI44FNU3331832,63,25,21,4,1
SBI42CVJ3212024,96,29,22,7,1
SBI18HHP7558579,23,21,11,10,1
SBI29BHC4361822,25,26,15,11,1
SBI80PCL3326921,86,25,16,9,1
SBI45LAI8626919,81,25,21,4,1
SBI11OOM5965973,84,21,20,1,1
SBI38KPW6841447,63,22,20,2,1
SBI84DXO0787702,64,25,19,6,1
SBI68IVF4676169,62,17,9,8,1
SBI01ZGX3792358,62,25,18,7,1
SBI25CUJ9238642,72,18,15,3,1
SBI14YRA7377260,93,23,19,4,1
SBI51ZFU8824150,20,32,19,13,1
SBI18HWU0022923,90,23,17,6,1
SBI86KPQ4466535,18,24,15,9,1
SBI36YHW3711992,72,18,14,4,1
SBI79BME4103867,89,23,18,5,1
SBI35XID4999259,87,21,18,3,1
SBI25LBZ8703874,99,20,17,3,1
SBI71OIZ6905718,94,22,18,4,1
SBI25XAB9339511,25,24,13,11,1
SBI16KNG8776275,71,24,21,3,1
SBI31KYM2920177,24,22,14,8,1
SBI01MGV6616964,75,25,23,2,1
SBI93CIC1280329,76,22,12,10,1
SBI45OWA9310051,23,28,24,4,1
SBI01GCU0597217,24,28,25,3,1
SBI19FVM3267906,78,26,19,7,1
SBI81KYT4403650,74,24,18,6,1
SBI61HVQ5075482,67,23,15,8,1
SBI29IAB5160222,84,28,17,11,1
SBI70XER9979089,80,22,21,1,1
SBI51RZE8429044,24,24,21,3,1
SBI59FCC0401288,67,22,13,9,1
SBI61PIP8326014,65,17,16,1,1
SBI71KTW2063684,71,24,13,11,1
SBI79LUF1809445,81,29,16,13,1
SBI73BYE0105491,77,19,10,9,1
SBI82MWB6273802,19,18,14,4,1
SBI17RHY1493845,25,23,16,7,1
SBI03QKF8313990,18,24,19,5,1
SBI75DAC5894141,87,28,26,2,1
SBI18PLB0804994,92,23,18,5,1
SBI02OLQ0946204,93,29,19,10,1
SBI16WAN6367865,82,25,16,9,1
SBI33DZI3800402,78,23,12,11,1
SBI34UZN3766667,81,35,19,16,1
SBI08HXE8294885,93,31,26,5,1
SBI17UHE6188290,74,23,17,6,1
SBI62HZF2147605,20,21,20,1,1
SBI02TQA9145626,84,17,10,7,1
SBI12JZN6806162,84,36,26,10,1
SBI29KGF5967435,65,28,17,11,1
SBI84BGC1708396,18,20,14,6,1
SBI67EUZ2614396,70,21,18,3,1
SBI45LFM8767839,25,24,13,11,1
SBI76WSR6863687,90,34,31,3,1
SBI68JSB1967949,62,29,26,3,1
SBI90DKL4036104,81,29,16,13,1
SBI77ADW0245286,92,30,16,14,1
SBI19FFH3604086,89,26,14,12,1
SBI76TBI6943811,19,24,20,4,1
SBI00YTL6934049,89,25,22,3,1
SBI79CAM7355569,18,26,17,9,1
SBI22BPE3504437,22,29,28,1,1
SBI47AGK5827009,23,26,17,9,1
SBI94BUU2832329,87,23,16,7,1
SBI29ZQP7749759,94,19,11,8,1
SBI36SVZ8982734,89,23,20,3,1
SBI75XZI0879724,98,25,20,5,1
SBI76IKY4744738,70,32,28,4,1
SBI16VEU7202853,20,38,31,7,1
SBI66EOB7715941,79,31,25,6,1
SBI53HNP5601021,85,28,24,4,1
SBI39JLO5743829,61,24,17,7,1
SBI04EYO3546195,96,22,15,7,1
SBI79WWQ6887943,72,28,26,2,1
SBI05LHV7597113,86,14,10,4,1
SBI28FQG8286696,73,24,21,3,1
SBI02QOR3487303,69,29,23,6,1
SBI66DVK3871347,94,34,29,5,1
SBI88TOZ6160309,92,27,25,2,1
SBI36TEE7933047,78,18,13,5,1
SBI45XJH5941978,83,24,21,3,1
SBI86JHK6875397,88,14,13,1,1
SBI29FUC2030242,68,30,25,5,1
SBI83KNI9558934,93,34,29,5,1
SBI99UTW7666220,97,23,14,9,1
SBI45POY4737738,96,28,17,11,1
SBI35CPV2323065,75,21,14,7,1
SBI71EHS0908971,63,25,20,5,1
SBI16GJC4703997,18,26,15,11,1
SBI75MLW7109564,81,25,19,6,1
SBI65FZH2639162,73,23,20,3,1
SBI04OVL6453741,71,30,18,12,1
SBI76VFU3131445,23,23,15,8,1
SBI02CZH7891761,90,16,13,3,1
SBI66XRZ9944907,92,28,15,13,1
SBI63SLT4414924,78,18,17,1,1
SBI71RGT6779426,91,23,21,2,1
SBI56BCA1750770,70,28,26,2,1
SBI35SFT8334579,62,24,14,10,1
SBI28SST9687018,18,21,14,7,1
SBI99SHG0923590,85,21,17,4,1
SBI84MSV5463505,86,28,18,10,1
SBI05ITI5221148,85,25,23,2,1
SBI47AJP3428723,83,25,21,4,1
SBI80IUW1147806,61,30,27,3,1
SBI07NYF4698122,62,34,26,8,1
SBI22WUI5047134,81,31,17,14,1
SBI32EVY3670192,81,24,19,5,1
SBI29KPZ4821047,77,32,18,14,1
SBI91SKQ4665425,72,30,24,6,1
SBI45MBC3503544,86,24,21,3,1
SBI64OOO5911331,21,31,30,1,1
SBI29NUZ7788946,89,29,17,12,1
SBI17GUE6192198,69,25,24,1,1
SBI98HBR1343537,99,31,21,10,1
SBI05GSD8597860,64,24,21,3,1
SBI58TAW8933664,98,34,26,8,1
SBI50DYO2497720,23,29,25,4,1
SBI56RVR6422967,90,27,25,2,1
SBI00TWB2768173,73,28,22,6,1
SBI89YAC4080249,82,28,22,6,1
SBI59UGD2177627,90,26,21,5,1
SBI56EQX4282339,63,19,14,5,1
SBI12RTP3842516,86,25,16,9,1
SBI47BNO5416749,85,29,22,7,1
SBI37IWV7896415,86,23,14,9,1
SBI16GQM8217235,62,25,18,7,1
SBI88VFZ5360175,23,17,16,1,1
SBI88MBT2191688,94,21,18,3,1
SBI91HWD2516106,62,25,23,2,1
SBI05IQX3297238,69,11,10,1,1
SBI90NFE5273291,86,29,21,8,1
SBI21PWY6532083,76,34,32,2,1
SBI90PUE7915555,98,25,23,2,1
SBI10DJC4804138,96,26,15,11,1
SBI59WGC0331776,96,24,22,2,1
SBI47AFM2813440,22,25,24,1,1
SBI48VZQ8507498,68,27,18,9,1
SBI43HVD0216895,70,20,16,4,1
SBI10WMA3317080,80,24,15,9,1
SBI18WDV5414155,95,21,12,9,1
SBI56MMO8770670,20,22,19,3,1
SBI16TDK0470426,89,27,26,1,1
SBI80OMP7379156,81,13,9,4,1
SBI56TWJ5687835,69,25,17,8,1
SBI63ODX5356935,95,26,23,3,1
SBI61OSQ4298883,75,34,33,1,1
SBI98OYA6494137,63,31,26,5,1
SBI76BGI2122558,23,19,11,8,1
SBI45VOQ0215360,99,15,12,3,1
SBI56BTO0335880,97,17,14,3,1
SBI56SRD5527251,99,16,10,6,1
SBI14BWV8776380,62,25,21,4,1
SBI36YSH6763419,60,23,14,9,1
SBI74ELS6064741,72,20,16,4,1
SBI45EWB9710882,97,26,16,10,1
SBI41DDT6911585,68,22,15,7,1
SBI99EIU3264197,19,24,18,6,1
SBI45PWE6717496,19,25,22,3,1
SBI20IYH6657934,80,22,19,3,1
SBI37TML7540251,79,19,16,3,1
SBI54LYA4861380,69,28,24,4,1
SBI35VXV8501843,70,24,18,6,1
SBI22TCE0380421,84,38,29,9,1
SBI88YWP9629172,64,24,13,11,1
SBI12XOT6958000,60,25,21,4,1
SBI73DET8744574,66,27,17,10,1
SBI71RGJ2277394,89,20,17,3,1
SBI39RYJ2368144,79,22,18,4,1
SBI78BPF3535555,79,21,17,4,1
SBI93JCK7786467,90,19,11,8,1
SBI05NJP6736811,68,14,12,2,1
SBI19WBV0970976,78,30,23,7,1
SBI20ZAS1334726,86,28,21,7,1
SBI26WVH5003254,91,24,21,3,1
SBI15LEW0120354,88,18,17,1,1
SBI47VOO8351545,61,15,12,3,1
SBI72AUW1911784,78,26,17,9,1
SBI88JVF7701666,91,23,17,6,1
SBI26UCC2052847,18,25,18,7,1
SBI25VKJ9788973,66,22,16,6,1
SBI68LSQ0857479,77,17,11,6,1
SBI07TIE2139842,68,32,19,13,1
SBI06NIE0471939,24,26,23,3,1
SBI07UUJ4902488,91,30,20,10,1
SBI62LLH9271161,69,25,18,7,1
SBI60BPH0674116,69,25,17,8,1
SBI94FSR1643466,67,20,11,9,1
SBI22ELX2468096,90,36,27,9,1
SBI27ZSQ8714763,95,21,14,7,1
SBI68GKP0124892,69,24,20,4,1
SBI29NJT6075633,70,31,30,1,1
SBI01TZU9076016,87,24,23,1,1
SBI14UHW7395916,64,21,14,7,1
SBI63OME5311919,96,19,11,8,1
SBI92QCJ8077614,93,33,22,11,1
SBI72HDG4700682,77,26,21,5,1
SBI74YSO5124534,67,31,27,4,1
SBI58YWL8209285,74,27,19,8,1
SBI64UXL8099394,90,27,16,11,1
SBI03SOX5000636,71,35,29,6,1
SBI46MFM1615843,23,31,16,15,1
SBI06VVY5065080,75,19,12,7,1
SBI88NMZ4671307,82,23,16,7,1
SBI64WXT4439564,70,28,15,13,1
SBI06LGO6724311,90,21,20,1,1
SBI42YCG8709754,23,14,9,5,1
SBI19XYC2353438,24,13,7,6,1
SBI64OQM4967984,64,25,16,9,1
SBI79CQS0563885,71,21,13,8,1
SBI90YEC3336729,88,34,21,13,1
SBI89JEC0142201,87,32,30,2,1
SBI80AOJ2325841,71,26,19,7,1
SBI55ZAC9358597,63,30,22,8,1
SBI19OIB7709387,90,24,21,3,1
SBI35KLD3875917,73,22,21,1,1
SBI25XTF5369397,84,20,15,5,1
SBI11ICI8293170,88,21,18,3,1
SBI69DFF6473562,90,16,10,6,1
SBI26IMU3219328,84,22,13,9,1
SBI86HXF9060725,87,24,15,9,1
SBI69FAA2619044,83,34,27,7,1
SBI76HEM9830235,98,24,20,4,1
SBI20BQQ5147826,25,28,19,9,1
SBI17JHN3739468,73,23,15,8,1
SBI48JYO9506888,23,18,16,2,1
SBI92BEB2738362,73,29,20,9,1
SBI52GMK2899794,65,28,27,1,1
SBI62VRO3207235,85,26,25,1,1
SBI14TZK3126669,84,34,29,5,1
SBI07HKU5954617,84,21,13,8,1
SBI41OBD5434426,80,28,19,9,1
SBI94TGO0567283,86,29,22,7,1
SBI67ZMP0783195,60,26,14,12,1
SBI61BIG0482076,68,28,16,12,1
SBI77IND0737488,68,20,13,7,1
SBI49XTH1179854,75,26,17,9,1
SBI82AII3485885,24,17,11,6,1
SBI92MNG0383576,69,25,20,5,1
SBI86RCC1619607,73,24,22,2,1
SBI61NDX5390071,18,27,18,9,1
SBI13SOR8491567,65,21,19,2,1
SBI55OCL8439692,80,31,21,10,1
SBI56IWL8728808,23,32,19,13,1
SBI06CRN1792609,19,18,15,3,1
SBI81KMN3835633,95,20,12,8,1
SBI85IQK9418184,82,20,16,4,1
SBI12XCL8254416,78,19,14,5,1
SBI70EEU9082013,77,30,22,8,1
SBI81LST9361853,81,25,20,5,1
SBI57HRW0224623,67,29,24,5,1
SBI37XSA0890565,95,29,18,11,1
SBI29IMI0447956,65,25,16,9,1
SBI19HBY4210296,96,24,19,5,1
SBI18LJW9775411,21,23,15,8,1
SBI96FLB0586877,67,22,17,5,1
SBI24ZUZ7457754,95,23,22,1,1
SBI99TIC8843361,76,23,15,8,1
SBI69TDS7962428,84,35,30,5,1
SBI46PFE2276724,18,18,11,7,1
SBI02QRR9461768,98,21,19,2,1
SBI39WNH0817403,19,30,21,9,1
SBI06QTK7032638,89,27,25,2,1
SBI91UER7476279,80,33,21,12,1
SBI07OND4262116,97,26,23,3,1
SBI76KYT3921641,85,24,21,3,1
SBI42WDZ7758331,92,17,16,1,1
SBI96NZM3651256,85,17,14,3,1
SBI55JAR8459462,70,29,28,1,1
SBI24LGO1398373,71,21,17,4,1
SBI71MXP8620898,88,19,17,2,1
SBI28ARX1384485,88,37,20,17,1
SBI06OMW2519974,23,24,16,8,1
SBI41KTK2840076,79,20,17,3,1
SBI80QTC4656564,96,30,29,1,1
SBI86KVO4378790,65,36,19,17,1
SBI33QSV3106491,67,29,15,14,1
SBI88QDR7566219,96,27,22,5,1
SBI49ZPM0906478,71,19,13,6,1
SBI46MYQ1560056,86,20,16,4,1
SBI36GQO6326304,81,19,12,7,1
SBI58RDM7680807,88,33,26,7,1
SBI19RQN4964125,23,35,21,14,1
SBI83ADU4888580,79,29,25,4,1
SBI40WEI1675680,91,29,15,14,1
SBI32CJU5163554,94,24,21,3,1
SBI95YNY7294943,89,21,17,4,1
SBI60EMG0888988,94,24,21,3,1
SBI47CKX7849464,76,26,15,11,1
SBI33ZQA1880138,75,26,15,11,1
SBI17PPZ2050286,72,11,6,5,1
SBI22NHL8362153,61,21,12,9,1
SBI10WFH4788355,65,27,20,7,1
SBI09POA1528500,19,25,15,10,1
SBI70HDH7831683,61,27,23,4,1
SBI27AEB2987617,67,15,8,7,1
SBI44LNQ6636709,77,24,23,1,1
SBI38HXQ3715790,92,20,17,3,1
SBI77QJU4244808,96,30,27,3,1
SBI87KXF5613691,89,29,28,1,1
SBI79PPC9866059,91,26,19,7,1
SBI20HYM5250927,90,28,17,11,1
SBI54GPT1563925,89,23,12,11,1
SBI89VJZ4276054,92,36,26,10,1
SBI48PJJ5231614,87,26,14,12,1
SBI82JTK3555703,99,30,20,10,1
SBI55QVC4011937,20,30,20,10,1
SBI96OVL3261449,69,24,13,11,1
SBI32OOP5363611,80,22,14,8,1
SBI55KRM4496602,78,23,19,4,1
SBI85ODE8864327,90,24,15,9,1
SBI94FZP0373291,93,32,31,1,1
SBI46MEB3213468,66,33,18,15,1
SBI01EGP1712745,69,23,19,4,1
SBI42SZM3213237,92,23,17,6,1
SBI00TKI0575654,97,25,18,7,1
SBI67CPA1144089,72,22,15,7,1
SBI36TVG2563945,61,29,16,13,1
SBI62CXC3002033,98,26,22,4,1
SBI15WRV7045342,94,24,23,1,1
SBI28CEQ5669022,80,22,17,5,1
SBI76IXF3447708,20,20,12,8,1
SBI98QGT9215104,63,25,21,4,1
SBI42QNX3190411,18,23,22,1,1
SBI29IMG5289348,24,25,13,12,1
SBI90YBG6931916,60,30,20,10,1
SBI23CGT7972383,77,29,23,6,1
SBI86CNV5940195,78,20,18,2,1
SBI04AJS9229847,82,36,21,15,1
SBI95SNI4525028,83,32,30,2,1
SBI72DTH5063645,93,34,18,16,1
SBI42JTN9430113,82,17,14,3,1
SBI56ULJ4497100,89,21,16,5,1
SBI82YHA7752131,24,22,20,2,1
SBI51XCI6252656,61,22,12,10,1
SBI24HRU0396283,82,19,15,4,1
SBI03FZY5819833,21,22,18,4,1
SBI28YQX0682924,22,30,19,11,1
SBI38NZS2861173,94,22,16,6,1
SBI71ITA6697202,64,23,14,9,1
SBI82LTE8108382,97,25,24,1,1
SBI91YSY8602369,80,21,14,7,1
SBI08MWD3238305,61,23,19,4,1
SBI20NNU4056025,66,26,17,9,1
SBI02DYO3389594,80,15,9,6,1
SBI03BJC9328677,75,26,22,4,1
SBI20WPZ5751801,87,31,17,14,1
SBI05FIG8640133,21,27,18,9,1
SBI36SDE0047327,89,19,11,8,1
SBI85BXC0773753,84,26,20,6,1
SBI71SZJ1117945,24,23,18,5,1
SBI07MFD9892300,80,22,15,7,1
SBI64OLF6973894,61,27,26,1,1
SBI16ZWG7819634,64,27,14,13,1
SBI44CLZ3593887,91,27,23,4,1
SBI23ZUD7139543,83,27,19,8,1
SBI48UOY6476588,65,30,26,4,1
SBI45MLN1102914,75,25,20,5,1
SBI14IOO6111940,19,27,20,7,1
SBI77XDJ3691929,85,20,15,5,1
SBI15CSA9558688,89,20,17,3,1
SBI24EDH5978157,24,11,8,3,1
SBI62GVT4675416,88,25,13,12,1
SBI45UQY4357518,80,24,15,9,1
SBI53YXQ8844110,68,30,27,3,1
SBI40GMX2922873,20,27,17,10,1
SBI71IGG2734996,63,24,17,7,1
SBI60FME2655043,18,30,17,13,1
SBI36RNL9570172,81,24,21,3,1
SBI74PWJ9356427,77,22,21,1,1
SBI30QDM4419243,99,29,27,2,1
SBI81FJL6762432,73,21,17,4,1
SBI68DRT3829568,18,19,16,3,1
SBI96NZS2148221,99,27,16,11,1
SBI03QVV2821364,85,33,25,8,1
SBI21ZDN4567936,84,18,14,4,1
SBI43CVU6971790,69,25,19,6,1
SBI19TMY6704244,25,24,21,3,1
SBI33QBB0572701,64,22,17,5,1
SBI23JKB0274110,25,20,17,3,1
SBI54KPZ1189868,96,18,15,3,1
SBI04VLC0527979,96,28,22,6,1
SBI49PGF1328964,73,23,13,10,1
SBI63AMM2654337,93,21,18,3,1
SBI35DZZ8830326,61,20,18,2,1
SBI17HKM6279492,98,28,27,1,1
SBI19PAK1773243,67,18,17,1,1
SBI27ZGU0052414,66,25,20,5,1
SBI43OZV7442946,95,22,17,5,1
SBI49ZTH7102162,25,20,17,3,1
SBI71IFE5144482,79,26,17,9,1
SBI19AMP3141500,97,18,14,4,1
SBI84OTS5236991,79,26,25,1,1
SBI01YSJ7978776,70,24,18,6,1
SBI80BZR2267496,60,22,12,10,1
SBI96FMR9560315,91,26,22,4,1
SBI46TXZ6903343,22,15,8,7,1
SBI60QYL2226338,64,28,16,12,1
SBI41JKH8207104,70,27,16,11,1
SBI68ADZ1534453,97,22,17,5,1
SBI23RDC7932700,73,25,18,7,1
SBI94GEI8838948,89,29,27,2,1
SBI10FHZ8684432,19,23,20,3,1
SBI38YGC0031504,23,11,7,4,1
SBI26HVS1743241,22,23,13,10,1
SBI71BTU9217351,60,33,22,11,1
SBI27DUW2551295,70,32,27,5,1
SBI96JNA5320231,70,27,16,11,1
SBI59RMK5381249,23,22,21,1,1
SBI18RVA2142135,22,31,28,3,1
SBI81JJX4211448,99,22,20,2,1
SBI26OFD3728011,72,32,22,10,1
SBI80HLB0581480,95,32,28,4,1
SBI91MCK8196740,88,30,24,6,1
SBI42NIG7596245,90,33,19,14,1
SBI86ICA0535639,88,27,25,2,1
SBI15HLE6563089,80,13,12,1,1
SBI84CJJ7654371,85,32,24,8,1
SBI68ALU5935959,66,18,14,4,1
SBI43UPC7563336,18,20,13,7,1
SBI81RWB5462658,68,25,18,7,1
SBI43MZB4787007,21,29,25,4,1
SBI30GGB4000178,99,25,16,9,1
SBI81TXD6767391,78,28,17,11,1
SBI52CDD5307231,76,29,22,7,1
SBI99UKX9423137,95,25,20,5,1
SBI58QJY8634640,92,25,14,11,1
SBI69YML0545767,25,21,20,1,1
SBI81WPD3077860,21,24,16,8,1
SBI34EYB8365571,70,17,12,5,1
SBI73KJA7863550,66,23,18,5,1
SBI96VYS3930646,62,19,13,6,1
SBI10KAN3294499,20,21,20,1,1
SBI49JFI1420132,21,24,14,10,1
SBI64TGH5206406,73,26,18,8,1
SBI37FDG3553262,89,22,19,3,1
SBI02OKI1366499,69,25,19,6,1
SBI94EES5761715,64,21,17,4,1
SBI51XXM2869091,24,33,32,1,1
SBI92NXR1725150,74,20,17,3,1
SBI12VQZ2863213,67,30,19,11,1
SBI50CAG5541099,68,27,25,2,1
SBI20XGB3216152,70,28,25,3,1
SBI57VFL6071136,81,24,15,9,1
SBI46NTJ2917984,68,24,23,1,1
SBI94MGG7597114,71,28,26,2,1
SBI10YRH6890021,88,28,21,7,1
SBI21ZJK8887121,95,26,22,4,1
SBI67RRD0388784,85,34,32,2,1
SBI79QFU8031569,99,28,24,4,1
SBI33EZW8659375,60,24,22,2,1
SBI16THS5188728,85,27,22,5,1
SBI97JXV3752087,85,27,26,1,1
SBI55QWG5523386,88,21,13,8,1
SBI69YSZ7506751,75,30,20,10,1
SBI71UIV1064057,67,19,15,4,1
SBI80XOZ1164081,87,24,19,5,1
SBI16RRB7016640,78,24,18,6,1
SBI37POR3414259,76,23,16,7,1
SBI39LIB1751855,94,18,16,2,1
SBI74JKQ4594907,63,22,16,6,1
SBI66ASF1254752,83,28,21,7,1
SBI96KBH7645205,72,31,23,8,1
SBI04KLC9104381,82,19,13,6,1
SBI59IHX2466808,91,21,17,4,1
SBI40WLK4328749,25,31,23,8,1
SBI68QAS6206032,69,26,21,5,1
SBI77NFO4091801,65,33,18,15,1
SBI27HCW2566681,75,24,21,3,1
SBI83VXB8897218,77,32,25,7,1
SBI06GIX0266398,65,12,8,4,1
SBI04XZL2107264,93,22,20,2,1
SBI02RCM9717634,79,22,21,1,1
SBI40MHI9449928,71,20,16,4,1
SBI94RKA2177972,20,27,20,7,1
SBI99UNH1496789,90,27,18,9,1
SBI90YFY8780385,74,23,18,5,1
SBI40OLS0385946,83,31,25,6,1
SBI40UUY0856232,75,22,17,5,1
SBI82HYY1111112,92,30,26,4,1
SBI06VUT5005617,88,21,16,5,1
SBI67ARI4926384,21,16,15,1,1
SBI93YBV0291244,18,28,23,5,1
SBI00LNH1383956,21,28,24,4,1
SBI42XND7612527,23,17,9,8,1
SBI55CDT8762079,68,23,15,8,1
SBI84PAG6287777,25,12,11,1,1
SBI85JJO9582118,63,23,22,1,1
SBI14RKG4085244,63,29,26,3,1
SBI29ROD6214763,65,25,17,8,1
SBI69PNS1302081,97,19,12,7,1
SBI32NGZ9971803,75,30,28,2,1
SBI76URF1427213,66,27,21,6,1
SBI06MSC3851244,75,24,16,8,1
SBI83TYS8036904,80,18,14,4,1
SBI35HEH3868668,98,22,14,8,1
SBI85LYW1559626,63,24,13,11,1
SBI70SET1918878,22,36,28,8,1
SBI85HCM8545402,92,18,16,2,1
SBI89DVK8835131,78,28,25,3,1
SBI19ZUJ1386987,82,23,12,11,1
SBI68NHT3884344,70,17,10,7,1
SBI79ETI4702503,68,22,13,9,1
SBI71LVH5344781,74,19,13,6,1
SBI19WAN5040121,79,23,19,4,1
SBI34RGL3242736,99,35,18,17,1
SBI06EVS1665046,62,20,16,4,1
SBI34GBE7937187,62,20,18,2,1
SBI88PKO2548283,62,28,22,6,1
SBI79ZNI3655088,94,22,18,4,1
SBI41IAF3623922,94,26,19,7,1
SBI80QEA0944397,94,27,20,7,1
SBI40YSK7894032,61,18,14,4,1
SBI15WZE5024370,25,24,21,3,1
SBI24BYO5730685,67,29,22,7,1
SBI83PWK3178219,73,24,13,11,1
SBI40YHY8219227,80,18,12,6,1
SBI59XOT5485918,70,27,18,9,1
SBI31WTW4831010,63,21,18,3,1
SBI73AHZ5685010,72,22,14,8,1
SBI96BVF6096691,85,22,15,7,1
SBI61KAN4888554,62,23,16,7,1
SBI43WWV4815767,22,18,12,6,1
SBI64IOZ4825467,21,20,15,5,1
SBI55GHJ4725447,91,18,15,3,1
SBI33ALB6055515,97,20,15,5,1
SBI86TKK9864729,94,24,21,3,1
SBI05OCO3285701,98,35,33,2,1
SBI27PVR5300469,62,27,19,8,1
SBI27FMX5941641,89,24,23,1,1
SBI02MGV6963074,62,19,14,5,1
SBI94VCN0853287,62,23,22,1,1
SBI49XAX6425201,94,26,25,1,1
SBI44QXI4154122,65,29,16,13,1
SBI68FFH4424804,90,31,25,6,1
SBI08IGF0061700,81,25,13,12,1
SBI07YYE5691515,21,24,15,9,1
SBI07YDG7973605,19,18,17,1,1
SBI22EVG7083458,81,34,33,1,1
SBI38VPG4962429,20,24,19,5,1
SBI95SGL6585015,73,22,15,7,1
SBI57TQN4331179,82,24,20,4,1
SBI44YNC1954249,83,27,17,10,1
SBI33PKB6318928,90,27,24,3,1
SBI04BPW5460632,97,16,15,1,1
SBI25BEC5083331,91,33,25,8,1
SBI91ZIL1884087,72,27,17,10,1
SBI43ELC0556903,24,11,10,1,1
SBI54BNQ5070052,66,22,19,3,1
SBI27QXP6827584,82,26,18,8,1
SBI95FHI1649437,92,21,15,6,1
SBI66JBK0170281,21,21,14,7,1
SBI90QAH5767552,94,23,13,10,1
SBI05FKH4984581,82,16,9,7,1
SBI98NBQ0315005,97,30,16,14,1
SBI95CLP2719821,91,27,24,3,1
SBI08FHG4993906,91,16,9,7,1
SBI98OJX9422647,90,25,14,11,1
SBI19RUY2568140,95,21,18,3,1
SBI85TUC4594921,22,23,18,5,1
SBI46JAP1353265,91,21,12,9,1
SBI74ZEI9223442,81,26,17,9,1
SBI69BEL4941839,24,29,24,5,1
SBI28OVS0986813,25,24,23,1,1
SBI11AXI1515168,21,19,15,4,1
SBI45LVG1507924,67,22,13,9,1
SBI67MOQ0860286,63,24,19,5,1
SBI42QWK1560573,61,18,11,7,1
SBI77GDG9333942,94,27,18,9,1
SBI57MYT6932948,18,26,17,9,1
SBI79COV1045506,71,20,13,7,1
SBI72PBJ5875497,97,28,20,8,1
SBI77EPA0122525,63,23,18,5,1
SBI77XXQ0811843,21,29,25,4,1
SBI94UTF3165618,98,22,18,4,1
SBI34WRJ6239245,80,31,24,7,1
SBI48AUC1204396,20,28,15,13,1
SBI69KEM1733476,87,25,22,3,1
SBI54FKR9556268,86,38,26,12,1
SBI80EWN5716884,92,28,17,11,1
SBI74FVY8844944,62,32,19,13,1
SBI84TKU1246461,96,26,18,8,1
SBI68SPC6806084,22,20,17,3,1
SBI49UXW0086857,72,29,28,1,1
SBI31SRD2094094,78,30,22,8,1
SBI91IRP6189057,85,32,24,8,1
SBI43XWT8200571,87,26,19,7,1
SBI65QGP8241674,73,22,19,3,1
SBI94GSL9557285,72,22,13,9,1
SBI22AVE8545730,78,27,26,1,1
SBI85NBY5830290,87,24,14,10,1
SBI29GWB5999940,18,25,16,9,1
SBI71WXX0798106,19,26,23,3,1
SBI14LJO7791263,75,27,26,1,1
SBI69SKB4847441,65,31,23,8,1
SBI98OVA4480958,61,23,19,4,1
SBI57AHG6237230,67,26,14,12,1
SBI53BJB7735616,73,19,15,4,1
SBI44QYE9812047,69,24,23,1,1
SBI90EJS9149190,84,24,22,2,1
SBI90DWS6600330,72,28,17,11,1
SBI44BXV9149122,97,25,17,8,1
SBI63TUW0268202,96,22,16,6,1
SBI31OMU8958603,80,26,14,12,1
SBI02TXK5921446,68,26,22,4,1
SBI85MHF5781220,74,29,27,2,1
SBI12DJC6166891,62,26,14,12,1
SBI09NBU7990049,97,27,19,8,1
SBI52MTD7929713,64,15,8,7,1
SBI61TGP5647959,96,20,19,1,1
SBI90JOI5736898,80,35,20,15,1
SBI20NUJ5615380,20,24,15,9,1
SBI03GJX5913567,25,19,18,1,1
SBI63VRU3890764,63,28,20,8,1
SBI69OQJ2714478,83,26,18,8,1
SBI87BXW4350208,77,25,16,9,1
SBI54NRO4119048,82,21,15,6,1
SBI81XZG5091681,62,28,17,11,1
SBI46EZP4492132,81,19,18,1,1
SBI60TVK7819877,76,25,22,3,1
SBI81QVR5134329,68,20,12,8,1
SBI20RTQ9292791,97,21,17,4,1
SBI57KKR6202478,77,25,18,7,1
SBI05DQH3009636,22,28,20,8,1
SBI53RSU0743715,83,22,20,2,1
SBI36JYW7146586,62,30,27,3,1
SBI49CQH3621750,85,18,11,7,1
SBI96WNB8699353,23,34,20,14,1
SBI22LNG7653921,21,29,17,12,1
SBI77FJB4389086,86,20,13,7,1
SBI87GRB4182176,66,22,13,9,1
SBI19UNK3317221,99,20,17,3,1
SBI99EYC4642096,78,22,12,10,1
SBI59IWU6431767,68,22,13,9,1
SBI35FVX2144886,89,19,14,5,1
SBI69JZD0469366,84,22,16,6,1
SBI93TCF4487515,98,27,20,7,1
SBI10QNT7521100,79,30,16,14,1
SBI12POT5156331,23,29,27,2,1
SBI64ZAD6085878,95,20,13,7,1
SBI86CDC3918871,77,28,25,3,1
SBI71WVF4358962,94,23,14,9,1
SBI33WSQ4618228,22,30,21,9,1
SBI75ZPN5052250,95,28,24,4,1
SBI74CEE8856424,90,20,14,6,1
SBI80TFS8433884,85,26,18,8,1
SBI75GJU6156540,70,22,12,10,1
SBI07PUB1828419,90,23,19,4,1
SBI98ZEG1153020,18,25,13,12,1
SBI82TWG1181611,94,16,9,7,1
SBI45RKD2686362,92,27,16,11,1
SBI35LRZ5938842,72,20,11,9,1
SBI30QNR9108701,75,25,15,10,1
SBI43WPH9255545,92,27,22,5,1
SBI76DMG1809224,73,25,18,7,1
SBI81LWN2378512,68,34,18,16,1
SBI42XBZ9428582,67,33,23,10,1
SBI21ENS9411572,93,24,13,11,1
SBI34RLN8311407,18,25,21,4,1
SBI80PRY2011443,83,20,12,8,1
SBI91GFK0329643,74,20,19,1,1
SBI50LFU0236048,80,24,17,7,1
SBI44LMN6510028,98,32,24,8,1
SBI34HDW0159069,89,19,13,6,1
SBI25TYU2505317,21,24,13,11,1
SBI01ZQN2921835,89,25,22,3,1
SBI30KEG5114774,82,23,22,1,1
SBI25WOD2527212,79,22,20,2,1
SBI25SYY0996224,84,33,26,7,1
SBI29KHE5992733,76,31,24,7,1
SBI87JQZ7823602,72,30,24,6,1
SBI20TDN5990306,95,16,12,4,1
SBI91ZOI3244157,65,28,24,4,1
SBI82WJE9794075,20,30,24,6,1
SBI20CEK6378941,25,32,18,14,1
SBI52HFJ0563141,62,20,18,2,1
SBI71RJY2116850,83,25,22,3,1
SBI27GIU2061771,77,25,24,1,1
SBI62XJI3356018,61,23,14,9,1
SBI64NDQ8811085,70,15,13,2,1
SBI18LMT7322095,74,14,11,3,1
SBI26QAL0729066,98,22,18,4,1
SBI56QSY9716438,65,17,10,7,1
SBI35LZK6939704,66,28,20,8,1
SBI07JIV5269948,71,26,24,2,1
SBI01BVP4382255,79,13,12,1,1
SBI13SGU0033011,83,27,21,6,1
SBI58QGG9399899,96,26,16,10,1
SBI37WDB6282179,78,32,22,10,1
SBI00YTI2484561,79,15,8,7,1
SBI44GQA7521059,99,22,13,9,1
SBI51LSJ4050669,92,23,16,7,1
SBI55LKD4724564,69,19,16,3,1
SBI64GIK1318042,78,29,27,2,1
SBI75IZN8754690,95,20,15,5,1
SBI94GUM8083328,97,27,20,7,1
SBI93THX9865772,69,26,24,2,1
SBI24QGS7440881,75,24,20,4,1
SBI90BKR0075327,87,23,17,6,1
SBI33HPD6120197,62,26,24,2,1
SBI25HZL9169299,67,26,20,6,1
SBI49POF9572087,64,30,27,3,1
SBI17RCX0328486,78,26,21,5,1
SBI66SIE9685441,63,27,21,6,1
SBI02OZN7378175,93,30,27,3,1
SBI75SSB6815305,83,12,9,3,1
SBI64SZM1087153,20,18,14,4,1
SBI46MHP8559846,78,24,13,11,1
SBI17HVY7757840,19,24,19,5,1
SBI13WGF5878414,64,20,18,2,1
SBI10PLV7361328,60,22,20,2,1
SBI55AUT9962467,72,22,19,3,1
SBI48ARQ9573331,80,22,14,8,1
SBI47IGS1630652,21,29,25,4,1
SBI08SLX0761394,86,19,10,9,1
SBI52KKH0295260,99,35,18,17,1
SBI92FZY2636939,66,29,17,12,1
SBI46BPE3246546,23,21,18,3,1
SBI29BAM9953136,65,22,19,3,1
SBI49WVO3293968,78,23,15,8,1
SBI23QRL2958954,24,26,17,9,1
SBI15TRK4276626,76,25,15,10,1
SBI95IGZ2218537,96,29,24,5,1
SBI57MBA8364870,85,16,14,2,1
SBI10POV9848127,67,25,15,10,1
SBI58DXL0662843,84,25,16,9,1
SBI72CSH7287056,79,32,27,5,1
SBI03EGF1941796,93,16,14,2,1
SBI63RXU8367331,91,24,23,1,1
SBI57JMN4975968,67,20,11,9,1
SBI25JSK9021758,83,28,27,1,1
SBI84GYT2940073,71,29,16,13,1
SBI47OPV5586410,82,25,16,9,1
SBI74ARU7184096,96,22,19,3,1
SBI44AXY9743022,20,24,20,4,1
SBI41NGJ6410048,62,28,18,10,1
SBI48LEH4077123,24,31,30,1,1
SBI96KNX7830347,77,27,24,3,1
SBI02AZI5913653,76,24,14,10,1
SBI02RKB5590503,84,24,21,3,1
SBI17QKJ6464759,65,28,17,11,1
SBI02UDW4223567,79,25,23,2,1
SBI98BXS1541974,63,24,15,9,1
SBI89KLX4546726,74,24,19,5,1
SBI93OGS8831130,93,26,22,4,1
SBI49INT6932245,83,27,14,13,1
SBI88KHL0591684,79,23,18,5,1
SBI18DRV3567348,61,24,18,6,1
SBI15LSH9105855,61,19,12,7,1
SBI38QAL2219284,60,23,16,7,1
SBI00OGA9290456,87,25,14,11,1
SBI39TCJ0989590,79,24,22,2,1
SBI23QFZ2544347,76,20,16,4,1
SBI09GOG8358852,86,29,23,6,1
SBI32HLW5253118,73,26,14,12,1
SBI34CUR6074404,21,34,27,7,1
SBI72RAA1593266,90,27,21,6,1
SBI64DQO2643112,64,22,17,5,1
SBI76ZAC4215341,89,25,14,11,1
SBI47QVF6698841,63,19,11,8,1
SBI18FHE3648150,19,26,24,2,1
SBI96LSG9603121,65,19,12,7,1
SBI01FWF9660340,72,28,19,9,1
SBI45YZE0211294,25,31,30,1,1
SBI37GIC0908133,79,20,18,2,1
SBI68ZJT5866403,71,19,13,6,1
SBI86XNK8400234,90,24,21,3,1
SBI56CVI2528370,81,28,15,13,1
SBI50KAP1280071,92,26,21,5,1
SBI17YKS5279412,60,32,27,5,1
SBI12HED7647356,24,22,12,10,1
SBI15AMH9868041,95,28,21,7,1
SBI53BXF8937277,81,30,21,9,1
SBI62YCX8757650,91,23,22,1,1
SBI45DYY5401059,66,23,22,1,1
SBI19ABU6260568,69,25,18,7,1
SBI78AWD8160935,67,22,20,2,1
SBI08GER2011084,86,21,15,6,1
SBI97BJT1764503,98,28,23,5,1
SBI38TSR0238429,67,27,21,6,1
SBI88LPW1670814,97,21,17,4,1
SBI02GYX1276908,63,24,14,10,1
SBI32DDE9950772,22,21,16,5,1
SBI92DQP8482249,98,20,16,4,1
SBI29VPL5693610,21,30,23,7,1
SBI04FEX0590316,72,27,17,10,1
SBI01EKW8297238,68,16,10,6,1
SBI15FOW9754191,21,23,21,2,1
SBI87HCF1419686,78,24,20,4,1
SBI15YWH5326942,67,27,25,2,1
SBI23MWQ8236514,81,22,21,1,1
SBI45NGK9456907,74,30,24,6,1
SBI67QBK4019184,97,26,25,1,1
SBI62JSB5106525,97,31,26,5,1
SBI16GKM1697139,75,19,10,9,1
SBI72YKU4282185,62,23,22,1,1
SBI65SBM8666942,77,24,18,6,1
SBI58MST0715027,76,23,20,3,1
SBI33BUX0055271,78,25,14,11,1
SBI87UEW9516631,94,21,12,9,1
SBI49GXE9363428,71,22,14,8,1
SBI86QYV8927060,67,21,20,1,1
SBI85IPS6574100,21,26,15,11,1
SBI05LSC0401390,80,26,17,9,1
SBI14EQC1524870,94,22,21,1,1
SBI77LAE5619081,82,28,18,10,1
SBI37FOT9950240,64,17,16,1,1
SBI06VQK4267422,74,25,19,6,1
SBI83EGJ2150114,76,23,19,4,1
SBI25BXZ5907565,64,19,12,7,1
SBI52FIR4348865,84,25,18,7,1
SBI46SLY0094847,62,37,24,13,1
SBI01UVX1002210,82,19,10,9,1
SBI20IIO5733048,79,21,15,6,1
SBI57JCK8916951,77,33,28,5,1
SBI48AME4541965,83,30,23,7,1
SBI80KSU2197319,91,20,11,9,1
SBI89IKW0954981,87,17,13,4,1
SBI24CRZ6292324,73,24,21,3,1
SBI88MBF5727578,73,20,14,6,1
SBI60UXK4915362,75,31,17,14,1
SBI52UHZ9249478,90,29,27,2,1
SBI57QWU9207001,91,22,15,7,1
SBI99MFE8481053,97,24,13,11,1
SBI71ZCK9799781,60,26,21,5,1
SBI97VSB9044043,63,38,27,11,1
SBI88FMH6269908,81,22,19,3,1
SBI84KHV1760432,68,23,19,4,1
SBI63RYO7651448,92,34,23,11,1
SBI38IZW2512173,72,16,13,3,1
SBI34GKE5024942,84,32,19,13,1
SBI35NZG0240257,99,23,21,2,1
SBI77LFI5918460,94,18,11,7,1
SBI02MIS6966318,94,23,15,8,1
SBI92WFY0264241,77,25,14,11,1
SBI95YQO9979414,84,26,20,6,1
SBI72YDZ9463630,77,17,13,4,1
SBI25KZK5295786,94,24,17,7,1
SBI72MHO7063366,65,21,20,1,1
SBI20QHX8540861,82,34,28,6,1
SBI08RUN3934117,24,14,9,5,1
SBI37FFA0516615,94,21,19,2,1
SBI66NVG0246366,99,22,13,9,1
SBI76CNE6152615,60,26,22,4,1
SBI25AIX5923103,73,22,16,6,1
SBI25VEX7852278,81,27,23,4,1
SBI85MKX3089837,61,33,29,4,1
SBI71EEG9317284,96,33,18,15,1
SBI56USQ3869269,86,32,26,6,1
SBI15GXW2068695,25,23,13,10,1
SBI23ZNR5488277,87,22,12,10,1
SBI65HCN4806095,61,29,16,13,1
SBI43NPV1361859,83,34,24,10,1
SBI95LJQ8110300,65,23,22,1,1
SBI56XUR5926242,86,28,24,4,1
SBI28ZYU1418364,61,20,17,3,1
SBI79IDY9868395,89,20,11,9,1
SBI96XNY2869563,78,30,21,9,1
SBI80QOK4170556,22,27,26,1,1
SBI72GNQ5762540,81,19,11,8,1
SBI86SAD6878221,78,23,17,6,1
SBI40FYY0945413,96,19,18,1,1
SBI17UVZ9099982,75,29,16,13,1
SBI34ZJU3122438,90,25,19,6,1
SBI96YMQ0333338,92,27,18,9,1
SBI44CLU7371639,70,27,21,6,1
SBI91YYE5003333,69,15,11,4,1
SBI18OYE1201620,88,19,17,2,1
SBI59XUP0259259,68,27,20,7,1
SBI25XRP5191007,86,21,18,3,1
SBI54KNC2677605,67,18,17,1,1
SBI13XGJ0909182,71,36,22,14,1
SBI27KYS4754319,79,13,9,4,1
SBI09RSN4730974,85,23,14,9,1
SBI75ROV5222036,99,33,31,2,1
SBI72WBL4564039,61,15,11,4,1
SBI75YRT2720624,75,20,11,9,1
SBI79HVV8102316,83,22,19,3,1
SBI64KFC6528696,70,22,13,9,1
SBI82EJT8460247,68,27,16,11,1
SBI56VXC3529768,94,22,13,9,1
SBI07JCU5694556,18,25,15,10,1
SBI88QXW7413308,80,26,20,6,1
SBI72TRD3759545,23,15,13,2,1
SBI64ATB8654617,63,18,17,1,1
SBI74PSA8351643,62,21,13,8,1
SBI52YKL7269259,94,27,23,4,1
SBI74TLV5965645,84,24,22,2,1
SBI11FZV6391113,83,25,19,6,1
SBI01EWL6691573,94,17,11,6,1
SBI05VXJ7572650,65,29,21,8,1
SBI98GYO2824345,25,26,17,9,1
SBI06SQX0128871,84,22,16,6,1
SBI98NOV5063415,90,28,23,5,1
SBI27OIO5202665,78,26,20,6,1
SBI93YIP3064291,96,26,15,11,1
SBI08JYQ7742088,85,24,16,8,1
SBI94IHU7817158,61,29,22,7,1
SBI16XCS3114687,97,19,13,6,1
SBI18JKW3422938,96,21,16,5,1
SBI42MQN2925981,67,27,26,1,1
SBI24FME2066184,60,18,12,6,1
SBI62FJU9210243,85,17,11,6,1
SBI15VRF2220288,98,16,11,5,1
SBI88TEG6384665,80,30,18,12,1
SBI97PKJ0812627,79,29,17,12,1
SBI00RFT5319126,75,24,18,6,1
SBI72XTA2229441,81,22,14,8,1
SBI51DLR0421222,99,21,12,9,1
SBI71NQN8721456,90,21,19,2,1
SBI82UBX5336285,20,32,21,11,1
SBI69VGG9187482,75,32,22,10,1
SBI46LFM0843506,60,19,17,2,1
SBI09ESR1669356,91,30,26,4,1
SBI92XBQ9520175,74,22,12,10,1
SBI54KEJ4724192,74,28,19,9,1
SBI29ZIV3449828,24,31,21,10,1
SBI72HQW8433823,94,20,14,6,1
SBI02LHZ7375445,84,23,21,2,1
SBI75DCS7267135,79,29,15,14,1
SBI55HUS0020170,72,22,15,7,1
SBI22EMH3047683,87,19,12,7,1
SBI03WTJ0201392,95,26,25,1,1
SBI58IUH3664776,80,30,19,11,1
SBI08ZOB2453354,79,16,9,7,1
SBI93QGZ0690473,87,24,16,8,1
SBI68SEI1460193,95,25,19,6,1
SBI02BXU3899051,78,23,13,10,1
SBI06VMA4356442,98,22,14,8,1
SBI60ILH9207674,75,27,18,9,1
SBI78AFZ5660334,66,28,19,9,1
SBI64UKH0905631,72,22,18,4,1
SBI62YZR3604739,76,25,16,9,1
SBI99JBH3817958,72,20,18,2,1
SBI35JLR7992177,22,26,17,9,1
SBI79VQG8039523,72,21,13,8,1
SBI21LNB1697628,78,25,19,6,1
SBI80ATH6651134,60,28,15,13,1
SBI68RTI7546794,61,22,12,10,1
SBI58GON0763866,75,25,19,6,1
SBI48PPL1088731,91,19,11,8,1
SBI55YYQ4421446,63,28,24,4,1
SBI93YSU8477736,60,21,17,4,1
SBI00EMS2586206,75,29,26,3,1
SBI73IEX3061260,66,22,17,5,1
SBI00VHI1131803,86,24,23,1,1
SBI48SML3567384,22,25,14,11,1
SBI01JQS4862766,24,13,9,4,1
SBI09VCV6587787,96,16,10,6,1
SBI35XDW9129036,83,26,14,12,1
SBI31VZI8326794,83,23,18,5,1
SBI01QVW6602692,20,17,9,8,1
SBI67RYC3932568,88,23,16,7,1
SBI19RQH1846650,61,23,15,8,1
SBI00HPF5709735,93,19,15,4,1
SBI97VML6866465,65,18,14,4,1
SBI90ULQ0208093,93,22,14,8,1
SBI93ZWK3412640,75,29,27,2,1
SBI13NZH1547414,82,27,21,6,1
SBI45ADA8503445,62,29,24,5,1
SBI83ZPJ7560573,24,21,16,5,1
SBI35ZFX8539417,82,25,19,6,1
SBI85LCV8958507,64,15,13,2,1
SBI51FHX9532334,78,32,22,10,1
SBI86JXK8813744,73,23,19,4,1
SBI29KZF0593293,19,35,26,9,1
SBI43CBX2339180,60,22,21,1,1
SBI88TQT5805777,90,23,22,1,1
SBI14QML9694175,90,21,14,7,1
SBI89JHE9810205,64,13,9,4,1
SBI73NNA2036102,62,23,12,11,1
SBI06INY4447036,75,23,21,2,1
SBI86UEG5685608,65,32,24,8,1
SBI69TUB7234737,63,22,12,10,1
SBI60OUI7456970,99,22,18,4,1
SBI05WLJ2193669,67,32,26,6,1
SBI42RQE7443947,79,24,22,2,1
SBI44KEW7508950,98,23,16,7,1
SBI08RCB4708794,70,28,21,7,1
SBI82PIJ2751558,69,22,13,9,1
SBI68GMZ3406882,92,24,21,3,1
SBI47FWJ1300406,61,19,12,7,1
SBI50RLA0165529,74,24,13,11,1
SBI41KAT5422652,80,21,20,1,1
SBI14DOP1959345,93,21,19,2,1
SBI22YBM6752620,74,35,26,9,1
SBI98RNN7689992,92,19,12,7,1
SBI49AFQ8763026,91,22,17,5,1
SBI01NFV5922212,75,22,13,9,1
SBI97TIS5627955,93,24,20,4,1
SBI29WWH8999363,18,27,16,11,1
SBI46ECX4712168,89,29,25,4,1
SBI91UKA1385449,23,31,22,9,1
SBI71EMI3863948,76,29,26,3,1
SBI29WFJ9170619,77,28,21,7,1
SBI83GEM8532540,64,26,24,2,1
SBI68UJR8912696,63,33,23,10,1
SBI82IVR9030435,91,38,28,10,1
SBI77VDJ4458293,25,30,20,10,1
SBI52LZH6889736,69,20,18,2,1
SBI47ITZ8424666,63,20,16,4,1
SBI13IXS8478753,18,27,23,4,1
SBI98LUO5470942,80,33,20,13,1
SBI36ARY0180596,75,28,16,12,1
SBI52EGF0959964,86,24,15,9,1
SBI06NYE1818325,63,27,18,9,1
SBI33GBY3010469,19,19,16,3,1
SBI08OLQ8171292,80,27,22,5,1
SBI23NZB6307369,78,23,12,11,1
SBI92TPV9943368,95,23,19,4,1
SBI81VFL5471000,97,20,12,8,1
SBI93MTG2191461,25,13,9,4,1
SBI73LZM8871543,90,20,17,3,1
SBI24GTU9461926,70,32,28,4,1
SBI22ASV1950191,25,16,11,5,1
SBI24NZH4246639,98,23,15,8,1
SBI77MRA4578790,63,28,19,9,1
SBI60ZKY0289072,24,32,23,9,1
SBI33RTB8460083,80,21,20,1,1
SBI83MZB0801492,78,21,11,10,1
SBI61ENC9918025,70,22,19,3,1
SBI22WQO7906109,96,30,28,2,1
SBI38EVC7154206,87,27,17,10,1
SBI35LOS4450184,66,26,24,2,1
SBI51VQX0880372,91,22,21,1,1
SBI15DQL5617105,87,26,24,2,1
SBI69NEJ6482250,86,24,14,10,1
SBI24HRK1329061,84,32,22,10,1
SBI02MZT4073634,74,23,20,3,1
SBI92RFB4179451,84,25,18,7,1
SBI50OFD5840191,93,24,22,2,1
SBI42CWR8045224,64,27,22,5,1
SBI74NHW8278788,65,29,25,4,1
SBI33ZOO5726189,23,29,24,5,1
SBI54MKS3288749,62,25,17,8,1
SBI84DCN2765299,85,30,26,4,1
SBI90KPJ6920355,25,23,21,2,1
SBI03JZT9447057,25,17,15,2,1
SBI40XMQ6074733,71,20,18,2,1
SBI38AKH5182504,21,19,18,1,1
SBI55SDM0242587,65,25,18,7,1
SBI01XDN5364850,69,18,14,4,1
SBI87EOT8626379,65,19,15,4,1
SBI52NWV9826121,62,17,13,4,1
SBI57OHF4630664,99,17,9,8,1
SBI26ZSQ8885996,61,31,18,13,1
SBI32PPC4013623,75,25,20,5,1
SBI67DVL1373895,76,24,22,2,1
SBI42FAG8692728,23,31,19,12,1
SBI80IFP9499017,78,24,19,5,1
SBI26LFX1421851,76,25,19,6,1
SBI52AXX5737856,97,18,17,1,1
SBI72GHL1974162,96,21,15,6,1
SBI37DHO7041052,23,36,19,17,1
SBI62VSM1478912,70,21,13,8,1
SBI46VTH1616332,79,25,23,2,1
SBI70NGG0250439,83,16,11,5,1
SBI57FYI7452456,73,21,16,5,1
SBI49AHY1944450,80,30,20,10,1
SBI52HQF9361202,62,23,18,5,1
SBI02AVR4556983,70,30,24,6,1
SBI76CPG1491518,87,27,21,6,1
SBI85MBE3271773,71,27,22,5,1
SBI08QUA6180167,84,21,16,5,1
SBI37GST9620875,86,16,9,7,1
SBI53BWT4584465,20,21,15,6,1
SBI19FWZ8236843,69,30,25,5,1
SBI80XBS9449399,18,22,16,6,1
SBI92HJT8852153,89,29,15,14,1
SBI38BRZ4592343,88,26,19,7,1
SBI74DPV1076947,87,17,13,4,1
SBI44OJT6917836,62,21,17,4,1
SBI82UQR6266282,64,26,18,8,1
SBI93RRS5074482,73,20,17,3,1
SBI19XZZ9635405,84,29,21,8,1
SBI10DIH7427587,22,26,22,4,1
SBI19KWS1279302,95,17,11,6,1
SBI89REO1847610,75,33,20,13,1
SBI11JIZ6100989,77,11,8,3,1
SBI88OYB3434119,84,18,14,4,1
SBI60JBM2293605,99,28,25,3,1
SBI62GTD4670938,25,23,16,7,1
SBI50GAY5067962,91,31,24,7,1
SBI27LQY9175034,18,26,24,2,1
SBI03JQG6609961,86,22,16,6,1
SBI77CQD9072010,18,30,25,5,1
SBI07DDZ2914781,67,23,21,2,1
SBI54YKJ9297650,86,25,23,2,1
SBI04OHC4807372,77,25,18,7,1
SBI45RVI5396907,22,32,22,10,1
SBI01HQC6961031,98,20,11,9,1
SBI42GRT1609475,21,17,15,2,1
SBI74OVT7432405,98,30,22,8,1
SBI72AZK0075486,98,20,19,1,1
SBI53SOH6546720,96,33,20,13,1
SBI72JCK5602511,86,21,18,3,1
SBI22ILM5446968,23,30,18,12,1
SBI92LRL2626464,64,30,16,14,1
SBI17QUM1423621,76,24,19,5,1
SBI53ASC4641302,22,23,17,6,1
SBI85JJW1494541,63,19,18,1,1
SBI55FCH1807053,72,23,21,2,1
SBI63DMD7570964,95,16,11,5,1
SBI70KMQ2430225,98,32,31,1,1
SBI15IQU6400499,98,15,8,7,1
SBI78AVI9675832,72,26,25,1,1
SBI81YPE4787403,80,25,24,1,1
SBI83OUV6317330,77,23,19,4,1
SBI72XWP0795398,69,26,22,4,1
SBI91ILD2816610,83,26,21,5,1
SBI06TJN8084647,66,31,21,10,1
SBI72VYN5906479,91,19,16,3,1
SBI17NVX2168619,87,25,15,10,1
SBI13WVQ7927032,62,33,23,10,1
SBI67LAZ6215157,95,29,18,11,1
SBI64FGQ6039408,89,23,16,7,1
SBI05RWW9570525,80,22,12,10,1
SBI81BTO3155182,72,18,17,1,1
SBI79LVC0403254,70,29,23,6,1
SBI01JFW9319791,61,18,14,4,1
SBI24WSW7501538,76,21,12,9,1
SBI35ZHR5126367,64,20,14,6,1
SBI38QKW8165750,21,24,21,3,1
SBI80MPX2228845,87,23,21,2,1
SBI95EOH1124541,87,31,18,13,1
SBI45KSC8037009,19,24,15,9,1
SBI36KDO0530792,24,25,13,12,1
SBI67KVZ1483713,18,23,20,3,1
SBI20SHE3272419,66,30,16,14,1
SBI26LLL6620414,72,26,19,7,1
SBI49AXD4290406,19,27,15,12,1
SBI53MGO2701572,76,27,24,3,1
SBI41QYY3497020,60,22,18,4,1
SBI48JGO5206607,93,28,26,2,1
SBI22CWG1559663,62,23,13,10,1
SBI24HFQ5139907,76,34,19,15,1
SBI87RUL2938417,74,34,21,13,1
SBI18VSR5049461,82,15,10,5,1
SBI59XQT6295736,85,24,20,4,1
SBI83JPY5437924,68,23,21,2,1
SBI32FFF5031755,93,26,23,3,1
SBI07JIF0120108,60,18,11,7,1
SBI69PIC8262608,74,26,23,3,1
SBI89YAE8549292,76,20,16,4,1
SBI56QXD7552434,60,30,19,11,1
SBI01XYE6958774,85,31,17,14,1
SBI74HXB7676365,93,20,18,2,1
SBI61YER4781708,79,29,17,12,1
SBI52PTL8439972,91,22,14,8,1
SBI17ZRA2585028,94,19,14,5,1
SBI98QKT7705176,88,21,19,2,1
SBI23PBW2689612,24,25,22,3,1
SBI58PWP3458636,83,29,19,10,1
SBI04NZS8863803,67,26,16,10,1
SBI27SVM0309767,74,14,9,5,1
SBI74JEK3010079,91,13,12,1,1
SBI62ZLX9412879,70,18,16,2,1
SBI67XIP4797403,98,23,12,11,1
SBI00SPK9031707,69,21,15,6,1
SBI01TKH6494729,19,24,13,11,1
SBI69DTQ9169105,83,22,20,2,1
SBI59ENK4385481,67,20,13,7,1
SBI91GWQ0836078,88,24,20,4,1
SBI35TYA8826774,96,20,17,3,1
SBI88BKS1219760,94,27,17,10,1
SBI62KME2200679,64,28,21,7,1
SBI69DVX9397678,80,29,16,13,1
SBI22DQS7162389,60,28,25,3,1
SBI73BEO3192875,19,22,14,8,1
SBI43TCM0606474,72,21,13,8,1
SBI80CJO4455388,69,25,21,4,1
SBI52GUE9787086,67,29,28,1,1
SBI87YUO7750316,89,28,16,12,1
SBI40XRQ0559273,68,24,21,3,1
SBI41YPD8524894,18,19,10,9,1
SBI29JUK9795997,72,27,18,9,1
SBI03JOV2286503,70,29,15,14,1
SBI04BQF6678424,18,30,24,6,1
SBI84AEW9108393,99,30,28,2,1
SBI50DEJ0259116,18,28,19,9,1
SBI42AXM9218370,69,30,24,6,1
SBI47KOH8144922,70,34,33,1,1
SBI44ENT0839067,85,23,13,10,1
SBI23TDQ7363890,23,31,16,15,1
SBI56IXG3423091,70,26,24,2,1
SBI58FHF8829847,98,33,23,10,1
SBI71XQR5323330,22,19,11,8,1
SBI37MAH5428536,77,27,22,5,1
SBI03IQY8277558,65,24,18,6,1
SBI43WIK6296545,23,27,17,10,1
SBI05HMW9706401,84,22,12,10,1
SBI38XXL7150866,75,26,14,12,1
SBI07TFI4859046,20,26,20,6,1
SBI31EHC0618081,82,31,29,2,1
SBI20OQG8689551,85,16,9,7,1
SBI14AQO7239280,85,22,13,9,1
SBI88MYE6947965,24,17,14,3,1
SBI64NRM3215008,71,27,16,11,1
SBI95ICY6289287,93,19,16,3,1
SBI00INY2645701,78,31,28,3,1
SBI71YSQ3980485,78,29,16,13,1
SBI94QPN9463519,99,15,8,7,1
SBI55LBF6697226,73,20,11,9,1
SBI67BUN8762039,24,16,12,4,1
SBI16PBB9573641,78,16,10,6,1
SBI91HEG7506902,21,21,15,6,1
SBI58ICK0506419,73,34,25,9,1
SBI63TSO8164542,76,27,24,3,1
SBI41HEV7124004,75,23,13,10,1
SBI10FZB2294248,76,30,22,8,1
SBI47ZNA7382387,94,22,13,9,1
SBI69MZD0477406,77,26,24,2,1
SBI10QUR7907523,70,25,24,1,1
SBI97JMW5337127,97,30,23,7,1
SBI72YRD4652971,66,23,19,4,1
SBI12ZFP6771274,83,31,30,1,1
SBI17AGK6604994,61,29,26,3,1
SBI55ACR2409718,75,26,22,4,1
SBI90YSA3088039,99,36,32,4,1
SBI57RPN0339778,77,23,13,10,1
SBI29JSI1560742,90,17,10,7,1
SBI69SUV1171240,84,19,14,5,1
SBI89ZRE8620951,95,24,15,9,1
SBI18WFB0827903,67,25,19,6,1
SBI61FAS4137154,84,24,16,8,1
SBI54WXW3675276,18,20,11,9,1
SBI65DZE2619003,94,27,18,9,1
SBI50YME9790217,95,23,12,11,1
SBI99YLF2610130,75,29,25,4,1
SBI92MKC0304832,82,29,22,7,1
SBI52GIH7994913,19,20,17,3,1
SBI74OTT7949335,93,21,12,9,1
SBI79MML3309328,82,19,16,3,1
SBI52OYP8369197,63,28,16,12,1
SBI74DUJ9770773,81,21,17,4,1
SBI64NXD3135252,81,25,20,5,1
SBI87JJC1037139,74,18,17,1,1
SBI44RTR0156545,21,28,24,4,1
SBI13ZQK9670953,99,22,15,7,1
SBI59TWA1222611,19,25,15,10,1
SBI52JHV6270242,61,26,20,6,1
SBI45FKM4319643,25,22,19,3,1
SBI00YZF4089868,94,23,19,4,1
SBI33PMH1702742,71,30,24,6,1
SBI17OYZ8389998,24,15,14,1,1
SBI43YFR0489535,72,14,9,5,1
SBI76OBN3395802,65,17,15,2,1
SBI53MWT5683219,82,25,20,5,1
SBI65PGI1220651,93,34,20,14,1
SBI59TZU6179010,69,27,25,2,1
SBI31SYT0006255,74,23,13,10,1
SBI95XTR2787195,64,27,24,3,1
SBI05GQK3395326,18,26,14,12,1
SBI48LDA6321603,80,27,14,13,1
SBI06OEM4658679,78,24,15,9,1
SBI01BMX7492633,88,12,9,3,1
SBI03OQR4972999,22,29,20,9,1
SBI62NKV5264653,78,23,12,11,1
SBI73FPP9530894,69,26,24,2,1
SBI78LET2279877,84,26,17,9,1
SBI29MQA9586237,22,25,19,6,1
SBI24QFK0766690,60,24,21,3,1
SBI14VUV9519252,84,25,18,7,1
SBI36MVB6346155,76,21,15,6,1
SBI78BSW3531529,98,30,21,9,1
SBI70MSZ5451415,86,28,19,9,1
SBI00OZD2923250,73,24,23,1,1
SBI44PJZ9600845,90,32,31,1,1
SBI42CTY7138952,25,20,19,1,1
SBI17SED6065508,74,23,16,7,1
SBI82ZHW8889617,62,19,15,4,1
SBI95QIB4777404,75,18,16,2,1
SBI81YVT3279346,65,21,18,3,1
SBI74AQE4709000,93,18,11,7,1
SBI84LIM4253067,62,19,12,7,1
SBI51XIL1151116,85,25,22,3,1
SBI62JAI5353276,20,20,14,6,1
SBI99CLF0472029,22,19,14,5,1
SBI34ZWY5186901,61,13,7,6,1
SBI81HSF1721815,61,30,16,14,1
SBI98QYW0944244,83,19,14,5,1
SBI24ONG1042235,77,27,14,13,1
SBI52RLR2093343,77,15,9,6,1
SBI21TCG8016275,87,20,12,8,1
SBI19BMB3486904,81,33,30,3,1
SBI71WEL7876499,21,24,16,8,1
SBI53UXA5996306,88,25,16,9,1
SBI01PEV1142357,71,34,20,14,1
SBI73ILQ0796887,96,17,16,1,1
SBI57JWN5058640,90,33,19,14,1
SBI38OLP4183771,84,20,12,8,1
SBI27IMA1961064,92,25,15,10,1
SBI52QCG1104572,95,21,14,7,1
SBI61HTN9529229,94,38,32,6,1
SBI43LLG5402610,83,25,14,11,1
SBI58SCO6313989,83,15,9,6,1
SBI38IXX6877589,94,31,20,11,1
SBI65KYH3984997,84,35,33,2,1
SBI37WAL9736891,60,25,22,3,1
SBI72FNF3387318,60,27,15,12,1
SBI95QNR6972350,69,35,23,12,1
SBI01QQT6401799,62,24,20,4,1
SBI27KYJ3924833,87,22,12,10,1
SBI25VLM1152832,97,26,23,3,1
SBI51GFU5248675,62,18,13,5,1
SBI77AGJ5448355,20,21,20,1,1
SBI19IIK9746982,81,24,17,7,1
SBI78IPJ6767726,87,30,16,14,1
SBI80KBT2455601,61,26,23,3,1
SBI99DDG0858871,78,25,24,1,1
SBI60FOR1655732,85,28,27,1,1
SBI85VYY2661872,24,25,20,5,1
SBI53DUU3065056,77,25,19,6,1
SBI77TBP3721554,94,23,17,6,1
SBI01NGV2520014,87,30,20,10,1
SBI18MGG4360983,20,19,13,6,1
SBI84EJL9018735,63,26,15,11,1
SBI93QYH1349557,84,21,12,9,1
SBI77HHM2963457,97,23,13,10,1
SBI28NPN4732372,21,18,15,3,1
SBI22DQZ3470212,91,26,14,12,1
SBI41GUI6407916,92,25,17,8,1
SBI19IHV6789286,82,21,11,10,1
SBI76ZFA1791055,81,27,24,3,1
SBI32BNL0369310,88,17,16,1,1
SBI03PPJ3288354,93,13,7,6,1
SBI21QHZ5026897,68,29,21,8,1
SBI09QCK7491925,89,23,16,7,1
SBI69TUN2520302,21,29,16,13,1
SBI08YIL8373034,93,18,10,8,1
SBI69SLI6500103,65,31,24,7,1
SBI44KDE0872520,70,26,21,5,1
SBI04CZW0144937,80,26,21,5,1
SBI12TOO9481833,96,25,15,10,1
SBI88HVA7653675,83,27,15,12,1
SBI85XAH1519830,67,24,22,2,1
SBI30FIW1218618,70,21,15,6,1
SBI05PFY2178724,99,15,9,6,1
SBI12BNW3960467,91,28,25,3,1
SBI48FXS4944520,62,20,15,5,1
SBI70EYQ5403291,99,29,20,9,1
SBI48UCO8338021,99,14,9,5,1
SBI73EWP0786575,71,21,11,10,1
SBI83QSH6780394,90,36,19,17,1
SBI39OSA1964424,72,15,11,4,1
SBI22TLQ8076637,87,18,11,7,1
SBI25RFW6903437,18,27,15,12,1
SBI96CRB4114201,81,21,18,3,1
SBI96SJK7894247,67,19,10,9,1
SBI81AGZ8258695,20,15,13,2,1
SBI97ENY5039665,87,21,11,10,1
SBI46JUW2123489,81,22,19,3,1
SBI40DCA4312463,76,33,30,3,1
SBI99ZDD7492380,92,24,15,9,1
SBI97OMY9518223,21,21,20,1,1
SBI65ONC0123320,75,21,11,10,1
SBI41IDL0566350,24,25,18,7,1
SBI90XVY3418756,84,22,19,3,1
SBI87UGN2730588,66,16,11,5,1
SBI57YLB8579888,21,25,13,12,1
SBI68LGF6327287,93,27,24,3,1
SBI95BPR5613498,18,22,19,3,1
SBI46WWI7269775,61,27,22,5,1
SBI61EBR2422140,66,25,19,6,1
SBI50WFO3704605,24,27,16,11,1
SBI58LRN9844207,77,18,10,8,1
SBI97DEJ1728559,83,19,13,6,1
SBI69FHB6349611,21,26,15,11,1
SBI04QSX6165593,98,31,18,13,1
SBI63MEN1760789,74,27,14,13,1
SBI99RJD3764225,96,32,23,9,1
SBI65JZJ2554113,24,22,19,3,1
SBI06AEN6457095,97,29,25,4,1
SBI54ZGE8017919,67,27,20,7,1
SBI96JCV3533249,66,21,17,4,1
SBI83DLE4023650,69,26,20,6,1
SBI67MAF9405553,22,32,22,10,1
SBI70PZR7477365,72,14,8,6,1
SBI89FCX0569849,66,24,20,4,1
SBI32GXH3075231,23,24,20,4,1
SBI35XEH2423377,68,26,21,5,1
SBI38YMH2126129,69,20,19,1,1
SBI78SNX7810058,24,25,17,8,1
SBI70EGI7539692,99,20,15,5,1
SBI21JSK9898319,69,20,17,3,1
SBI76HKM8647127,97,19,17,2,1
SBI80FZG9551775,61,27,14,13,1
SBI21QAF8197160,93,26,25,1,1
SBI17SKT9719750,93,31,24,7,1
SBI74WMO9934384,69,24,21,3,1
SBI06GKK3851430,62,28,21,7,1
SBI72NBN3683019,76,26,25,1,1
SBI94MAV2296989,62,19,12,7,1
SBI62DDN0967537,73,25,22,3,1
SBI65DXJ4168909,77,19,18,1,1
SBI51UHX2653172,65,31,25,6,1
SBI07BYB4811078,77,28,24,4,1
SBI02XPO3741125,93,26,24,2,1
SBI33AUG5318678,21,31,26,5,1
SBI37IYY6275169,73,27,21,6,1
SBI36HZY3679214,93,27,22,5,1
SBI23INB0354168,63,27,26,1,1
SBI91YEE8047240,86,23,19,4,1
SBI46HQP2707249,67,26,25,1,1
SBI71FTN8515334,85,23,21,2,1
SBI86SIZ9995226,72,31,25,6,1
SBI86UOL5165349,61,16,10,6,1
SBI84HKA2982573,86,21,13,8,1
SBI56TWA3445468,79,24,15,9,1
SBI68IVV7747697,60,22,19,3,1
SBI62SJG2618668,81,25,18,7,1
SBI53HVF6754764,19,17,11,6,1
SBI05NOW5165279,19,20,19,1,1
SBI16GKB6868286,75,23,12,11,1
SBI21TBI2984586,96,18,13,5,1
SBI49PAK1421410,96,29,17,12,1
SBI09OEF5158587,76,29,28,1,1
SBI32XOC7486718,87,31,20,11,1
SBI94BJN3499864,74,16,10,6,1
SBI12MGU8812528,70,14,9,5,1
SBI69PUO5925267,93,25,19,6,1
SBI48DGR8634115,96,22,16,6,1
SBI13SDP5498381,60,30,25,5,1
SBI17NFI2137738,18,18,15,3,1
SBI06VCE6442881,94,32,25,7,1
SBI04KSB1181402,98,29,21,8,1
SBI24KNH2090208,18,25,19,6,1
SBI17BBT2200760,22,25,23,2,1
SBI60PMM4277778,89,28,17,11,1
SBI33IWH4903775,20,27,24,3,1
SBI47TPT1450551,91,23,17,6,1
SBI64KNT4573668,86,20,17,3,1
SBI76OOE5001313,82,33,32,1,1
SBI72VUL3776738,68,23,21,2,1
SBI67PZV3470139,67,28,24,4,1
SBI54AKJ2902102,90,22,20,2,1
SBI21DCW6366010,92,19,12,7,1
SBI99IYL2730646,99,21,11,10,1
SBI90NGZ5460198,76,29,19,10,1
SBI47QBZ3499296,21,25,24,1,1
SBI83TWO0619729,71,20,16,4,1
SBI67MCL7972329,25,25,20,5,1
SBI95AGZ5582602,84,28,22,6,1
SBI05BBF7971161,95,20,14,6,1
SBI83BLI2324780,94,17,9,8,1
SBI39OGK3642611,20,23,18,5,1
SBI05WZP7053136,21,25,18,7,1
SBI93RTK1094900,18,22,12,10,1
SBI50GBG6397245,62,29,24,5,1
SBI49NOO7780404,88,21,20,1,1
SBI31GLP2875192,69,18,14,4,1
SBI92OYM0198896,94,24,15,9,1
SBI72BTW5753719,24,30,17,13,1
SBI83BTD5237692,68,26,24,2,1
SBI91VHU8849946,95,16,14,2,1
SBI54DXE2710553,97,22,14,8,1
SBI59OCJ8193457,24,30,21,9,1
SBI75TWA5295566,62,21,15,6,1
SBI86YZG2078251,20,14,11,3,1
SBI96ESO2008823,69,22,15,7,1
SBI11HJA5424864,98,24,21,3,1
SBI15HEW8690837,65,22,16,6,1
SBI73UJZ3634307,99,24,16,8,1
SBI16AAZ5586032,65,29,20,9,1
SBI44FZZ8313185,69,19,15,4,1
SBI72XDW8664101,93,18,11,7,1
SBI28IIG9728699,88,22,15,7,1
SBI84XCP0305831,94,25,21,4,1
SBI06OHL6898976,81,35,25,10,1
SBI06WCO7674643,24,27,23,4,1
SBI47UTK6099986,25,30,29,1,1
SBI23FUC9310489,96,23,18,5,1
SBI20WWV6245348,20,21,17,4,1
SBI06EEU0969476,67,25,22,3,1
SBI35SBX1748191,70,29,19,10,1
SBI94VLH0587323,21,30,29,1,1
SBI77ZOR1308853,96,26,24,2,1
SBI48VMW7012125,78,19,14,5,1
SBI20VQK9006364,70,29,27,2,1
SBI80HVL8257535,85,28,25,3,1
SBI49DEV0182186,90,28,16,12,1
SBI12LEM2025919,22,27,16,11,1
SBI66AOR5339539,83,23,13,10,1
SBI38XKY5282771,65,22,12,10,1
SBI97RBT0447879,22,26,22,4,1
SBI45YCA9061440,71,23,15,8,1
SBI71AGS1895651,83,21,12,9,1
SBI39QVX5195151,89,25,21,4,1
SBI55BLZ3670175,89,19,10,9,1
SBI35HSR1433506,91,26,24,2,1
SBI91GZF9065425,20,29,21,8,1
SBI65NRQ0076596,66,35,30,5,1
SBI29VNI1789356,77,31,27,4,1
SBI74DQD7498442,86,25,23,2,1
SBI41FCV1013346,77,16,12,4,1
SBI52OYY5349042,22,26,22,4,1
SBI89JPF5558027,24,27,23,4,1
SBI81YTD8267156,20,28,19,9,1
SBI19QMR9425273,81,25,14,11,1
SBI89MXH4507765,76,20,11,9,1
SBI19QBO7008232,88,15,11,4,1
SBI38LTQ3063632,85,21,14,7,1
SBI79WCC9909575,91,28,21,7,1
SBI58JUU3296031,61,17,13,4,1
SBI11HMF4231301,98,33,17,16,1
SBI16VUZ8742510,66,15,10,5,1
SBI26FYO4771664,83,31,25,6,1
SBI20RHI9895211,66,27,14,13,1
SBI19JXV7660473,25,19,18,1,1
SBI18QSW9927469,83,29,16,13,1
SBI14TTK2591700,89,18,11,7,1
SBI55BMM8865208,88,28,15,13,1
SBI07APX3848129,22,23,18,5,1
SBI99NUQ1647078,24,26,22,4,1
SBI20LDI4665076,70,24,19,5,1
SBI86FRJ6454483,60,31,29,2,1
SBI50BFK7276050,68,31,26,5,1
SBI28ALW2961471,82,26,21,5,1
SBI46DCG7469100,69,16,10,6,1
SBI40RII6502989,90,26,22,4,1
SBI89IHY9961242,74,27,14,13,1
SBI45RWT5418067,72,22,15,7,1
SBI14FRV8105575,97,22,18,4,1
SBI32TOA5665037,80,28,24,4,1
SBI92SXY8292001,96,30,22,8,1
SBI61TFT3076151,75,24,19,5,1
SBI56UUF6973631,70,22,13,9,1
SBI42XPP0760240,87,30,19,11,1
SBI82UCP6510335,70,22,17,5,1
SBI54JTA1533929,96,25,18,7,1
SBI87BAG7926098,82,25,13,12,1
SBI32PFX0557510,89,25,24,1,1
SBI72NRI3379519,98,27,22,5,1
SBI21WKK4289079,69,31,27,4,1
SBI77SOR0622782,79,26,22,4,1
SBI51PWC3749853,21,20,11,9,1
SBI35KBL3248262,85,21,19,2,1
SBI56EWD3811692,83,23,14,9,1
SBI33ORM0078600,90,14,12,2,1
SBI73BXP2069255,63,22,12,10,1
SBI22RSU6736589,88,29,24,5,1
SBI04BKC6472632,18,32,26,6,1
SBI58MVL7864005,68,27,24,3,1
SBI51TXP3479297,93,25,20,5,1
SBI78JLD3954665,65,29,16,13,1
SBI21ZMM4260140,74,16,12,4,1
SBI75PER2153208,86,27,23,4,1
SBI01XIR6019435,98,26,18,8,1
SBI94OMO2502896,65,25,21,4,1
SBI50RUP3547066,85,32,31,1,1
SBI58MOI7250559,63,22,20,2,1
SBI27NQN7215922,18,21,15,6,1
SBI13KOQ6531628,67,21,13,8,1
SBI62YQI0101928,90,21,16,5,1
SBI83VHP0505547,98,25,14,11,1
SBI09OAN7460314,67,24,21,3,1
SBI44UBL9974867,60,29,27,2,1
SBI55QID2688183,96,21,20,1,1
SBI77PFN9345046,80,24,19,5,1
SBI58GSR7432196,63,30,21,9,1
SBI20GUB2771878,84,25,24,1,1
SBI64FTU7989019,18,25,23,2,1
SBI59TCQ8840990,83,28,18,10,1
SBI01GAY2589421,96,25,24,1,1
SBI13UUF6419391,86,21,19,2,1
SBI86GBI2099779,18,27,21,6,1
SBI46DQR3237870,64,26,25,1,1
SBI29FMN3337542,75,22,12,10,1
SBI68GAF3477771,93,23,12,11,1
SBI69UMI8066787,85,22,15,7,1
SBI68IGK0911323,88,28,25,3,1
SBI79DAB7185726,89,27,15,12,1
SBI63QAR3612525,92,27,25,2,1
SBI70PRT7916230,93,28,22,6,1
SBI02QKZ8905613,76,22,18,4,1
SBI93UAR8777793,97,20,16,4,1
SBI65ZAS4348394,94,32,27,5,1
SBI45AOZ7922538,74,32,23,9,1
SBI42FTM4203215,66,27,26,1,1
SBI69FDL8709384,23,18,11,7,1
SBI11TTV0871044,72,27,17,10,1
SBI17UIJ1024379,19,22,17,5,1
SBI89FCZ5384116,72,18,11,7,1
SBI26EDO5735425,84,17,14,3,1
SBI90NPB9028528,96,32,22,10,1
SBI38YHW9922047,83,25,15,10,1
SBI98TAG0323893,63,26,14,12,1
SBI58PFH1145661,25,18,15,3,1
SBI70ZJE2495991,73,30,19,11,1
SBI85EOH2242255,77,25,14,11,1
SBI99ENU1659010,72,29,21,8,1
SBI79OBF6669212,93,18,15,3,1
SBI63XJJ5928424,23,37,27,10,1
SBI29ZQH8860151,78,17,13,4,1
SBI73NWI4830658,99,28,15,13,1
SBI05JFZ2797711,70,21,12,9,1
SBI03XFY4814881,85,17,9,8,1
SBI30TFK3305111,76,26,17,9,1
SBI11SNF9758422,18,14,8,6,1
SBI89LAT8161553,67,23,16,7,1
SBI63CEX2676053,70,27,26,1,1
SBI05HNQ8355635,23,24,20,4,1
SBI84RHL1397020,65,28,15,13,1
SBI22JKH3704519,96,19,16,3,1
SBI73NUZ9807099,67,15,13,2,1
SBI38SPO9685208,96,28,20,8,1
SBI09IKA5220502,60,20,11,9,1
SBI04UNH3348629,82,31,25,6,1
SBI63WOO1083594,71,23,16,7,1
SBI43WNA8093988,98,27,17,10,1
SBI98VLP7037290,61,13,8,5,1
SBI86GTL0798797,96,30,22,8,1
SBI27YCK7798708,78,25,20,5,1
SBI93DHK3255610,21,16,12,4,1
SBI75AEY2657316,94,15,9,6,1
SBI85HCI4234419,94,20,15,5,1
SBI25ENA7670220,20,29,20,9,1
SBI48HFT3532278,84,18,17,1,1
SBI86QDQ0932738,21,17,14,3,1
SBI85AYW7777364,61,15,11,4,1
SBI41LEU0891899,81,35,24,11,1
SBI82PUJ4926334,76,22,12,10,1
SBI93UUF0395033,71,30,16,14,1
SBI49DMN9494884,84,19,14,5,1
SBI69IXQ2200850,86,28,23,5,1
SBI79QWH4103879,18,26,16,10,1
SBI25QKQ5723110,66,25,22,3,1
SBI38MXX8467703,85,28,22,6,1
SBI16EFW3486420,94,24,18,6,1
SBI22PHO1209979,94,23,16,7,1
SBI27MWC8257334,69,24,17,7,1
SBI37LTC0347226,78,25,22,3,1
SBI54PDZ8497214,24,24,22,2,1
SBI54KFW6250162,89,27,20,7,1
SBI63CGA3516597,76,22,13,9,1
SBI30NHO8394541,75,26,16,10,1
SBI15XTJ2240661,87,29,22,7,1
SBI87MOI8847811,66,18,13,5,1
SBI42DIY1754600,23,16,13,3,1
SBI04YUE5666095,24,35,26,9,1
SBI27HQI6213686,87,21,17,4,1
SBI95MDB8412942,18,18,16,2,1
SBI69XPF5162867,89,22,17,5,1
SBI70WVS5432482,94,25,20,5,1
SBI32YCD4793099,74,28,26,2,1
SBI59FQT0892472,82,35,19,16,1
SBI12XGM5697610,87,29,23,6,1
SBI77GAV7665825,71,22,20,2,1
SBI89USD4188685,93,25,24,1,1
SBI97DYA8839776,83,21,13,8,1
SBI92UYF8544037,88,24,19,5,1
SBI15VXD0694072,73,35,21,14,1
SBI54JPV4094560,96,25,13,12,1
SBI68TNA6403030,87,30,17,13,1
SBI83YFF6717661,88,23,21,2,1
SBI26JMO5157540,24,30,20,10,1
SBI12SDQ8298359,80,24,15,9,1
SBI75OAA9873191,73,22,20,2,1
SBI92AFK3576078,77,24,18,6,1
SBI81HED8756614,74,27,15,12,1
SBI91RAX2474917,69,23,16,7,1
SBI82FCR2484446,21,23,15,8,1
SBI15HSV7630482,65,22,21,1,1
SBI83NTC3536793,81,26,23,3,1
SBI32EZI3446331,69,19,14,5,1
SBI23FKT1797295,80,20,17,3,1
SBI54TQJ4530134,75,28,22,6,1
SBI89RGS1092332,63,21,19,2,1
SBI82IML9446647,61,20,11,9,1
SBI25PCP5333255,79,18,12,6,1
SBI34AXF5888260,82,30,20,10,1
SBI73FYC0722205,72,23,15,8,1
SBI93CYD5511378,67,33,21,12,1
SBI13POF4462166,81,21,12,9,1
SBI83SRN0356801,62,25,24,1,1
SBI77INE7078038,98,32,28,4,1
SBI66UUX5480756,82,30,29,1,1
SBI55TAG6851628,75,24,22,2,1
SBI26PWJ0082547,97,38,26,12,1
SBI24FNL6348041,65,24,15,9,1
SBI69IXF7823165,95,25,14,11,1
SBI19QVX5350336,20,29,19,10,1
SBI32ZMH5685530,68,32,23,9,1
SBI40PDH1961023,74,25,17,8,1
SBI57RDC2123250,72,24,22,2,1
SBI29BTM0378957,87,28,21,7,1
SBI36NSF3100115,66,23,18,5,1
SBI75XAI8436049,94,21,18,3,1
SBI21ZMV6903917,71,23,16,7,1
SBI58VPG3835234,86,21,12,9,1
SBI15EOZ1672108,81,33,19,14,1
SBI84PII6862128,22,21,13,8,1
SBI75FWG8895488,79,29,18,11,1
SBI98TEF9700075,90,18,17,1,1
SBI30OVN1637431,60,27,22,5,1
SBI37PQW3780168,94,24,21,3,1
SBI10ULF2788311,79,24,20,4,1
SBI51OJJ3437939,75,21,19,2,1
SBI95KUK4621032,93,13,12,1,1
SBI40WEQ1412842,80,25,23,2,1
SBI29MAU6563034,95,33,24,9,1
SBI60LYW9514895,23,30,18,12,1
SBI56GLT9819543,96,25,14,11,1
SBI85SGO4033671,81,35,20,15,1
SBI45XKL6874534,86,29,19,10,1
SBI81KXL5958605,98,16,11,5,1
SBI27JUD3399869,71,20,11,9,1
SBI67IFE5321238,77,23,18,5,1
SBI88HOH8695721,21,28,22,6,1
SBI99GSD3246755,71,21,13,8,1
SBI03GVJ1188195,68,13,12,1,1
SBI91OLJ9017085,95,21,17,4,1
SBI00RCK5096921,78,29,24,5,1
SBI21YJC9283526,61,19,13,6,1
SBI21ETL9436635,25,25,20,5,1
SBI66JYD5513396,79,23,13,10,1
SBI18GHK6283622,23,22,21,1,1
SBI39ANL6483496,82,32,24,8,1
SBI32ENG9327849,63,27,21,6,1
SBI36LSF5810200,89,14,12,2,1
SBI52QRO5671212,78,27,26,1,1
SBI25FWE7071076,60,28,20,8,1
SBI75PNY1030492,95,25,18,7,1
SBI18ACS5616717,91,28,19,9,1
SBI28KRM9088914,81,24,13,11,1
SBI07XHZ4983849,20,27,17,10,1
SBI75GIX9576439,63,23,15,8,1
SBI05ARD3937054,25,21,17,4,1
SBI95XNZ1789060,25,30,18,12,1
SBI17YOS2709949,93,28,15,13,1
SBI36IES3742059,60,28,20,8,1
SBI45GRF1485074,69,26,22,4,1
SBI55BVI1421359,61,24,17,7,1
SBI04UFZ3722776,18,22,21,1,1
SBI92DXC6231415,79,28,25,3,1
SBI75MPR1477044,73,27,17,10,1
SBI16IGR6347073,66,18,11,7,1
SBI32IOZ0075925,87,22,17,5,1
SBI18ZLP1322298,18,32,29,3,1
SBI99LMW8707737,83,10,7,3,1
SBI89VKZ0668949,67,22,19,3,1
SBI12VYY1262918,69,23,21,2,1
SBI59BIK7134142,23,20,13,7,1
SBI70VBR4248059,86,29,28,1,1
SBI38BWT5377294,85,23,15,8,1
SBI26RQA0125386,89,23,12,11,1
SBI18LRJ7311396,87,22,17,5,1
SBI13OQS6415572,72,23,20,3,1
SBI87YNG2254197,21,25,17,8,1
SBI84OPN1030677,87,21,13,8,1
SBI50KYP6282539,92,27,17,10,1
SBI06QVF9609797,94,28,18,10,1
SBI96IAP2883057,99,25,14,11,1
SBI95PRF2577667,64,26,21,5,1
SBI07MYK8780606,91,20,13,7,1
SBI58XEN7655807,79,34,19,15,1
SBI33VSW2693509,75,22,12,10,1
SBI00LMR0634594,22,26,23,3,1
SBI17ANR6489803,92,29,18,11,1
SBI54GXL9932840,84,21,16,5,1
SBI39PLA7087740,97,33,27,6,1
SBI78VKW4207817,95,19,17,2,1
SBI50ECD1914157,68,15,8,7,1
SBI97PKG3468790,71,32,25,7,1
SBI60TLU4784066,94,25,23,2,1
SBI74DEH7265099,25,16,11,5,1
SBI46ZOC6305003,78,24,23,1,1
SBI87IKG5780450,73,19,12,7,1
SBI13PON0309051,90,30,29,1,1
SBI51FTX0019591,24,25,19,6,1
SBI37IGW4789368,96,28,25,3,1
SBI99BLS9417705,91,30,17,13,1
SBI42RPN9532302,97,24,18,6,1
SBI01LXM0807838,62,31,30,1,1
SBI88TRB6495441,87,23,15,8,1
SBI82ABB3177829,97,30,18,12,1
SBI20CUD3221732,99,32,18,14,1
SBI13ZFU6053757,83,25,16,9,1
SBI13IPH7398180,86,37,19,18,1
SBI24PTC7071683,20,23,22,1,1
SBI33XAZ4491766,97,31,26,5,1
SBI98IAQ2745892,93,22,18,4,1
SBI52IXP7825416,86,16,10,6,1
SBI88RHX6193277,84,17,11,6,1
SBI94DAP9116973,23,19,17,2,1
SBI60QRM2783286,84,21,18,3,1
SBI80QSG2797927,65,19,16,3,1
SBI76EGY6493380,85,24,23,1,1
SBI84DXO5655900,18,33,27,6,1
SBI41GNY1686916,96,22,21,1,1
SBI90FPI2691421,93,31,16,15,1
SBI18PUP0152030,19,32,17,15,1
SBI62JCZ4450128,20,15,13,2,1
SBI22KXX4005619,95,28,24,4,1
SBI93FZO6831246,95,22,12,10,1
SBI71ZJC9807885,96,27,14,13,1
SBI62QUD2772286,79,28,25,3,1
SBI43MND9618349,88,22,15,7,1
SBI90QXC0080216,68,22,12,10,1
SBI54AJW7693223,75,27,24,3,1
SBI38XXI1927275,95,20,17,3,1
SBI17LXX5023461,61,28,17,11,1
SBI72WMK0708915,64,27,14,13,1
SBI85JBC0008134,24,22,13,9,1
SBI14JSI1912432,22,29,19,10,1
SBI20EPJ4088836,94,22,21,1,1
SBI52SDB8314360,67,34,20,14,1
SBI88IXS4488186,94,28,27,1,1
SBI62GPE7840426,73,25,16,9,1
SBI33IKF1110948,63,23,21,2,1
SBI02YND0792711,84,33,19,14,1
SBI39HTL5490191,68,29,19,10,1
SBI71CZK1822384,76,28,21,7,1
SBI97DIN7115102,67,21,12,9,1
SBI76XQQ6425254,25,25,15,10,1
SBI93EIT2753375,86,30,29,1,1
SBI01FSZ2897434,60,10,8,2,1
SBI76ISZ2630189,24,26,19,7,1
SBI98AHU2486928,19,16,9,7,1
SBI08YFO6452740,73,21,19,2,1
SBI89RLU7119110,19,20,13,7,1
SBI56DJI4742384,85,23,19,4,1
SBI35OMP4289058,74,18,16,2,1
SBI33ZLP8347231,78,23,17,6,1
SBI99BJB4182445,82,23,12,11,1
SBI06UZL4014020,81,24,23,1,1
SBI68YSA5850841,88,21,14,7,1
SBI36ZPH2787450,71,23,18,5,1
SBI87EWN8503865,87,29,21,8,1
SBI40UIO8892526,83,11,10,1,1
SBI31TWW6432349,80,24,21,3,1
SBI18YWX1858693,94,17,14,3,1
SBI83NDW6985581,24,20,15,5,1
SBI05ZVV5709619,83,21,15,6,1
SBI43IGU8168470,22,14,9,5,1
SBI23MKJ7873685,94,28,17,11,1
SBI72GFB1873171,70,21,14,7,1
SBI10VGA7193428,84,17,14,3,1
SBI51HCM5818139,72,32,23,9,1
SBI53CQD8539873,89,26,25,1,1
SBI72DJT3981365,66,31,21,10,1
SBI25JEO5744772,87,30,20,10,1
SBI33BAR5054643,76,33,21,12,1
SBI97FRZ9974452,70,21,12,9,1
SBI30GZM8741846,24,33,30,3,1
SBI95RMA3054120,63,16,9,7,1
SBI18GGR9977854,86,23,22,1,1
SBI74MBT0984781,63,20,12,8,1
SBI97QEV2910896,25,16,9,7,1
SBI79QHZ5034894,89,26,24,2,1
SBI64GPY9865660,83,23,12,11,1
SBI37IMH3927045,66,15,11,4,1
SBI13IVN4489762,83,18,17,1,1
SBI81CCK8747333,68,18,16,2,1
SBI29NIW3690316,19,30,24,6,1
SBI43WJM4335278,63,27,24,3,1
SBI96QLK5138820,78,17,12,5,1
SBI60MHU4688684,23,17,13,4,1
SBI85EWO4634588,80,26,19,7,1
SBI44YOE9836535,63,26,15,11,1
SBI60MJQ1490226,99,27,25,2,1
SBI62OYS7652948,93,31,24,7,1
SBI81GEC5295011,66,29,25,4,1
SBI68EBF2694540,90,22,18,4,1
SBI99ZBN1760225,93,24,14,10,1
SBI81IOI4777051,66,24,17,7,1
SBI24EWO0807175,23,25,19,6,1
SBI86TGE9489926,69,27,24,3,1
SBI21CZF6585588,90,28,18,10,1
SBI12KOP6061860,91,23,17,6,1
SBI40TZC3252357,74,15,14,1,1
SBI67RIR7539599,85,23,14,9,1
SBI72DPA8554118,66,27,21,6,1
SBI33JXA7299763,20,26,21,5,1
SBI26VMX6735725,84,23,16,7,1
SBI40HFM6293950,92,20,14,6,1
SBI69ZTS2781204,72,36,28,8,1
SBI30NVQ8990933,25,24,20,4,1
SBI43LSK7970128,75,28,27,1,1
SBI20HGC8482142,92,24,16,8,1
SBI55RFY3959870,67,22,14,8,1
SBI33YTS4166694,64,27,24,3,1
SBI74UVN4947663,82,22,16,6,1
SBI49JUP7946600,84,32,31,1,1
SBI93AII1131871,75,26,15,11,1
SBI95WFU4507856,90,26,24,2,1
SBI61DNH5346542,60,28,15,13,1
SBI81RCT7405878,96,23,22,1,1
SBI58VOC2410139,24,33,19,14,1
SBI67IMV0258374,24,29,24,5,1
SBI68AZM7333844,79,23,14,9,1
SBI29EUQ8450532,79,22,20,2,1
SBI25JRF4636060,79,14,12,2,1
SBI52GHF1301980,74,22,14,8,1
SBI81DJS9777969,86,25,23,2,1
SBI31GIH4395292,93,23,16,7,1
SBI00OMI4486932,86,18,17,1,1
SBI48ZLG3429911,78,24,15,9,1
SBI13XMN5261826,76,29,16,13,1
SBI97KLE2971436,18,23,14,9,1
SBI61YLE8178308,21,22,13,9,1
SBI24JVK5413089,67,24,15,9,1
SBI27UKQ1517905,79,27,19,8,1
SBI61LJV0180095,67,24,23,1,1
SBI80LND4436878,94,15,12,3,1
SBI82RIT0512348,71,22,16,6,1
SBI58GXO3372561,80,23,17,6,1
SBI89DUM0444517,90,23,22,1,1
SBI75GCZ9331000,61,29,18,11,1
SBI12NVC8870430,86,19,18,1,1
SBI36HSY0074376,96,17,9,8,1
SBI29MJA1304063,76,28,25,3,1
SBI76ARB4389130,92,35,19,16,1
SBI08CEH1754365,93,32,29,3,1
SBI99EEE4906293,82,21,14,7,1
SBI53TUW0724517,80,15,11,4,1
SBI10UXE4211198,66,27,14,13,1
SBI74WEZ8003352,85,24,19,5,1
SBI98VZY5580047,65,24,20,4,1
SBI47RIO5836565,92,22,13,9,1
SBI13WBG1849729,23,31,30,1,1
SBI92CHZ4459219,71,25,18,7,1
SBI34DRI1005612,92,19,17,2,1
SBI88FML0131457,79,28,21,7,1
SBI02PWK5821952,97,27,15,12,1
SBI36CEZ6543754,20,17,14,3,1
SBI09ONW0053023,63,27,26,1,1
SBI42DQH1474384,96,27,18,9,1
SBI88TOT0580790,99,34,21,13,1
SBI19KAK0846245,61,19,14,5,1
SBI61YPV6056370,66,22,12,10,1
SBI90CRX8556732,97,30,20,10,1
SBI09TMJ3395973,87,19,12,7,1
SBI01MWT5251881,86,22,12,10,1
SBI13AOP7543241,65,15,8,7,1
SBI45XZZ7006682,75,22,20,2,1
SBI82PCP1183045,67,28,22,6,1
SBI01ZQT5498703,72,23,20,3,1
SBI72JII2715837,63,25,15,10,1
SBI81BZS9754315,77,26,16,10,1
SBI10HYP2873872,19,23,13,10,1
SBI42MUO9377153,72,24,20,4,1
SBI01PKB6153542,96,28,22,6,1
SBI58BLZ6197989,82,20,11,9,1
SBI73JYF1963342,20,21,15,6,1
SBI36LJB9013374,83,32,31,1,1
SBI58RNR7359932,74,22,15,7,1
SBI43ICB3321910,25,32,25,7,1
SBI76OOQ3425868,21,24,20,4,1
SBI73YMC0595817,23,23,22,1,1
SBI03VLM6699779,90,26,17,9,1
SBI74AOM9894534,87,30,29,1,1
SBI02RHV5984223,96,23,12,11,1
SBI64YJH4145696,92,16,12,4,1
SBI76QWI7694093,82,22,14,8,1
SBI74XFR7563316,21,25,14,11,1
SBI31LTA0310030,97,33,18,15,1
SBI69LAP0323972,69,29,26,3,1
SBI22FCW9231943,81,32,18,14,1
SBI35RBC0891788,22,30,27,3,1
SBI72BRR0598921,80,28,20,8,1
SBI07LLA9183939,63,31,16,15,1
SBI42VWI9822212,94,21,17,4,1
SBI25QUW8005329,69,25,14,11,1
SBI55VTW9116153,67,14,12,2,1
SBI57KSB6137258,60,21,12,9,1
SBI12CHO1426758,66,23,20,3,1
SBI40HBX1465993,88,19,14,5,1
SBI25RVH8733387,74,24,13,11,1
SBI44RFF3199381,63,23,12,11,1
SBI47XRT2666923,63,28,27,1,1
SBI31TZB9324983,75,31,21,10,1
SBI02NYJ9200750,82,34,22,12,1
SBI03HRZ4460749,81,27,19,8,1
SBI36XND2804192,74,26,16,10,1
SBI19LYM0175913,99,19,17,2,1
SBI98AVU7774415,66,17,15,2,1
SBI00COI2022734,96,27,20,7,1
SBI54UXQ3396458,68,22,14,8,1
SBI04XQR5975653,21,29,18,11,1
SBI71PMM7603319,77,28,15,13,1
SBI08LGG7599735,20,18,12,6,1
SBI52NAQ0692999,64,33,17,16,1
SBI42RCU8594819,94,29,23,6,1
SBI87UMR0033456,94,21,19,2,1
SBI15YOT7459089,70,22,15,7,1
SBI24SRH2594842,93,22,15,7,1
SBI94TZL8295651,85,32,31,1,1
SBI65LNX3051259,62,24,21,3,1
SBI46GBQ2982383,96,23,22,1,1
SBI97TQH5294583,69,24,23,1,1
SBI55QIG8312520,91,28,27,1,1
SBI33YVZ5953714,64,17,15,2,1
SBI01LYU4495178,88,25,13,12,1
SBI60YNV1008755,90,26,24,2,1
SBI29WAJ5024560,79,23,20,3,1
SBI73CWS6993702,81,26,16,10,1
SBI11CBE1670629,60,20,18,2,1
SBI33HHL1528177,73,27,26,1,1
SBI43FEA8841914,20,23,17,6,1
SBI27HKF7305985,95,21,15,6,1
SBI21YCF4561446,95,28,20,8,1
SBI97JMK6618714,77,26,16,10,1
SBI76SWB3177365,82,20,18,2,1
SBI95JLZ5395916,75,20,16,4,1
SBI90PUH4895635,84,20,15,5,1
SBI85YHI2107521,92,23,20,3,1
SBI82TDD0037106,72,31,28,3,1
SBI03MBM2379134,60,21,12,9,1
SBI09UTF2114909,25,31,25,6,1
SBI36AQV1346469,70,20,15,5,1
SBI99RYM8379804,84,27,22,5,1
SBI29DSD6865086,84,16,9,7,1
SBI93EEP0569995,97,32,23,9,1
SBI34APN3351011,75,35,28,7,1
SBI53TEU1442885,71,11,6,5,1
SBI44KNK3563827,82,24,19,5,1
SBI24XHN1800317,98,29,21,8,1
SBI02ZZL2081954,25,25,24,1,1
SBI13NFC4822618,91,19,13,6,1
SBI05HNY3309335,88,21,17,4,1
SBI68BLK2920617,60,21,16,5,1
SBI30NPL9616800,99,31,26,5,1
SBI27MVD8043746,82,26,16,10,1
SBI13IBC8562661,71,24,15,9,1
SBI55PXK9573619,97,31,27,4,1
SBI40LCU3069740,94,25,22,3,1
SBI13ZWJ2085551,24,26,14,12,1
SBI64LHN6046909,72,18,12,6,1
SBI00PBF6513505,92,26,16,10,1
SBI26ZNJ5509221,19,30,28,2,1
SBI58NUV8661667,62,26,19,7,1
SBI03ZWU7785435,71,18,14,4,1
SBI94LFP0852993,95,28,21,7,1
SBI62GAY8745750,65,27,23,4,1
SBI69KJH4255080,99,27,16,11,1
SBI17EPS2207978,95,15,14,1,1
SBI01FCU2279535,69,27,24,3,1
SBI03MUZ2049257,93,33,20,13,1
SBI55CNB0859707,65,24,21,3,1
SBI79HAI8950751,81,28,15,13,1
SBI25LBB0214616,70,26,25,1,1
SBI11GSX3644471,76,27,23,4,1
SBI40NMV7383297,86,34,27,7,1
SBI96CGO3090425,98,18,15,3,1
SBI00FJE7556272,23,28,16,12,1
SBI76ITZ8431558,22,22,18,4,1
SBI75SIR1872771,64,28,15,13,1
SBI25VPA3258123,97,25,14,11,1
SBI17VQU8057613,98,28,24,4,1
SBI80JYM8800824,84,11,9,2,1
SBI59CNY6053753,72,37,23,14,1
SBI66CFF6319371,94,22,13,9,1
SBI10TEL4061228,94,22,12,10,1
SBI65MAZ1332468,96,26,18,8,1
SBI60WWU7665649,19,28,17,11,1
SBI49ZBD7033264,61,22,18,4,1
SBI60ZYK7473806,92,21,13,8,1
SBI22LET4973662,20,17,11,6,1
SBI71JXS2267448,95,27,17,10,1
SBI21SJG7981946,89,28,20,8,1
SBI69FTU1276473,77,26,24,2,1
SBI18CJS0721916,21,23,17,6,1
SBI76LOI8319374,19,22,18,4,1
SBI66MTI8866669,83,19,18,1,1
SBI07OQJ6862376,22,21,20,1,1
SBI73KTR9076645,24,29,16,13,1
SBI48DII4822099,21,20,11,9,1
SBI83QTI8282887,94,16,13,3,1
SBI01DNY0846510,23,25,19,6,1
SBI44BRP3321070,94,28,20,8,1
SBI45LLF1937932,80,28,26,2,1
SBI78PJO7914785,63,28,16,12,1
SBI23ZIZ5563248,97,33,31,2,1
SBI10IUC8646654,97,21,12,9,1
SBI52AWG2088037,86,27,24,3,1
SBI83MIV1614466,81,30,24,6,1
SBI82DJY0743915,95,29,21,8,1
SBI99ZHR5454911,61,19,15,4,1
SBI51AFQ0481153,91,26,17,9,1
SBI49XLH2450817,24,26,21,5,1
SBI00YME1148166,94,27,21,6,1
SBI21SVS1174117,65,24,20,4,1
SBI80SJU4213276,68,26,18,8,1
SBI58SRS6355809,84,22,17,5,1
SBI94STW1427279,79,21,18,3,1
SBI03CKF8410132,66,19,15,4,1
SBI43HHU3620880,78,14,13,1,1
SBI89QNU7129453,89,22,17,5,1
SBI05SRL8975901,79,28,20,8,1
SBI86SDU2155355,76,24,13,11,1
SBI98DCW9416208,74,25,17,8,1
SBI70OLE9736146,64,21,13,8,1
SBI20JMT2008728,94,23,15,8,1
SBI94AOU1080396,73,30,16,14,1
SBI04PKV5268928,70,22,13,9,1
SBI09KKC0355508,91,16,14,2,1
SBI82NWY4820070,60,11,10,1,1
SBI16TKF4936903,23,27,14,13,1
SBI74AYX1401914,65,22,15,7,1
SBI69XZP0558984,87,12,9,3,1
SBI09PJV9368945,62,24,21,3,1
SBI25BCK3919261,95,20,18,2,1
SBI63WIZ4453859,25,20,14,6,1
SBI88TPI7121948,66,31,25,6,1
SBI60WWH5294441,81,21,17,4,1
SBI57QOV2769502,66,25,23,2,1
SBI93NGO7253184,87,18,10,8,1
SBI50ZQX3746134,76,37,33,4,1
SBI41AQQ9324664,73,28,15,13,1
SBI90VNI3047816,65,24,20,4,1
SBI35OOA2029439,79,25,20,5,1
SBI47WBY1137323,83,21,18,3,1
SBI46AET5374991,66,15,11,4,1
SBI22XPY3590944,23,25,22,3,1
SBI96VFZ3034436,65,22,12,10,1
SBI87KHV0151156,66,29,19,10,1
SBI68THP8311311,78,24,21,3,1
SBI91HKH8645363,84,21,17,4,1
SBI91EVR7736551,71,34,32,2,1
SBI72WDT0144289,81,29,18,11,1
SBI01MZM8901105,61,16,12,4,1
SBI98GAH5595079,23,29,23,6,1
SBI24DEX4156592,75,20,17,3,1
SBI48YTK1372038,22,28,18,10,1
SBI19TZY1067606,23,14,13,1,1
SBI28SHH5540971,89,23,17,6,1
SBI36SFT8667529,66,28,15,13,1
SBI53ZIA5385671,77,25,18,7,1
SBI81RXX7320271,94,25,16,9,1
SBI53CSX8031783,19,32,26,6,1
SBI61KGG7588948,24,23,12,11,1
SBI91IXQ8131741,71,27,26,1,1
SBI16ZYS6004844,23,23,17,6,1
SBI06DDT9952300,68,26,18,8,1
SBI46SIC4881894,96,29,17,12,1
SBI38HXZ0058746,77,34,27,7,1
SBI20MNZ7769647,82,20,14,6,1
SBI44VSN1049903,76,20,19,1,1
SBI13ILS7560027,88,22,19,3,1
SBI33YAJ9311923,67,24,21,3,1
SBI65WTY9992740,60,17,11,6,1
SBI09DTA9848948,62,22,16,6,1
SBI67ZRC7219041,81,29,15,14,1
SBI66NNQ9439887,99,28,16,12,1
SBI15AUB2754348,83,21,17,4,1
SBI43LHP3511119,96,27,19,8,1
SBI17DUS4839871,60,22,16,6,1
SBI83DXZ8425200,85,27,20,7,1
SBI15SFF9060443,24,22,20,2,1
SBI84MMS0077796,81,35,32,3,1
SBI99HAU4749734,90,25,16,9,1
SBI00OHN9684112,63,17,16,1,1
SBI25ADA6756572,20,25,20,5,1
SBI10DLC2360502,85,24,23,1,1
SBI06VUY1080202,79,22,17,5,1
SBI91DSK4476023,68,25,15,10,1
SBI27XMW5410844,65,24,17,7,1
SBI41NUN5639363,92,22,13,9,1
SBI93ZKJ8705884,99,29,25,4,1
SBI53OOA3873219,90,20,16,4,1
SBI06PCB8258872,96,22,12,10,1
SBI95GWR8492051,20,23,19,4,1
SBI45FZG1465483,64,33,22,11,1
SBI92KTM9481224,73,28,24,4,1
SBI00LRO2531150,25,14,11,3,1
SBI46ONN3176374,87,18,15,3,1
SBI52LLG8401840,25,25,20,5,1
SBI90CNX4056498,25,17,14,3,1
SBI98XCO8041721,93,21,19,2,1
SBI34XFG1786518,83,20,18,2,1
SBI07GLT7753162,60,24,13,11,1
SBI33OEH8192987,61,18,16,2,1
SBI89HEE1883631,22,22,16,6,1
SBI20YZY6764317,70,25,20,5,1
SBI50EEL6499096,92,27,19,8,1
SBI40TZS6241597,68,28,22,6,1
SBI27KPD1116920,72,28,27,1,1
SBI39VHQ2305299,62,29,28,1,1
SBI50ZGN2447153,63,25,24,1,1
SBI25IZF5870762,83,19,17,2,1
SBI69JZT0637159,96,31,26,5,1
SBI15NRL5581582,62,20,15,5,1
SBI68FBH3127194,81,25,19,6,1
SBI46SOA5926488,93,30,26,4,1
SBI71FVJ2295609,61,29,21,8,1
SBI95YMN7182098,65,27,17,10,1
SBI55UHJ9045939,92,26,16,10,1
SBI43FAZ3305870,90,15,9,6,1
SBI43DQL0436433,18,27,24,3,1
SBI71IUX8230046,73,31,21,10,1
SBI13PWG1196230,24,26,23,3,1
SBI49ATW0494445,66,26,19,7,1
SBI55WWV6786445,70,25,18,7,1
SBI49DTT7891160,93,36,34,2,1
SBI17VDW3953433,97,21,15,6,1
SBI23TAN5910997,60,25,22,3,1
SBI45ERS2894739,97,22,19,3,1
SBI00LIB0517010,61,24,21,3,1
SBI77KNG0861440,61,20,11,9,1
SBI81LXA5064563,87,23,19,4,1
SBI55FCJ2349782,19,23,15,8,1
SBI86VOE6983659,91,21,13,8,1
SBI86RFZ0781704,63,30,17,13,1
SBI31SCN8642206,76,18,17,1,1
SBI19TEW9680768,98,22,14,8,1
SBI23DAJ8477779,80,27,17,10,1
SBI22TBS9882811,72,29,28,1,1
SBI18ZKC9490738,70,19,14,5,1
SBI43NSY3984552,64,21,11,10,1
SBI62MET2846294,61,33,19,14,1
SBI78CPW8555230,91,27,15,12,1
SBI88CSW8389787,89,22,19,3,1
SBI65PTU0979914,94,31,21,10,1
SBI68UCV9639668,68,26,21,5,1
SBI64OKP6214592,70,25,18,7,1
SBI98LMD7040779,77,38,20,18,1
SBI59MPD2696220,83,29,26,3,1
SBI21VXA1747825,22,25,24,1,1
SBI43DFL4999219,22,26,19,7,1
SBI14HRK9051166,63,18,14,4,1
SBI96FWJ4239663,63,20,17,3,1
SBI61QCV5750694,19,38,23,15,1
SBI60CPE0457434,98,25,23,2,1
SBI19DDS3710709,21,32,27,5,1
SBI34ZIU9837943,81,29,18,11,1
SBI44FJQ6116732,89,25,23,2,1
SBI98PJM5223105,77,18,10,8,1
SBI99RNL4959099,98,37,26,11,1
SBI76RUQ7759699,92,12,8,4,1
SBI19AWE8426836,80,26,16,10,1
SBI06DOD9053967,69,25,20,5,1
SBI13VAC7524517,74,29,26,3,1
SBI51ROJ3349488,72,21,14,7,1
SBI48PAK6371720,87,29,16,13,1
SBI55GPL3082063,82,32,25,7,1
SBI64FHY9691166,93,16,10,6,1
SBI37HXP2011171,91,16,9,7,1
SBI82SYQ8820903,77,24,15,9,1
SBI80CBP4778141,70,23,19,4,1
SBI86DCQ4974556,89,22,14,8,1
SBI89QJT9267128,76,21,12,9,1
SBI40ZOI5358485,22,21,20,1,1
SBI94AOJ8516760,96,24,21,3,1
SBI29UHP4443036,68,20,16,4,1
SBI35VLP2420211,65,31,25,6,1
SBI02WTC2933618,20,28,18,10,1
SBI09TOU7416664,74,28,19,9,1
SBI43OKJ4765858,73,40,28,12,1
SBI12PLZ4089254,79,33,23,10,1
SBI01TCQ2147020,73,22,15,7,1
SBI23OJT0527085,82,24,13,11,1
SBI87HKU5097684,87,15,13,2,1
SBI57QAK7868706,68,28,25,3,1
SBI27CHC4741247,80,25,19,6,1
SBI71MAQ4768988,92,29,21,8,1
SBI01LBB5935452,75,24,20,4,1
SBI68TFV7028861,81,29,24,5,1
SBI35DOK3131909,88,19,12,7,1
SBI66FAF9176728,21,25,21,4,1
SBI24UOL8289438,96,28,27,1,1
SBI21HUW2700257,81,26,19,7,1
SBI82WXC2819374,23,26,25,1,1
SBI54FIM3167491,70,25,17,8,1
SBI42IRD0550352,90,31,24,7,1
SBI14QDY3331725,82,23,20,3,1
SBI88FHV7200069,76,29,27,2,1
SBI26LFL2350551,21,26,19,7,1
SBI87PJR0213706,95,33,25,8,1
SBI95HLR7788121,67,14,13,1,1
SBI24RBB6007282,62,33,31,2,1
SBI56FOH2342776,71,30,27,3,1
SBI04ZQG4182908,80,27,17,10,1
SBI47SAY4338536,76,20,14,6,1
SBI36UBU0027347,61,25,18,7,1
SBI20FMC6205703,70,23,14,9,1
SBI54OQE5975406,63,22,19,3,1
SBI28UJV8994337,24,19,12,7,1
SBI98YFK1556107,86,30,21,9,1
SBI76BVT6595675,66,21,12,9,1
SBI01HWG0983495,24,31,27,4,1
SBI87OEJ7817091,96,21,15,6,1
SBI31EBK7554641,60,23,19,4,1
SBI21CHG4565125,19,23,21,2,1
SBI49XOZ8080747,98,20,18,2,1
SBI45XVO3036441,93,26,24,2,1
SBI75JXD2458563,60,23,22,1,1
SBI15SDM3656190,91,21,13,8,1
SBI06UZB8795712,90,20,19,1,1
SBI27WMZ0845978,79,28,18,10,1
SBI40RGE2921382,81,23,12,11,1
SBI21UKY1343946,91,24,16,8,1
SBI77YYB5550925,78,23,17,6,1
SBI15OYQ4672661,70,30,21,9,1
SBI09NEZ5443290,20,27,20,7,1
SBI55GIW1553232,88,24,14,10,1
SBI74YDV8522170,99,21,17,4,1
SBI07AUZ8937324,99,23,21,2,1
SBI62DMS2181898,64,24,19,5,1
SBI64YCL6687418,62,28,15,13,1
SBI32ZPH1173762,96,33,26,7,1
SBI24API3925101,23,21,15,6,1
SBI40KQW3746971,23,25,13,12,1
SBI28IXS9373509,63,22,19,3,1
SBI08BYI0728196,92,29,19,10,1
SBI91KTS2691019,25,27,15,12,1
SBI05OYQ8685775,74,15,11,4,1
SBI54VOB8156028,93,24,14,10,1
SBI88POU6630642,68,34,26,8,1
SBI23IEQ2584352,64,18,17,1,1
SBI87EGK4290370,85,18,16,2,1
SBI43QHK3584010,98,22,18,4,1
SBI12SDW2302658,63,28,23,5,1
SBI06ZHH6632299,76,29,16,13,1
SBI36GJP4533967,92,18,17,1,1
SBI67ZDU0389282,79,27,15,12,1
SBI98ICB0921638,76,25,24,1,1
SBI92HKI1974564,22,23,19,4,1
SBI53DVR9541880,25,20,11,9,1
SBI92YTS3175499,74,13,7,6,1
SBI25TBU3958737,81,24,16,8,1
SBI69RMF2373775,22,19,18,1,1
SBI96LXY4768789,83,30,24,6,1
SBI13HDV9410439,90,27,25,2,1
SBI02ICN7297073,65,19,18,1,1
SBI51PUR5528199,89,32,20,12,1
SBI15ACH0795049,20,28,26,2,1
SBI33ETJ9472073,21,25,18,7,1
SBI09HXH2189498,94,28,15,13,1
SBI13CAO6277569,61,27,15,12,1
SBI48XAX7946243,22,23,14,9,1
SBI64WVD6940038,78,14,10,4,1
SBI69LGH0132904,74,24,23,1,1
SBI01OKX6510539,84,34,23,11,1
SBI26JAH0586398,77,22,13,9,1
SBI33HLZ9128598,78,27,17,10,1
SBI33CPT8394205,65,17,11,6,1
SBI25FUD4776614,88,27,20,7,1
SBI75HWE6752256,92,27,24,3,1
SBI92IAQ7712136,95,18,10,8,1
SBI43ZCE5603238,64,20,15,5,1
SBI82RFF0517174,86,21,12,9,1
SBI16OXV1703025,83,30,23,7,1
SBI87HZV9754517,98,33,24,9,1
SBI68HYH0871863,22,25,15,10,1
SBI68EQD9414383,95,23,21,2,1
SBI28MGG1276818,93,19,12,7,1
SBI03SUP6335630,85,19,11,8,1
SBI16EGV5338298,96,34,24,10,1
SBI92YDU4641896,72,23,16,7,1
SBI66YJQ2161314,66,21,13,8,1
SBI69CZK6735127,19,18,13,5,1
SBI00NRA9949064,76,28,19,9,1
SBI58HHL9038503,95,24,19,5,1
SBI73RXN8479911,72,29,17,12,1
SBI65TJE6790384,89,17,10,7,1
SBI64OIW3073739,22,22,13,9,1
SBI79KQM9652607,63,30,29,1,1
SBI98VAU7604368,62,15,14,1,1
SBI51LTZ6009810,76,25,14,11,1
SBI21UPK4920307,82,14,11,3,1
SBI24JKW4792162,72,21,19,2,1
SBI16OKU4328511,84,21,18,3,1
SBI14TZE4795752,99,27,22,5,1
SBI02YUJ8546694,24,30,17,13,1
SBI14KMN8088439,21,25,15,10,1
SBI00CIK6565189,23,26,22,4,1
SBI29ZAU3645140,98,23,21,2,1
SBI42CPZ7042130,22,28,22,6,1
SBI68KJF3465422,79,34,24,10,1
SBI58ALY6783527,24,23,12,11,1
SBI31TEB5815320,87,15,8,7,1
SBI46QXA5694746,76,29,22,7,1
SBI79KKF6820786,23,29,25,4,1
SBI79INT0027532,64,28,23,5,1
SBI85LVS1303060,99,24,19,5,1
SBI65NGA4779472,21,21,18,3,1
SBI58LFJ8363646,97,22,19,3,1
SBI48MBW3802022,98,29,15,14,1
SBI36CMV6447439,67,32,25,7,1
SBI16LJZ2017056,67,23,20,3,1
SBI62OYG8383954,70,21,11,10,1
SBI47YMF4658342,23,29,27,2,1
SBI73ZSF7458890,76,28,15,13,1
SBI20NVB4756223,83,19,13,6,1
SBI69HKD5224613,82,22,18,4,1
SBI36UXI0374669,23,25,22,3,1
SBI35FWT9952956,60,35,20,15,1
SBI95JLU2310201,88,30,18,12,1
SBI78GTX3170480,18,31,29,2,1
SBI06QFH5003439,89,26,15,11,1
SBI09GNV8223289,91,27,18,9,1
SBI70TFC5365164,84,27,15,12,1
SBI17LJW1187344,85,25,20,5,1
SBI20MKU8267797,75,22,13,9,1
SBI78CWU3488970,23,22,12,10,1
SBI39WQN7316690,61,14,11,3,1
SBI39TXE2407328,21,24,21,3,1
SBI08VLF3542857,84,21,14,7,1
SBI17HGU8489395,23,24,23,1,1
SBI09FNM5994267,72,20,14,6,1
SBI09UJA7095016,77,25,22,3,1
SBI93APB9542037,23,27,15,12,1
SBI35FSU3067523,74,22,20,2,1
SBI08TDM3733029,85,28,21,7,1
SBI35MFM8037711,76,22,13,9,1
SBI65JYL5034370,63,28,15,13,1
SBI13XFE0277695,64,24,17,7,1
SBI25ZEG2433040,23,24,22,2,1
SBI36VPJ0811073,18,24,21,3,1
SBI71LUK8012825,18,18,12,6,1
SBI19DHF7317177,61,30,21,9,1
SBI89SHI2280081,92,25,19,6,1
SBI61QXK6469853,92,20,17,3,1
SBI65IGM4940249,62,25,23,2,1
SBI71RYF4333175,92,23,21,2,1
SBI83OZD0464757,94,27,16,11,1
SBI48VGI2345246,70,26,18,8,1
SBI08CCR1261458,81,24,17,7,1
SBI44JIW7411413,63,23,20,3,1
SBI43XBQ0621950,85,19,10,9,1
SBI19WXN3999529,75,26,18,8,1
SBI16ZNC7009538,65,28,20,8,1
SBI45ALP7855963,91,25,13,12,1
SBI45VSC6230871,66,19,16,3,1
SBI63QKR7598796,61,19,16,3,1
SBI66QRW3987893,23,16,13,3,1
SBI83BGJ4787526,93,18,17,1,1
SBI82DIE5133926,90,30,23,7,1
SBI90XWY7857854,22,30,17,13,1
SBI54YDH5212978,76,29,19,10,1
SBI19WAW0403454,94,19,18,1,1
SBI15BGS6305373,65,27,20,7,1
SBI68GTX0987199,61,32,25,7,1
SBI16BAG4973722,71,25,23,2,1
SBI25GKZ7830415,60,21,19,2,1
SBI89TQX8059878,74,22,17,5,1
SBI47BVG8030268,61,17,14,3,1
SBI80VUI3868785,60,35,31,4,1
SBI62DTA9683765,98,25,20,5,1
SBI73CJX4047471,79,28,19,9,1
SBI03DTR4917542,98,21,12,9,1
SBI60BSD2092300,87,22,12,10,1
SBI61IZS9770437,92,24,22,2,1
SBI34CIR3461607,64,21,12,9,1
SBI82ZSL1322946,88,21,18,3,1
SBI65LZC1897368,18,22,21,1,1
SBI71GZO9823147,85,26,23,3,1
SBI68BDP1330353,78,22,14,8,1
SBI43QRF5662913,96,25,13,12,1
SBI02HXY8980590,62,23,19,4,1
SBI17UAE4878871,70,22,17,5,1
SBI05WUN0665554,75,26,23,3,1
SBI26MMC7762642,74,20,19,1,1
SBI57BDQ7179354,84,23,16,7,1
SBI19NTQ7326623,72,14,8,6,1
SBI89UKV0550676,21,28,15,13,1
SBI80ENV8307434,69,26,23,3,1
SBI53CDO4903651,89,32,27,5,1
SBI53BLD9047867,86,37,35,2,1
SBI82FPY6745699,98,18,16,2,1
SBI68JLA1808256,24,17,9,8,1
SBI60KUP9976164,66,25,19,6,1
SBI78CWU0743919,60,20,16,4,1
SBI39RRC3375421,62,23,15,8,1
SBI94LTE0084968,91,17,10,7,1
SBI43LSX7418822,67,17,16,1,1
SBI26BCM7539828,67,34,24,10,1
SBI49FTX1275299,84,27,18,9,1
SBI70UEM8112884,78,25,21,4,1
SBI43UIG8301094,97,23,16,7,1
SBI27ELA7194732,71,24,23,1,1
SBI68NKS4957789,84,22,14,8,1
SBI56ZMF9935925,96,27,21,6,1
SBI41SSO1889107,18,19,14,5,1
SBI28TND0656895,98,18,14,4,1
SBI02OXL2101204,18,21,14,7,1
SBI51VNZ8848109,67,27,14,13,1
SBI61NWJ9921775,93,21,18,3,1
SBI08CRQ4941251,98,26,22,4,1
SBI55ZWI7255629,82,22,16,6,1
SBI32KFN7928711,80,28,26,2,1
SBI51NOT4767001,23,25,17,8,1
SBI82UWW5974134,64,25,16,9,1
SBI38IOL4865464,88,39,27,12,1
SBI19TSX6154856,67,28,27,1,1
SBI22XCN4365829,20,32,26,6,1
SBI19JEV5474388,75,21,19,2,1
SBI32MKP8058183,89,21,19,2,1
SBI12TYU9268526,71,22,14,8,1
SBI94VML3409871,24,26,24,2,1
SBI01OUC0003090,85,25,21,4,1
SBI30CTX0075568,74,21,11,10,1
SBI35VPK9675518,62,24,21,3,1
SBI17OOJ6792249,62,24,13,11,1
SBI74LYL2516183,66,19,16,3,1
SBI72HYJ0042325,64,14,11,3,1
SBI87WHL9379714,24,19,15,4,1
SBI69SRN5288363,74,17,10,7,1
SBI87ZQT3484786,75,30,27,3,1
SBI47UKX3329400,20,32,21,11,1
SBI73AJG8367667,98,24,16,8,1
SBI60AKR8077128,63,17,13,4,1
SBI04LWS4618670,87,16,12,4,1
SBI57ZXX7459240,70,18,15,3,1
SBI78QOI4082315,64,31,21,10,1
SBI53LJY9261710,90,27,16,11,1
SBI41GCE4506840,95,24,18,6,1
SBI07YGP5882105,23,24,19,5,1
SBI16HQY0686109,73,21,14,7,1
SBI15DCH0291199,64,25,20,5,1
SBI43HPB8266045,92,20,11,9,1
SBI09PUZ5285282,64,22,18,4,1
SBI96WIW1054448,60,24,15,9,1
SBI02QCV8281603,23,23,17,6,1
SBI11JJS9503477,18,25,21,4,1
SBI96KHK1817721,19,17,15,2,1
SBI92OQH9087848,90,17,9,8,1
SBI13PGB3484370,25,19,14,5,1
SBI06QDI3284477,20,21,15,6,1
SBI13CSF7448922,61,22,14,8,1
SBI82AVB8889696,18,24,16,8,1
SBI90GGX7699580,65,21,16,5,1
SBI87JPP0517095,87,23,18,5,1
SBI22KSU8071613,62,34,18,16,1
SBI89NVR3605803,78,34,28,6,1
SBI69MBB6651941,23,29,27,2,1
SBI68QRG7096711,95,27,24,3,1
SBI78DQS6209341,95,26,19,7,1
SBI63TSV9507531,79,25,20,5,1
SBI70SCD8399640,83,27,26,1,1
SBI93CDC3597387,87,30,27,3,1
SBI96GUP8643004,21,31,27,4,1
SBI89EKG3961853,93,18,14,4,1
SBI91MOX1631854,25,26,16,10,1
SBI38PBM6900341,70,20,19,1,1
SBI94BPP7947779,23,28,15,13,1
SBI73AKS2832237,98,18,11,7,1
SBI79CVT0574930,91,24,16,8,1
SBI32MYQ6307731,99,30,29,1,1
SBI80SKX0274734,82,26,17,9,1
SBI08EPY9676584,62,27,16,11,1
SBI02RLD2099395,69,28,18,10,1
SBI20YJQ3836164,80,27,23,4,1
SBI70ZEM0537413,75,31,19,12,1
SBI19IDO8377413,21,26,23,3,1
SBI75WBF3652377,77,25,24,1,1
SBI52SJO8020365,85,31,27,4,1
SBI16AZI7088149,20,20,14,6,1
SBI77ULC4162732,65,21,13,8,1
SBI15XCM0807553,70,23,15,8,1
SBI91QUH9165375,64,24,23,1,1
SBI56COV6320035,78,24,15,9,1
SBI59VMU4256571,85,25,20,5,1
SBI17NST8588772,69,19,14,5,1
SBI46QKK4619051,19,24,17,7,1
SBI68MSW0355801,18,23,16,7,1
SBI47LZF4635147,87,28,25,3,1
SBI30MMJ1011400,86,25,23,2,1
SBI15DPX9141687,76,22,20,2,1
SBI35EPU1995875,61,18,11,7,1
SBI50WAW6074923,65,24,15,9,1
SBI64RAU4409402,75,22,16,6,1
SBI61EDA2858135,69,26,20,6,1
SBI24FFD8474564,78,24,14,10,1
SBI54OVQ3705092,94,30,28,2,1
SBI13XXT2502914,70,30,18,12,1
SBI08HSE4145640,97,25,16,9,1
SBI25OZP5329294,98,28,17,11,1
SBI03ZCM7303033,74,19,18,1,1
SBI41JGN3098428,64,23,17,6,1
SBI79UHD2785677,91,22,20,2,1
SBI78PBY4998873,62,18,15,3,1
SBI42FAR6203783,83,16,13,3,1
SBI71QXI8935349,67,27,18,9,1
SBI76HTC4255650,96,24,17,7,1
SBI06HSR1891486,80,20,19,1,1
SBI94AVZ9686500,63,30,26,4,1
SBI61XGP6770544,99,23,12,11,1
SBI93MTM0372060,98,25,17,8,1
SBI17AYB4036079,71,13,11,2,1
SBI40XIS0827482,65,25,21,4,1
SBI34ZZV0869113,78,25,15,10,1
SBI02DZC0569221,61,21,11,10,1
SBI70FSA5669592,75,21,17,4,1
SBI19ATJ2207585,70,9,5,4,1
SBI43RCU6600019,66,29,27,2,1
SBI55HQP9445769,80,17,12,5,1
SBI44OUA9589073,78,26,21,5,1
SBI60OQG1598750,85,25,15,10,1
SBI70MSX4924874,82,22,16,6,1
SBI07WPA1725852,89,23,22,1,1
SBI82DRU1586340,95,32,27,5,1
SBI96JTX2697502,78,23,21,2,1
SBI34XUF5762975,65,23,21,2,1
SBI22XQW6191549,70,25,22,3,1
SBI46WFI2562436,88,19,10,9,1
SBI11FVA0794052,98,32,22,10,1
SBI19ZPE1284679,77,25,13,12,1
SBI53OQY1612076,90,27,17,10,1
SBI46IUU2582936,85,28,19,9,1
SBI17ZSJ5542795,25,29,20,9,1
SBI97ECB6425304,60,32,31,1,1
SBI72CXS4810458,94,24,15,9,1
SBI77GQL4453374,84,35,31,4,1
SBI06BOI9112887,86,27,17,10,1
SBI82JCC9673809,80,21,13,8,1
SBI67XTX4915591,86,29,27,2,1
SBI03JZE4334147,62,32,19,13,1
SBI48RSR6231402,99,33,25,8,1
SBI79VCH2525163,74,31,21,10,1
SBI05DEZ2881217,19,18,11,7,1
SBI82MEK6035208,67,23,13,10,1
SBI84ZQB4259553,97,28,18,10,1
SBI96HVC6021624,62,27,25,2,1
SBI92SYN9742013,21,20,11,9,1
SBI31VJJ2577602,70,26,15,11,1
SBI97TET0409459,97,21,13,8,1
SBI12MCU4708325,67,29,18,11,1
SBI89GJE9062569,80,24,13,11,1
SBI37HCE0374311,65,26,16,10,1
SBI11KKJ2505134,73,22,20,2,1
SBI97KPO7553759,66,25,21,4,1
SBI08FAR8239881,95,23,17,6,1
SBI92NPV0257176,70,27,21,6,1
SBI29VJA2065722,75,32,21,11,1
SBI63FWE9649716,83,26,24,2,1
SBI56ZJY3952164,74,24,22,2,1
SBI33JHT2468857,76,22,15,7,1
SBI54LOU8943193,91,33,21,12,1
SBI72AYF9708708,99,22,15,7,1
SBI19KBQ2204212,91,24,16,8,1
SBI57EBH7750885,74,19,10,9,1
SBI86LZA7782272,24,26,21,5,1
SBI97NGQ0147281,67,32,31,1,1
SBI65LFJ5717693,19,27,22,5,1
SBI76RYK5519093,89,23,20,3,1
SBI82PMC2584437,68,18,14,4,1
SBI21YDZ1593743,88,20,11,9,1
SBI30WCS8990269,75,24,21,3,1
SBI72VDQ3776906,67,30,27,3,1
SBI32BPL9000318,94,27,17,10,1
SBI36PJP0207141,79,15,13,2,1
SBI23ESZ9909941,83,19,10,9,1
SBI39TCV8173779,60,19,16,3,1
SBI92PYK0251140,66,29,18,11,1
SBI89JEL8870330,91,23,16,7,1
SBI48MFD5736316,85,30,27,3,1
SBI19CHK8973363,88,23,14,9,1
SBI84NAQ8770421,90,26,18,8,1
SBI25FMY7122327,78,17,9,8,1
SBI79LZM2830089,91,21,15,6,1
SBI81QBU7103151,23,24,23,1,1
SBI06ASS6824310,78,26,19,7,1
SBI16WIY4307758,62,27,22,5,1
SBI36TKZ6911898,84,26,15,11,1
SBI29GRW0353102,65,26,17,9,1
SBI92KJY2835936,77,19,13,6,1
SBI68UGS9047281,64,21,16,5,1
SBI05CUN3004139,84,23,18,5,1
SBI28NIM4292447,71,19,12,7,1
SBI64FYX4502651,69,23,19,4,1
SBI81WQD0684871,69,23,21,2,1
SBI84OWL9102112,90,28,17,11,1
SBI34UKP6281330,86,25,19,6,1
SBI20LAR9025640,89,30,26,4,1
SBI73YRC6804418,62,21,20,1,1
SBI76YVA9550902,93,27,20,7,1
SBI60WDG7999416,63,20,11,9,1
SBI94UNH3396462,73,25,21,4,1
SBI88OES7578336,89,26,17,9,1
SBI54LZH7621974,75,25,23,2,1
SBI75OYW1138855,62,20,17,3,1
SBI18VKM6738013,76,27,25,2,1
SBI22BNG2731469,74,22,12,10,1
SBI24XYH9704287,84,22,16,6,1
SBI57EYP7176032,98,23,13,10,1
SBI22GFL6948858,78,34,18,16,1
SBI32WOT9269557,60,25,15,10,1
SBI26VNP6402653,64,24,22,2,1
SBI64TQV6731445,21,22,17,5,1
SBI37HBE7606595,79,23,21,2,1
SBI37RGO3900114,73,31,22,9,1
SBI72EUZ9322544,61,20,16,4,1
SBI97LBA1395197,88,23,13,10,1
SBI06KMG3210831,84,23,20,3,1
SBI12EXH0366851,89,28,18,10,1
SBI86XYZ0614949,60,16,9,7,1
SBI38DIM4777380,63,18,15,3,1
SBI30NJP9254267,95,27,20,7,1
SBI61ZOJ8359186,22,21,12,9,1
SBI08EYV2294501,84,23,21,2,1
SBI11QED2530702,20,32,30,2,1
SBI28SVT3781790,72,23,17,6,1
SBI93NDP4226092,96,24,18,6,1
SBI53BMX3245578,90,25,14,11,1
SBI29TBJ3915043,80,28,17,11,1
SBI10HWI0431985,86,27,18,9,1
SBI44HOI6155324,69,21,16,5,1
SBI66NQY0816283,92,20,16,4,1
SBI46MPA6586124,68,26,16,10,1
SBI47OSR4879846,68,15,13,2,1
SBI96PSC8735782,74,28,16,12,1
SBI13MUP8442334,91,25,18,7,1
SBI14RED8812892,65,27,20,7,1
SBI69TSD4561308,60,23,19,4,1
SBI05QPA5816731,18,27,22,5,1
SBI32OYA8065946,23,29,26,3,1
SBI38TPL5480096,66,24,15,9,1
SBI27WGA2329594,76,29,24,5,1
SBI69NNA7670152,78,25,22,3,1
SBI05NDH8395791,73,26,20,6,1
SBI35JLC1312846,94,25,13,12,1
SBI38HYG4960779,61,26,24,2,1
SBI20KTV4680985,62,22,18,4,1
SBI92XKG1176476,24,25,22,3,1
SBI84JXU8834673,82,30,28,2,1
SBI45MLM0700439,71,26,14,12,1
SBI73BUR8060789,96,30,17,13,1
SBI96IBR6435410,60,27,24,3,1
SBI61AZB9480412,61,18,13,5,1
SBI81BSZ7390325,66,25,18,7,1
SBI21QOQ8739742,23,24,13,11,1
SBI89PMG4786209,63,24,13,11,1
SBI59MTU6581172,96,23,12,11,1
SBI50SCM6578755,68,23,22,1,1
SBI56LEB9634989,95,25,13,12,1
SBI43JJN0060512,95,21,15,6,1
SBI61MYN0082922,73,20,19,1,1
SBI88JAZ6922484,94,35,23,12,1
SBI02WLP7904074,24,27,18,9,1
SBI50ADI4171054,93,24,20,4,1
SBI33WMS0254389,21,36,33,3,1
SBI41UEJ7963326,68,26,19,7,1
SBI71BAD1873958,66,20,18,2,1
SBI74JJX1690767,76,22,18,4,1
SBI26TZU6456485,79,25,17,8,1
SBI44BCO8377209,68,29,27,2,1
SBI61AYQ4476244,65,19,10,9,1
SBI08EGX4291494,71,21,19,2,1
SBI18FQP8434963,86,24,21,3,1
SBI39KIL7633796,73,27,25,2,1
SBI63KZS9912891,63,25,14,11,1
SBI62UOJ2174527,76,24,17,7,1
SBI02PNZ9033347,92,19,16,3,1
SBI49YJQ9099218,94,19,15,4,1
SBI80QZT7874796,71,35,29,6,1
SBI03BYG5995082,93,22,21,1,1
SBI57UNH8034045,78,30,22,8,1
SBI37DPP9670288,98,19,12,7,1
SBI49QEQ4159576,93,17,11,6,1
SBI43AYM3246021,71,20,15,5,1
SBI07WMG9480518,82,37,31,6,1
SBI19FSD9497746,68,27,14,13,1
SBI86SWF1963875,66,17,13,4,1
SBI52WNA7468119,90,28,27,1,1
SBI78JTH8166024,18,16,14,2,1
SBI58SMK5911415,67,31,24,7,1
SBI65JRU0859316,71,30,21,9,1
SBI00LAO2914281,85,26,24,2,1
SBI67ZRY1374221,91,19,11,8,1
SBI01WIY7107384,21,26,20,6,1
SBI19DIQ0489719,75,25,24,1,1
SBI62SKA5234425,65,16,12,4,1
SBI40GCM7481814,66,22,19,3,1
SBI85FEU7125989,69,18,13,5,1
SBI02ZLB4565855,95,21,18,3,1
SBI05IFW1689791,86,27,23,4,1
SBI38KJE9080946,24,25,22,3,1
SBI91YTQ2066966,91,26,19,7,1
SBI41TAD9619109,91,30,29,1,1
SBI66YLV5086493,66,23,21,2,1
SBI38GOH8446344,78,17,9,8,1
SBI32TXP8185308,25,11,10,1,1
SBI72ATN1348783,67,29,23,6,1
SBI23KAJ4510635,62,26,17,9,1
SBI38KSZ6163967,18,28,21,7,1
SBI68YDS3432624,85,18,13,5,1
SBI97FGV7448826,72,22,21,1,1
SBI44WNQ2870844,92,27,26,1,1
SBI39JLF2540371,22,21,17,4,1
SBI01DFI3234681,96,14,12,2,1
SBI66WJN8049055,25,35,28,7,1
SBI64GXH8032723,79,20,17,3,1
SBI73JIL1000256,77,20,16,4,1
SBI31KJB8307705,60,31,28,3,1
SBI08BAL7107088,20,23,16,7,1
SBI43YNL7560693,18,22,13,9,1
SBI85PXF7621176,69,34,31,3,1
SBI06ZBW7024923,92,23,17,6,1
SBI59HLE5817386,20,24,21,3,1
SBI90VHG4329296,83,27,19,8,1
SBI52FHP4662030,82,33,19,14,1
SBI79TPG3077549,23,26,16,10,1
SBI56PTM9177536,60,19,10,9,1
SBI94EAL5641539,76,25,23,2,1
SBI28UZV1534639,73,35,19,16,1
SBI21CTN6995831,82,28,17,11,1
SBI51PCB8487280,72,22,21,1,1
SBI48COP9983916,18,26,17,9,1
SBI16TTY7919220,97,15,11,4,1
SBI11JNL8524282,82,26,15,11,1
SBI51ZLO5174524,63,30,24,6,1
SBI63TJX5329663,25,25,20,5,1
SBI20JBT3891932,63,29,19,10,1
SBI22ZEH7876691,77,24,22,2,1
SBI42TZN3363316,18,29,23,6,1
SBI70QVZ8418600,75,20,14,6,1
SBI41OTW3766633,96,18,13,5,1
SBI73QEV4889681,76,18,11,7,1
SBI68TKU4375143,96,33,23,10,1
SBI57APQ2360446,76,26,24,2,1
SBI53LUY9037736,63,29,17,12,1
SBI12AJQ9665912,72,21,15,6,1
SBI40GIQ9225043,71,21,15,6,1
SBI90XSN7327470,79,27,17,10,1
SBI12TAJ7975034,76,25,24,1,1
SBI91ZXH4351395,86,25,13,12,1
SBI22PSN1064307,89,21,16,5,1
SBI21KCX5341503,87,35,18,17,1
SBI89IJR6228509,21,25,19,6,1
SBI41NCO4314975,98,23,17,6,1
SBI10MFE4623421,77,21,18,3,1
SBI63BPB9068404,68,15,8,7,1
SBI55AFA3894059,74,29,18,11,1
SBI70RRT0145987,64,22,13,9,1
SBI10FDG3760314,24,25,23,2,1
SBI06MXL5355181,90,25,23,2,1
SBI95YDR7381996,85,26,19,7,1
SBI73LZN5458725,22,30,29,1,1
SBI21KKN0231505,99,23,12,11,1
SBI01NBI6164098,24,19,11,8,1
SBI66XFP2549840,71,19,17,2,1
SBI24JLK0312600,66,24,23,1,1
SBI97NSB0463529,60,22,18,4,1
SBI17CAD0754228,66,23,15,8,1
SBI31GWL2778484,62,22,14,8,1
SBI16KWQ0714961,64,20,13,7,1
SBI33FCR5440131,89,30,28,2,1
SBI77QED6068026,70,25,19,6,1
SBI81IPD6645585,76,23,14,9,1
SBI58UUL6908082,92,23,22,1,1
SBI38OXV4795550,67,25,13,12,1
SBI90RSV2281711,91,21,18,3,1
SBI60RWD7762089,73,20,11,9,1
SBI40AGU5290085,82,19,16,3,1
SBI54LUT2644808,96,20,19,1,1
SBI59AIG8458529,71,15,13,2,1
SBI52AHS0137024,22,30,20,10,1
SBI14XMG9896880,79,27,22,5,1
SBI94QQQ9114183,77,21,16,5,1
SBI96AAK6091328,80,19,17,2,1
SBI55EQA5400677,63,21,11,10,1
SBI66HEX0493925,23,26,17,9,1
SBI19AFQ1998480,90,18,10,8,1
SBI58BLF6495303,61,24,13,11,1
SBI88EFW8478523,95,30,26,4,1
SBI89RYJ0650884,76,21,19,2,1
SBI40UZM7121872,64,27,24,3,1
SBI25ORW6273349,19,20,11,9,1
SBI07HNN4186657,70,25,14,11,1
SBI05RTC3870690,18,23,15,8,1
SBI07EDQ7842087,65,24,17,7,1
SBI77HVR3586794,24,31,25,6,1
SBI65XEG5206996,74,31,16,15,1
SBI10AMZ0995589,91,28,23,5,1
SBI84OCV9620588,99,30,26,4,1
SBI60OTG0865948,79,14,12,2,1
SBI53CZI5441335,85,26,19,7,1
SBI15AJF8303633,68,26,19,7,1
SBI18UMY7522947,70,21,17,4,1
SBI84HSM7076071,19,34,23,11,1
SBI09RUY2224053,65,24,13,11,1
SBI25REC6881923,81,20,19,1,1
SBI89BUD9436450,87,22,13,9,1
SBI47CJL9856004,77,25,17,8,1
SBI80WAU1801173,85,23,17,6,1
SBI68LTG5333513,75,34,33,1,1
SBI05HJL1925991,90,25,21,4,1
SBI67OEJ1855390,90,22,15,7,1
SBI46MXT5497198,83,25,16,9,1
SBI15JLU8652716,76,19,13,6,1
SBI93JXJ9830703,25,25,13,12,1
SBI43MXO8683690,65,33,27,6,1
SBI08CLT8563131,20,18,12,6,1
SBI94WMK0367235,90,24,20,4,1
SBI09PCF6887774,79,27,24,3,1
SBI75CTV7522816,64,24,16,8,1
SBI90DCT7798868,81,24,19,5,1
SBI89LRL6167100,73,32,18,14,1
SBI37ZWW9550366,19,26,24,2,1
SBI71TXJ1698341,88,21,18,3,1
SBI76DDC6815774,69,30,16,14,1
SBI49MJI8075032,78,23,14,9,1
SBI22HGS3589714,71,21,15,6,1
SBI65CEE8899151,86,32,29,3,1
SBI20XNV9408795,93,28,26,2,1
SBI10QPS9567476,87,24,17,7,1
SBI16OTH1653092,75,31,27,4,1
SBI76UGR9786993,73,16,14,2,1
SBI47LDH2792637,66,32,30,2,1
SBI01LDI2384264,87,23,21,2,1
SBI71GQY6336731,62,22,13,9,1
SBI03OFD8979359,19,21,15,6,1
SBI87LFQ1233834,67,23,12,11,1
SBI82AQH1739814,95,28,22,6,1
SBI99YFP0914696,74,40,21,19,1
SBI58PTA2835839,63,24,19,5,1
SBI23FQV5506577,86,17,13,4,1
SBI00UWP3707854,98,31,21,10,1
SBI87PLE1502730,92,22,17,5,1
SBI79RRO3974031,67,15,11,4,1
SBI78XTR5572176,98,17,13,4,1
SBI40ZCH2502952,71,29,23,6,1
SBI57HIB3592685,64,31,26,5,1
SBI23PSL1798958,65,28,25,3,1
SBI50ALI1869438,74,25,17,8,1
SBI52KBN2162972,82,21,14,7,1
SBI73ZWN5136185,68,16,12,4,1
SBI95IBB7657526,64,26,24,2,1
SBI31YKP6784514,94,30,23,7,1
SBI19CRE8647520,87,20,15,5,1
SBI98LCQ2049308,85,25,22,3,1
SBI83NQV2180991,60,27,21,6,1
SBI65NOT1859476,93,26,22,4,1
SBI11QQK1779302,83,28,22,6,1
SBI35WZJ6948431,21,20,18,2,1
SBI45HIO1205176,21,21,11,10,1
SBI22WCI9778701,65,22,14,8,1
SBI58IEH6431385,62,20,13,7,1
SBI38KKP2969558,97,20,18,2,1
SBI44RXA0066575,66,22,13,9,1
SBI34NSO1406190,88,15,12,3,1
SBI42GOY1311454,64,26,14,12,1
SBI11ACU2527626,82,23,19,4,1
SBI38OPB6917690,77,21,16,5,1
SBI04JFJ9823278,78,22,20,2,1
SBI94WTW8186484,91,12,8,4,1
SBI22JEN5043889,60,22,20,2,1
SBI68OOT1620262,25,18,12,6,1
SBI27LHK6145298,97,32,19,13,1
SBI47BVO8239287,96,28,25,3,1
SBI80ODB7260934,95,24,18,6,1
SBI93UCA1681972,90,27,23,4,1
SBI18QJZ3830463,23,31,20,11,1
SBI25QFR4333768,94,25,23,2,1
SBI91GSB5280545,72,27,16,11,1
SBI74ZWG4848104,69,18,14,4,1
SBI08TEH7555567,94,29,15,14,1
SBI26UXK6527582,66,17,10,7,1
SBI12MVQ3989997,94,25,18,7,1
SBI51UCC3016751,88,33,19,14,1
SBI02SKN5273547,19,22,18,4,1
SBI18LAA5118682,99,20,17,3,1
SBI17UFS6455587,93,29,24,5,1
SBI15PEO7769469,87,25,17,8,1
SBI42SKI0201438,21,33,26,7,1
SBI46AOL3434019,20,22,17,5,1
SBI80MQO4027496,90,34,29,5,1
SBI59ZWF3064119,97,23,21,2,1
SBI91QTI5495265,73,24,19,5,1
SBI09RMP2385034,77,35,25,10,1
SBI73CUB8902642,86,23,18,5,1
SBI56LIR0879068,77,31,21,10,1
SBI92CQR3992536,85,21,19,2,1
SBI00NWY8192115,63,32,31,1,1
SBI21NUR4597279,69,34,24,10,1
SBI06SEL0720029,92,28,17,11,1
SBI47UJJ5732340,79,19,11,8,1
SBI98ECJ0136502,82,29,27,2,1
SBI93TMJ9019621,70,25,23,2,1
SBI33DGJ7753156,99,18,14,4,1
SBI79NTD7595386,77,25,14,11,1
SBI89JVA2040176,95,19,11,8,1
SBI85MQW2725187,98,26,22,4,1
SBI07RLV7090719,24,21,17,4,1
SBI88WIK8636098,66,33,20,13,1
SBI09LXB2055865,92,25,17,8,1
SBI55DXF4036504,69,20,18,2,1
SBI36FCQ9202698,70,25,18,7,1
SBI31IDD2060008,73,17,9,8,1
SBI34ULC8825214,95,22,21,1,1
SBI89TWC6038860,94,26,25,1,1
SBI98RDU1162994,85,19,17,2,1
SBI32WRB9437921,65,29,17,12,1
SBI97ZJB3735074,62,30,20,10,1
SBI93ARN4038492,82,20,15,5,1
SBI69FDO8091089,85,25,13,12,1
SBI54QEG3162221,74,24,19,5,1
SBI81AFD6030723,23,19,10,9,1
SBI63DQW2664257,23,20,15,5,1
SBI50EYI0154971,22,29,24,5,1
SBI82XBG3985160,87,24,16,8,1
SBI98YII6919763,81,21,13,8,1
SBI85VTV7734128,21,29,24,5,1
SBI97CQV3544110,96,19,15,4,1
SBI42YOS8801290,76,14,11,3,1
SBI33QDX4517402,25,18,15,3,1
SBI55XLP6511466,20,34,28,6,1
SBI77RIN4327481,79,30,22,8,1
SBI96PJX6765208,25,17,9,8,1
SBI66GXZ9808448,92,37,19,18,1
SBI59DUN2860251,19,29,26,3,1
SBI35LBR8913792,89,14,9,5,1
SBI91BRJ8624274,92,26,19,7,1
SBI85HZK2699484,93,24,15,9,1
SBI36HBC1261093,25,18,16,2,1
SBI79IQE2744178,77,25,19,6,1
SBI80GPJ0636214,87,18,15,3,1
SBI60GPH8378855,23,23,20,3,1
SBI20CAB7465022,75,26,14,12,1
SBI61GFA6656072,74,18,10,8,1
SBI82TWN8432629,70,33,31,2,1
SBI40REC2494938,71,27,16,11,1
SBI28XKW8048961,98,22,15,7,1
SBI12MMZ8528696,66,25,15,10,1
SBI13MGX4733519,92,27,25,2,1
SBI85OHW1044328,63,31,18,13,1
SBI75MTO2103042,68,33,21,12,1
SBI94SPD7855438,84,31,27,4,1
SBI49CZW0883399,62,22,17,5,1
SBI15URF2219367,66,28,26,2,1
SBI30ABJ6855460,83,26,14,12,1
SBI64UZZ0619878,64,29,16,13,1
SBI77IJE1966370,67,23,21,2,1
SBI85KBG9443803,66,26,24,2,1
SBI99NNG1986451,88,22,17,5,1
SBI82JGV3097223,98,24,16,8,1
SBI68XWW6032539,98,23,22,1,1
SBI74VRP9100247,99,24,22,2,1
SBI68DSS1386368,75,26,18,8,1
SBI29FHE3854162,77,25,16,9,1
SBI18QSY5361806,84,33,32,1,1
SBI90EOV8756794,22,20,12,8,1
SBI02AJQ0665779,21,26,22,4,1
SBI00THP6678136,65,22,18,4,1
SBI47CCI1028965,96,34,25,9,1
SBI51QGA5783283,94,32,31,1,1
SBI10YAS1657626,70,31,28,3,1
SBI43TMI6255608,25,20,19,1,1
SBI98DNR3013756,75,30,22,8,1
SBI30TMS3186339,84,17,12,5,1
SBI23YRL5958906,74,21,17,4,1
SBI72QGW6336187,73,22,15,7,1
SBI09DGI2892604,67,26,23,3,1
SBI13IKF7923046,72,18,12,6,1
SBI64MMG2932509,88,32,17,15,1
SBI89QAO1081378,71,17,14,3,1
SBI67EFQ5437799,89,28,24,4,1
SBI85FKH3603647,60,27,23,4,1
SBI46TEF2428604,95,24,13,11,1
SBI43DLB4629389,92,24,14,10,1
SBI71HRD8436172,76,23,21,2,1
SBI08GFH4317785,78,25,14,11,1
SBI27ZBM0256290,88,25,19,6,1
SBI84QSM4063474,95,31,27,4,1
SBI26VGC7417870,22,29,22,7,1
SBI29AAJ0519498,64,16,10,6,1
SBI81BLS1000695,25,28,27,1,1
SBI32UPI8670092,68,18,17,1,1
SBI03PUB4535983,98,24,14,10,1
SBI76ONJ7988662,93,23,14,9,1
SBI42DHL6353608,97,22,20,2,1
SBI62EXR0279065,68,21,13,8,1
SBI43GHJ2556374,63,11,9,2,1
SBI72KRB4014529,20,25,13,12,1
SBI30VNG0396056,99,19,14,5,1
SBI77ONT4632409,80,19,13,6,1
SBI50IRX4389105,83,25,16,9,1
SBI60QAS7657565,78,21,20,1,1
SBI12LIY0819909,25,21,17,4,1
SBI91JRC0054932,83,17,16,1,1
SBI41LQO2939941,95,26,15,11,1
SBI31LTQ1560506,62,24,22,2,1
SBI61PPA3216110,66,20,18,2,1
SBI80VBM7015878,67,29,26,3,1
SBI41LFB0843466,79,26,18,8,1
SBI99JLD6654488,78,12,7,5,1
SBI11CCI6803630,78,16,13,3,1
SBI95NOQ4616727,84,24,17,7,1
SBI94DOI0344628,60,27,21,6,1
SBI53IIZ9615484,23,22,17,5,1
SBI73WMN9389429,68,26,23,3,1
SBI90VHS6484134,65,28,22,6,1
SBI42FAZ7479370,81,23,20,3,1
SBI36DQB9798777,68,28,16,12,1
SBI12ARN3862651,77,20,13,7,1
SBI05GBL4439538,19,25,14,11,1
SBI91PNU3131145,86,26,24,2,1
SBI42SGF4037530,91,26,24,2,1
SBI22RTM7336804,96,32,17,15,1
SBI12AMI4861379,96,24,15,9,1
SBI49DLW4591133,63,21,19,2,1
SBI42QDP4367974,97,20,18,2,1
SBI54MOI4751345,94,33,23,10,1
SBI70YKJ0678494,92,25,22,3,1
SBI66QNZ9226293,60,30,20,10,1
SBI67CAA2798217,76,23,12,11,1
SBI62QPJ1451735,21,27,17,10,1
SBI87DTT4059012,22,29,27,2,1
SBI97XWC5750966,82,27,14,13,1
SBI00XLH2765858,77,28,18,10,1
SBI18LOM5008197,60,22,18,4,1
SBI55NCR8961724,75,28,19,9,1
SBI95SXR9289081,94,24,19,5,1
SBI01FWL4155282,91,21,15,6,1
SBI72SGX8640312,66,27,20,7,1
SBI54NMH4426380,23,29,20,9,1
SBI88PPY0482665,86,29,22,7,1
SBI23GBC5224805,91,19,17,2,1
SBI49YPW8301245,93,25,15,10,1
SBI63RHK6778150,90,29,23,6,1
SBI95ZDH9258676,82,27,26,1,1
SBI52NAG2351288,25,37,30,7,1
SBI12GWG3033964,24,22,19,3,1
SBI93ARE3370252,21,22,20,2,1
SBI58AKM3804030,78,31,23,8,1
SBI64PGE5642514,72,18,10,8,1
SBI09KVH2122608,64,17,13,4,1
SBI36WJB0730543,65,24,22,2,1
SBI01HHK8920166,63,30,18,12,1
SBI79UHB9458698,73,19,16,3,1
SBI27ZIS4875156,61,20,16,4,1
SBI19IEJ4825561,63,29,16,13,1
SBI01FJY3089734,61,23,17,6,1
SBI85HLH7590177,96,17,13,4,1
SBI42QOJ1946858,95,23,18,5,1
SBI82CRZ4051886,66,20,11,9,1
SBI30QCJ2817557,88,19,10,9,1
SBI18SQL1699995,25,24,23,1,1
SBI06ZBT7760891,98,25,19,6,1
SBI25OIP2275256,25,18,16,2,1
SBI77DDK5943982,95,28,27,1,1
SBI87KJJ1769047,60,27,14,13,1
SBI61VHS0624619,65,26,23,3,1
SBI30SKY9316479,99,25,22,3,1
SBI53RGQ3270265,97,25,22,3,1
SBI21YZJ7547585,23,25,23,2,1
SBI74SBW3863225,77,25,24,1,1
SBI57UTB5612668,95,32,30,2,1
SBI49MEP2011710,76,20,14,6,1
SBI51NNP2602128,61,25,18,7,1
SBI21UTG4896230,69,30,27,3,1
SBI03AZU5431824,22,26,18,8,1
SBI16BIO5049050,81,26,24,2,1
SBI87TIF2707934,60,26,22,4,1
SBI86QLW9217634,65,21,16,5,1
SBI22RXC7989018,83,28,23,5,1
SBI19TDZ9326841,90,29,22,7,1
SBI83PHE1863346,84,26,21,5,1
SBI11XUQ3638330,79,13,8,5,1
SBI39RCH4657977,76,20,12,8,1
SBI20ZVR8832841,97,22,13,9,1
SBI55XAH7536121,60,29,27,2,1
SBI03TKW3832532,82,16,15,1,1
SBI49OVT4375531,63,24,23,1,1
SBI93GCD1729432,75,23,17,6,1
SBI18ITO7539144,82,25,23,2,1
SBI84KIF4605767,70,28,20,8,1
SBI22HAF5242273,80,24,13,11,1
SBI94WWV5562882,74,30,21,9,1
SBI39RQW2813530,90,9,6,3,1
SBI92WWH7263994,93,23,16,7,1
SBI23OZD7946718,72,14,12,2,1
SBI11YVK5753318,81,23,18,5,1
SBI12IHC6240002,95,26,19,7,1
SBI44ECP3265561,73,17,12,5,1
SBI98SUC1729961,97,25,19,6,1
SBI69BRI8390109,97,22,14,8,1
SBI85TTS3189676,96,28,24,4,1
SBI92JCR4878947,18,34,28,6,1
SBI43GEF4863088,82,22,15,7,1
SBI02IAM6290743,88,24,14,10,1
SBI93ZTD6640683,20,21,11,10,1
SBI94RGW0774465,94,24,23,1,1
SBI57CTA7119190,97,31,18,13,1
SBI75FAG2579125,22,31,23,8,1
SBI83BIM9949907,82,33,18,15,1
SBI14ZPX9234482,90,35,19,16,1
SBI91UFL1411200,67,32,20,12,1
SBI54HJB7399651,94,31,20,11,1
SBI60RAE0922340,88,29,26,3,1
SBI04GUH9597352,86,17,14,3,1
SBI14ADF2262688,73,28,19,9,1
SBI28OEW2369375,94,28,23,5,1
SBI97AKN6936066,25,21,13,8,1
SBI06WXC1127023,61,30,29,1,1
SBI13ZPL9467028,66,28,26,2,1
SBI16IKQ5548256,84,27,24,3,1
SBI71WBG0971117,98,23,20,3,1
SBI52VJJ2330136,78,26,21,5,1
SBI81RRA5438892,24,21,17,4,1
SBI58DGO9394752,21,25,17,8,1
SBI66UNT3460917,97,29,23,6,1
SBI58QJX6489236,80,30,27,3,1
SBI92XJC5935751,81,24,21,3,1
SBI29XZU4924684,18,24,18,6,1
SBI07AOY6584681,64,26,16,10,1
SBI57LPZ6439905,86,22,14,8,1
SBI28QOO0523719,77,25,15,10,1
SBI61EZH0657014,98,22,15,7,1
SBI27SFW5109946,77,32,27,5,1
SBI70TDK7936152,93,25,20,5,1
SBI22EYG7952247,76,19,13,6,1
SBI76KES6660656,22,25,16,9,1
SBI57OWC4220546,83,26,15,11,1
SBI58PFS4159402,89,19,16,3,1
SBI26UTH6107477,67,25,20,5,1
SBI07KWA2343381,88,19,18,1,1
SBI81VZU8357086,19,17,14,3,1
SBI88CRC5556690,89,22,16,6,1
SBI42HHP6701093,80,22,19,3,1
SBI13GMO9822562,64,19,16,3,1
SBI70YHW1664196,78,27,20,7,1
SBI06ICE8612146,87,26,17,9,1
SBI11JGS9607297,69,25,20,5,1
SBI60TXH5452498,22,28,23,5,1
SBI04URM9911205,69,19,11,8,1
SBI77LBO6867953,78,27,19,8,1
SBI95LNC3299402,90,26,25,1,1
SBI70EGD8708219,82,18,11,7,1
SBI90ICG8240063,80,25,13,12,1
SBI88DBO1265604,60,35,25,10,1
SBI39LOP3085783,68,20,17,3,1
SBI50TCS6603035,25,25,23,2,1
SBI52KKH4084987,67,21,17,4,1
SBI97LCW6266162,60,20,16,4,1
SBI85ZFZ6371352,82,10,8,2,1
SBI65VNB6122331,98,26,14,12,1
SBI28CZI7718200,80,26,23,3,1
SBI50XSB9164244,75,25,13,12,1
SBI13GEW0600606,85,20,16,4,1
SBI32CJD6741082,74,28,16,12,1
SBI25JHC8012793,76,31,29,2,1
SBI69PBY6928504,64,25,21,4,1
SBI46LTT9293040,22,32,31,1,1
SBI28IBT6027613,21,15,12,3,1
SBI75HLD0178649,19,30,17,13,1
SBI21HUM4588770,67,21,13,8,1
SBI37OEU4203653,95,36,34,2,1
SBI24GNM7079758,68,24,23,1,1
SBI98WSA2882465,83,32,31,1,1
SBI13TUZ4018549,74,22,18,4,1
SBI17YOB0261576,23,21,18,3,1
SBI17IYH8350539,64,22,18,4,1
SBI70QZQ0757410,20,23,21,2,1
SBI22JND5264656,24,31,23,8,1
SBI03JGJ6944932,64,18,15,3,1
SBI36HHQ0025095,73,39,21,18,1
SBI42NEW7215726,67,25,17,8,1
SBI38QZG4953529,85,28,15,13,1
SBI48TLW3366093,95,33,26,7,1
SBI13XMG5276489,92,28,24,4,1
SBI47QOI8074056,73,21,13,8,1
SBI18OBK4977330,74,24,15,9,1
SBI68XQF8500529,66,23,19,4,1
SBI98NJD4769009,97,19,11,8,1
SBI39REG2022580,82,19,14,5,1
SBI17SWF9238743,23,24,19,5,1
SBI29MNW1889917,71,28,15,13,1
SBI63MDJ8215264,91,38,32,6,1
SBI74UVN8334167,89,24,23,1,1
SBI38NTK1296961,78,35,25,10,1
SBI58CUP3249832,25,22,15,7,1
SBI26MLH4692103,87,26,21,5,1
SBI12WER9668332,91,22,17,5,1
SBI22CCS1000962,85,29,20,9,1
SBI23YAP8901163,18,13,7,6,1
SBI83OUR9639736,19,27,15,12,1
SBI19ATQ9246027,23,21,13,8,1
SBI03DTK2979665,95,27,26,1,1
SBI61RST3873274,19,28,20,8,1
SBI36BRU6141407,77,24,16,8,1
SBI84DLX8172191,85,21,18,3,1
SBI59DNB7034039,88,27,14,13,1
SBI13VDK9006969,67,33,24,9,1
SBI98IUN6959976,97,25,21,4,1
SBI58AXV1344805,89,23,21,2,1
SBI82PUH1001351,82,15,13,2,1
SBI17KRZ2829304,60,16,10,6,1
SBI70LKK6465950,20,23,13,10,1
SBI37RIJ9553859,78,30,20,10,1
SBI01TSB6422644,74,28,23,5,1
SBI37MCD6429200,75,20,11,9,1
SBI12CCH5818875,99,21,13,8,1
SBI26PSG5350626,70,23,14,9,1
SBI70ICI8237250,76,21,11,10,1
SBI23FDK7770187,20,23,19,4,1
SBI94PDF8955579,74,31,21,10,1
SBI07YSE1698669,68,23,18,5,1
SBI15WLT8872569,23,24,20,4,1
SBI58WTC6114630,72,21,11,10,1
SBI67CNN0693464,84,25,23,2,1
SBI71NRK9719096,98,29,27,2,1
SBI30SXA2157592,78,28,18,10,1
SBI80HNH4241819,62,21,16,5,1
SBI17ZXY8518030,19,29,28,1,1
SBI54FBM7141907,83,19,12,7,1
SBI50OUD4135755,90,27,24,3,1
SBI68RAW2118276,83,24,15,9,1
SBI31GUG1445039,73,25,22,3,1
SBI60EHJ8275140,89,23,19,4,1
SBI90CDE5590152,74,20,14,6,1
SBI99QWQ5266646,66,18,11,7,1
SBI91DWG4629546,83,23,17,6,1
SBI33QCI5950380,60,34,21,13,1
SBI79HSF4257878,94,27,19,8,1
SBI63DNW5874772,86,21,11,10,1
SBI38QPQ9484967,61,27,23,4,1
SBI64EFZ3116211,20,23,20,3,1
SBI47AYQ1402465,64,29,15,14,1
SBI38DVD3309893,88,28,18,10,1
SBI60MUI1295880,97,18,10,8,1
SBI40MSM4275450,65,23,17,6,1
SBI15CKJ2932893,95,26,23,3,1
SBI64CTD5908578,71,16,9,7,1
SBI31EWW0101981,98,25,19,6,1
SBI88SMF0870228,78,26,15,11,1
SBI52QXT3023223,86,15,10,5,1
SBI13NNK1966942,66,29,27,2,1
SBI04VBS2947168,79,27,22,5,1
SBI45DXV6787947,91,16,12,4,1
SBI91BPY3004388,87,23,16,7,1
SBI57IUV3657910,90,23,14,9,1
SBI14EQP6908207,73,22,17,5,1
SBI00UZZ5190044,67,26,16,10,1
SBI97KJV3837529,60,27,14,13,1
SBI97FKW0203817,67,25,16,9,1
SBI03GZP6738867,78,27,21,6,1
SBI19RSI9054926,98,25,16,9,1
SBI64FFN2284336,19,20,18,2,1
SBI47IBF7808533,23,21,15,6,1
SBI50NGZ4400262,72,17,14,3,1
SBI48BJU9046516,97,26,22,4,1
SBI91GZC5715268,92,26,16,10,1
SBI13NMK7975311,77,34,30,4,1
SBI74JRX5589765,88,25,22,3,1
SBI03UAT0534660,88,26,18,8,1
SBI02FJS4767816,61,26,19,7,1
SBI63YKD7959931,93,18,14,4,1
SBI02HQA0159600,99,31,20,11,1
SBI77BZL6967493,92,21,13,8,1
SBI80BCW7380240,89,24,13,11,1
SBI26SRC7452971,61,24,18,6,1
SBI05LJG5593042,63,28,21,7,1
SBI33OZK8032819,85,27,21,6,1
SBI93TXC3884972,93,28,18,10,1
SBI31ZIR6278890,18,18,17,1,1
SBI16EXF5048673,85,22,13,9,1
SBI96PQF6716671,21,14,10,4,1
SBI00GIW6309192,72,35,29,6,1
SBI39SOF3147283,74,26,24,2,1
SBI05EEP5789318,61,30,20,10,1
SBI97HWN6484677,71,29,21,8,1
SBI86PMG0900381,92,29,22,7,1
SBI84TSZ9456803,90,23,21,2,1
SBI58VFX4287728,71,22,14,8,1
SBI15EYU6920241,70,22,20,2,1
SBI28SDQ7157017,66,21,13,8,1
SBI61XKV4141796,69,27,17,10,1
SBI00RUU2027795,78,26,23,3,1
SBI06EWL8383572,63,23,18,5,1
SBI08SRL2654785,79,20,13,7,1
SBI57BLN2945588,67,17,14,3,1
SBI36LVN3338126,85,27,20,7,1
SBI63JRA8478079,75,31,24,7,1
SBI65CNK0986378,81,36,30,6,1
SBI52LVD2933393,82,37,25,12,1
SBI97SAJ0334216,88,24,19,5,1
SBI05QYP1425488,98,25,18,7,1
SBI33NND8994910,85,24,18,6,1
SBI06WGQ3458459,65,16,12,4,1
SBI87GYI4141358,24,16,11,5,1
SBI16NIF7954415,76,28,18,10,1
SBI18CNE1495907,89,20,17,3,1
SBI17IQJ8237945,89,19,13,6,1
SBI48BGG2492618,69,23,18,5,1
SBI36LDT4245134,62,31,27,4,1
SBI03XSP1761019,62,30,24,6,1
SBI89ZCV3677933,82,26,16,10,1
SBI01AKC0463569,80,23,18,5,1
SBI00QHD4474057,19,22,13,9,1
SBI72BOE6560383,60,23,19,4,1
SBI54XBB8764078,60,23,21,2,1
SBI68NIY1994087,79,19,11,8,1
SBI65YHN2979878,95,24,20,4,1
SBI33UCQ8811362,75,30,26,4,1
SBI32BAK1001879,61,23,20,3,1
SBI21GJS1265955,66,24,20,4,1
SBI50NYT7029928,95,18,11,7,1
SBI61TDE2430527,67,22,16,6,1
SBI83QMP2182867,86,17,14,3,1
SBI67YHI1712342,68,28,16,12,1
SBI67MNB8576659,98,25,23,2,1
SBI29DXM1412891,85,25,18,7,1
SBI92GTK6350844,84,26,19,7,1
SBI42WMI7366933,66,30,19,11,1
SBI53HCY5132544,22,18,12,6,1
SBI16VDW1933881,80,25,23,2,1
SBI06UZD9325048,73,34,33,1,1
SBI06XLH1412419,91,30,27,3,1
SBI30DBB7936446,63,27,16,11,1
SBI34TMP8809664,77,23,22,1,1
SBI69MEA3576102,60,22,12,10,1
SBI31LNZ7725457,72,21,12,9,1
SBI59JPY5402160,82,33,27,6,1
SBI03PTM1270114,97,32,24,8,1
SBI74CZJ1151668,62,17,13,4,1
SBI42SJX5663854,66,19,14,5,1
SBI04YTX9453106,95,25,23,2,1
SBI39LGM6126464,76,21,11,10,1
SBI24DQP7355991,90,25,18,7,1
SBI59ROB1194333,25,28,25,3,1
SBI12FFB4291740,86,27,26,1,1
SBI14USZ6567556,74,27,24,3,1
SBI76PPJ2977586,70,24,20,4,1
SBI50GRS8883864,76,21,19,2,1
SBI74WBC1651739,71,17,15,2,1
SBI94WOD1994931,60,27,26,1,1
SBI65MRE4610201,22,25,18,7,1
SBI04MUR7733530,78,26,17,9,1
SBI25OMG4039116,24,22,16,6,1
SBI99VHQ1458790,86,28,25,3,1
SBI47STH0770566,23,27,23,4,1
SBI43GFL9255142,88,15,11,4,1
SBI74BLT9285079,80,31,20,11,1
SBI22QEL7012173,24,18,15,3,1
SBI92BPV0103237,64,22,18,4,1
SBI07YHB0889644,60,26,21,5,1
SBI70CUY6084771,86,29,23,6,1
SBI93HJG5725015,19,23,19,4,1
SBI77MVI9428731,60,23,20,3,1
SBI62SBZ7771880,88,28,20,8,1
SBI84FPG0951514,69,22,18,4,1
SBI13TAJ9730941,65,23,16,7,1
SBI97QEK8584445,72,21,13,8,1
SBI09RHJ9779747,75,32,17,15,1
SBI09MHD8928231,74,22,19,3,1
SBI85UTZ6727969,98,26,25,1,1
SBI67VAS7432098,98,19,18,1,1
SBI45ETH8802216,76,30,17,13,1
SBI49VMU6518746,19,21,15,6,1
SBI13CKI5124705,86,34,30,4,1
SBI50JIL7927336,68,23,22,1,1
SBI22NJT1811698,94,16,15,1,1
SBI75ARX0488635,92,21,18,3,1
SBI13QPY0797773,72,18,16,2,1
SBI05IYP0781816,85,28,16,12,1
SBI02SJY4498325,92,24,22,2,1
SBI38KSO8161565,72,29,25,4,1
SBI44OLW2444661,94,23,19,4,1
SBI37SUA0504223,77,26,24,2,1
SBI62UXT6422485,75,30,20,10,1
SBI14YAJ4150782,83,24,13,11,1
SBI35JRW6340353,70,31,19,12,1
SBI11JAZ6249304,98,29,23,6,1
SBI84QVF2926074,78,27,26,1,1
SBI34BOD1551341,64,22,13,9,1
SBI99YIA7245168,19,33,29,4,1
SBI47PFL9902239,98,30,27,3,1
SBI93UBJ7195550,96,24,18,6,1
SBI41MIG1054787,71,22,13,9,1
SBI16OPF4126904,75,25,19,6,1
SBI01VAS9929203,74,32,25,7,1
SBI62BUK5629697,21,23,16,7,1
SBI29PQM2474631,82,25,17,8,1
SBI59XFV0566384,93,25,21,4,1
SBI91DFQ3899887,19,27,25,2,1
SBI42QVA5875204,64,25,22,3,1
SBI28UFO6502809,99,13,7,6,1
SBI00SGB3859347,64,23,18,5,1
SBI74FZA4182842,22,31,23,8,1
SBI47ZLG2224571,70,32,31,1,1
SBI23YYE2202334,92,30,25,5,1
SBI16KWH9091829,79,20,15,5,1
SBI09JLF2654343,71,29,23,6,1
SBI05AFY2771231,85,24,18,6,1
SBI53TOF1310270,19,32,21,11,1
SBI28PQY6779498,62,21,18,3,1
SBI90WSH6173378,69,24,22,2,1
SBI54PTG9160741,69,27,23,4,1
SBI98QJX3412401,76,23,16,7,1
SBI44LWZ6736018,66,31,16,15,1
SBI49XLA8635339,67,22,12,10,1
SBI23HRQ1797767,24,20,14,6,1
SBI56EXQ0970295,80,24,13,11,1
SBI55PFF6885201,82,24,15,9,1
SBI00MVI4667442,62,26,17,9,1
SBI73WYS1232266,99,21,18,3,1
SBI88YWR7668490,67,25,17,8,1
SBI73NIG8064590,82,22,12,10,1
SBI77XJX2599198,93,28,21,7,1
SBI07BKR6572031,83,23,21,2,1
SBI91UIZ9266443,23,18,16,2,1
SBI43NLQ9032141,86,29,15,14,1
SBI83YJX5353585,84,18,13,5,1
SBI70TYM3106529,71,28,20,8,1
SBI80XER0183965,98,25,13,12,1
SBI01RVH0128308,87,26,20,6,1
SBI95SGT4454750,96,23,15,8,1
SBI70MYH3686320,74,25,20,5,1
SBI09URF9704562,89,23,21,2,1
SBI41AUJ0417911,65,31,22,9,1
SBI91IHA1767548,89,27,24,3,1
SBI66PEP5460944,74,24,20,4,1
SBI22FXU4483394,64,29,28,1,1
SBI13FQO9326109,82,17,16,1,1
SBI00FDK9244319,72,29,23,6,1
SBI20OOT2133924,99,32,27,5,1
SBI17VFW2683983,96,21,13,8,1
SBI76DFV1854488,84,10,7,3,1
SBI95QNM7053463,86,20,18,2,1
SBI92INA7145986,18,23,13,10,1
SBI86JPF7421199,74,18,13,5,1
SBI95JLW2199215,61,21,11,10,1
SBI11LBU1939643,93,14,9,5,1
SBI04CGB3327761,73,17,12,5,1
SBI85BWV6334147,92,25,17,8,1
SBI18HQV8132147,98,21,20,1,1
SBI18MJM6749400,91,31,25,6,1
SBI75AMM9784930,90,33,22,11,1
SBI44HJB3453721,79,32,23,9,1
SBI30RFK7631854,96,21,19,2,1
SBI97MVJ9643403,62,30,24,6,1
SBI64HOZ0456955,78,33,17,16,1
SBI67WLZ6510005,88,31,17,14,1
SBI18IGG6414207,80,27,19,8,1
SBI44CYG5618541,71,28,26,2,1
SBI95IWG6440959,18,17,9,8,1
SBI28DYA1328709,19,17,11,6,1
SBI94NDH7418389,62,26,17,9,1
SBI27UJL7510321,68,19,17,2,1
SBI07URV8269412,71,21,19,2,1
SBI65ZTS1086740,81,28,18,10,1
SBI82GQP6329694,87,23,12,11,1
SBI04MQL4824810,24,34,33,1,1
SBI13AQP0161069,62,28,24,4,1
SBI38WER9901662,88,22,19,3,1
SBI73TLT8724577,60,17,13,4,1
SBI64FAP7986367,92,33,17,16,1
SBI19EBD4977815,18,24,16,8,1
SBI42YOY4587173,60,16,12,4,1
SBI65CHH4544169,80,25,21,4,1
SBI36AXW1213799,69,18,16,2,1
SBI55FFO2600978,25,23,16,7,1
SBI04AOS0023136,98,22,21,1,1
SBI78RBU6129396,18,31,29,2,1
SBI29HYV6604364,94,24,20,4,1
SBI78XBT6104628,76,23,21,2,1
SBI33ALG1148079,25,26,15,11,1
SBI98GCV0410657,22,30,21,9,1
SBI74SRK2165023,94,26,19,7,1
SBI52FJH4594984,19,22,21,1,1
SBI63FYZ0754090,66,16,11,5,1
SBI02NSC5498537,72,17,14,3,1
SBI90NBO5459003,92,31,24,7,1
SBI52NMW9389278,25,31,24,7,1
SBI98WGZ6168974,74,24,13,11,1
SBI99AES1993566,95,17,11,6,1
SBI90WME4501184,86,32,29,3,1
SBI94IJB3025434,77,21,12,9,1
SBI17YKZ8897898,99,27,23,4,1
SBI03NZY7131878,20,18,11,7,1
SBI82REW1336203,78,27,15,12,1
SBI92WTY3057101,81,31,25,6,1
SBI06UVN6965403,88,20,17,3,1
SBI75VTQ5813866,67,24,21,3,1
SBI56FBF0363435,21,35,27,8,1
SBI98JDT6927187,84,22,18,4,1
SBI63FOJ1873233,18,33,23,10,1
SBI76BPH0154837,84,33,24,9,1
SBI36LKW5903842,62,26,14,12,1
SBI02WMY6516178,67,24,16,8,1
SBI36GOF9402439,80,22,16,6,1
SBI95DEW8868537,79,22,21,1,1
SBI07FPU5321187,23,25,22,3,1
SBI41AKL2446976,25,27,24,3,1
SBI58TLQ7087457,75,20,13,7,1
SBI51HOZ5406249,76,21,12,9,1
SBI88WPF7981796,81,26,20,6,1
SBI02QRU3720808,84,21,16,5,1
SBI36TFK7593059,23,31,24,7,1
SBI34CNU5021418,90,25,18,7,1
SBI70TGT0463842,82,26,19,7,1
SBI41OPF7507181,66,27,25,2,1
SBI20RDC9757089,21,32,25,7,1
SBI77ENH5011583,92,27,17,10,1
SBI40CAZ5673162,90,39,22,17,1
SBI87ZKA1261098,78,26,14,12,1
SBI37VRV6094540,92,31,21,10,1
SBI48MGB3109750,96,32,25,7,1
SBI71POQ5736679,24,31,19,12,1
SBI72XFW0949093,63,20,19,1,1
SBI28JNE1989543,63,23,18,5,1
SBI06RWW6742724,95,24,19,5,1
SBI00YSQ4553359,86,17,10,7,1
SBI24JEW7286566,71,32,27,5,1
SBI93TRE7111366,97,26,20,6,1
SBI70JLX5960895,82,36,25,11,1
SBI11PPO1285407,77,17,16,1,1
SBI41UMV2407679,79,26,19,7,1
SBI10VPH0623356,19,32,24,8,1
SBI07BHP1372893,94,21,20,1,1
SBI80CRL7989074,19,22,13,9,1
SBI03LWP1946448,77,17,14,3,1
SBI52YWH7883629,65,21,11,10,1
SBI07IMZ3279933,70,25,17,8,1
SBI26UYO2469138,82,16,10,6,1
SBI23ZBC4870268,69,24,22,2,1
SBI23ATX5859577,64,19,13,6,1
SBI15BDS7057941,66,29,24,5,1
SBI31BHI8888352,22,27,16,11,1
SBI86TOP0862245,83,20,12,8,1
SBI25LUU7743276,77,31,18,13,1
SBI97FNH6209834,87,21,14,7,1
SBI98HZE8173925,91,25,13,12,1
SBI41WIE3408917,69,24,18,6,1
SBI34XFI6366519,79,25,19,6,1
SBI06IJC5283896,67,20,13,7,1
SBI50DNE0385882,74,28,21,7,1
SBI83WEM5282195,23,25,13,12,1
SBI52DOA8077086,94,29,22,7,1
SBI39FXE8991694,23,24,20,4,1
SBI13OWW6229852,61,24,15,9,1
SBI48XYG1499610,84,25,17,8,1
SBI82NAT4595052,23,12,11,1,1
SBI85GOC5624142,94,31,25,6,1
SBI55NWY1411978,71,16,13,3,1
SBI16HYM6037835,22,27,26,1,1
SBI70JLJ9607689,99,28,20,8,1
SBI32AOY6095109,75,19,13,6,1
SBI06NZX0305507,89,24,18,6,1
SBI71HOG6369626,68,27,23,4,1
SBI40NGK7205017,65,26,21,5,1
SBI67FSS1697382,92,22,15,7,1
SBI41BGS2009711,91,24,17,7,1
SBI14FTK1093859,64,21,12,9,1
SBI54SZJ1844943,93,25,23,2,1
SBI34WOR4865419,93,39,20,19,1
SBI29YKE0059340,20,25,19,6,1
SBI01LLH8938351,80,14,11,3,1
SBI99UQN9810592,63,31,30,1,1
SBI57EOL4491102,88,23,18,5,1
SBI19TOA5588695,86,25,15,10,1
SBI97JYJ7851379,93,22,15,7,1
SBI36TKJ6319452,81,12,9,3,1
SBI85CBP3081773,79,27,22,5,1
SBI08WUD9469149,96,24,17,7,1
SBI36RHR8406757,63,25,20,5,1
SBI75QYL5649944,80,18,13,5,1
SBI91FPO2179334,21,24,22,2,1
SBI34DFJ8597087,73,23,18,5,1
SBI60BEK9342175,65,20,17,3,1
SBI13GQZ6251484,60,19,17,2,1
SBI08AJU5255953,66,26,22,4,1
SBI79KCL6280346,63,26,20,6,1
SBI78NTO7172816,69,29,17,12,1
SBI22NIY9944913,79,28,25,3,1
SBI25NYW0570321,23,22,14,8,1
SBI44UQM2085751,93,18,17,1,1
SBI06SJD0208300,81,25,21,4,1
SBI43HAO7463589,77,23,14,9,1
SBI54FMP9407942,88,13,11,2,1
SBI71TSV3479518,91,18,16,2,1
SBI97KBC2750703,77,23,22,1,1
SBI41XCS2781692,60,25,17,8,1
SBI60MIA6945919,87,18,12,6,1
SBI34RLJ6699436,94,20,18,2,1
SBI70BZM4195937,90,24,14,10,1
SBI89AIE7087541,77,28,18,10,1
SBI92JMZ5235969,67,26,18,8,1
SBI69JQP3567517,73,21,13,8,1
SBI99YBO4878126,80,19,13,6,1
SBI63RAD8610146,85,15,11,4,1
SBI86KMB0283184,76,19,13,6,1
SBI22VQG0477770,93,25,15,10,1
SBI06KZI2286140,67,20,19,1,1
SBI39KFD1589202,83,31,28,3,1
SBI15WFP8065273,80,25,18,7,1
SBI84RYK0569570,22,26,17,9,1
SBI89BUS5894092,24,20,19,1,1
SBI26YNX0194043,77,25,18,7,1
SBI51HJT1966966,62,29,23,6,1
SBI34XZZ6233139,63,22,15,7,1
SBI25PEZ5715999,18,22,12,10,1
SBI46WCS0543647,90,23,20,3,1
SBI58QDJ9700541,24,28,18,10,1
SBI63PVU8626504,62,35,28,7,1
SBI71RQH6064045,85,26,23,3,1
SBI39NPI7030792,25,20,12,8,1
SBI10UFX8504971,99,21,11,10,1
SBI82GIG5208608,90,23,14,9,1
SBI34PIB2047407,82,22,16,6,1
SBI10UES7373995,98,27,19,8,1
SBI41YEI5300738,20,26,15,11,1
SBI34YRH0983068,21,23,16,7,1
SBI94BIG9577105,94,23,20,3,1
SBI37NCU1775300,21,15,11,4,1
SBI46TEA1693687,90,25,17,8,1
SBI03SPW8244825,83,30,24,6,1
SBI41IKK2903249,88,19,17,2,1
SBI26FUY1872786,18,21,17,4,1
SBI27DGV2423772,24,28,26,2,1
SBI92UWW7358082,66,18,15,3,1
SBI24RLZ3714661,76,32,21,11,1
SBI43EQN3564523,66,28,20,8,1
SBI80BDK6620078,79,23,17,6,1
SBI07QPY8868311,93,27,26,1,1
SBI49FRJ9635317,19,26,18,8,1
SBI70FAQ1810690,94,21,11,10,1
SBI19GNO9967990,19,30,28,2,1
SBI82YWL1402038,68,23,17,6,1
SBI27VRN2848649,90,22,16,6,1
SBI07NKE4247837,84,29,22,7,1
SBI95UVW4583713,89,21,19,2,1
SBI78AWV8556955,74,24,19,5,1
SBI56XLR0570331,98,28,16,12,1
SBI81IKF3071717,18,20,14,6,1
SBI75YOT5991432,75,31,19,12,1
SBI35OCN2895926,71,19,16,3,1
SBI70TTR5169151,23,25,20,5,1
SBI23YWK4853763,96,31,28,3,1
SBI55IRS4008182,18,23,13,10,1
SBI75QQN4950588,74,27,20,7,1
SBI44GDM8996484,80,31,26,5,1
SBI03JRO1638283,93,22,13,9,1
SBI63ZKY1369899,97,27,23,4,1
SBI53MEY1265818,23,20,17,3,1
SBI45VAH3833143,25,29,15,14,1
SBI08PXA2956061,93,24,20,4,1
SBI27LBO5414426,78,12,9,3,1
SBI61SBX0367822,99,31,19,12,1
SBI39XEN2749436,85,21,17,4,1
SBI09IHV0872651,84,23,12,11,1
SBI94LKV5006124,75,21,20,1,1
SBI39SWN3137643,67,28,18,10,1
SBI50MKF0559276,88,25,13,12,1
SBI06HVZ4779068,88,33,24,9,1
SBI17WSM4519253,62,12,9,3,1
SBI80BSX0543321,23,22,19,3,1
SBI89FHY4845902,24,23,14,9,1
SBI59MAQ4626859,20,29,19,10,1
SBI47KNU1452938,21,25,13,12,1
SBI76FYO0801078,83,26,18,8,1
SBI36WXY4796088,64,25,17,8,1
SBI28YUZ3489554,69,25,24,1,1
SBI29CON6169780,72,19,15,4,1
SBI06HTY3770756,63,21,13,8,1
SBI55RSE1894531,91,22,20,2,1
SBI71OJM2335927,80,27,23,4,1
SBI76OYM3908613,89,19,15,4,1
SBI89VKQ0743595,72,32,25,7,1
SBI42IJL2825833,99,31,21,10,1
SBI16QYB8840807,99,28,19,9,1
SBI82HWY2818322,91,39,22,17,1
SBI64PMP0750982,67,22,18,4,1
SBI49XZW1690537,64,23,13,10,1
SBI92GSI4515566,95,24,23,1,1
SBI72WZD3234958,21,27,22,5,1
SBI29EWI0393618,81,27,15,12,1
SBI89XPP5924003,19,23,14,9,1
SBI00XKS8067142,91,26,20,6,1
SBI87LDZ0675463,60,29,28,1,1
SBI50TPI4389582,67,22,13,9,1
SBI10UOC2459392,62,18,12,6,1
SBI00YQV9353665,93,31,29,2,1
SBI39NRA6297009,82,36,21,15,1
SBI30ZPZ3560036,70,21,19,2,1
SBI01ODR6222779,79,30,27,3,1
SBI46UKA2007945,85,28,19,9,1
SBI23IJE8021812,67,26,20,6,1
SBI05JLF8499467,61,35,24,11,1
SBI35URN1736379,83,24,13,11,1
SBI68EJO9132817,23,18,17,1,1
SBI18DEH0446299,83,24,19,5,1
SBI65RGZ1853331,70,34,28,6,1
SBI28HOZ5744392,83,22,21,1,1
SBI81YLH6890427,62,28,18,10,1
SBI68MFD9651025,69,27,22,5,1
SBI11UBH4746149,73,26,15,11,1
SBI77MCS1302129,65,21,19,2,1
SBI76CGW1522014,69,29,16,13,1
SBI27CNE6767127,69,28,19,9,1
SBI96YKA5232699,94,10,8,2,1
SBI47FKG2722000,65,19,18,1,1
SBI10NGG5143907,83,26,14,12,1
SBI33BMR0979855,92,29,25,4,1
SBI23LKX9791879,73,21,18,3,1
SBI18HEC6805178,82,23,14,9,1
SBI68ROG1324714,85,24,13,11,1
SBI01NHJ8353328,86,18,17,1,1
SBI62JWS0409662,18,23,16,7,1
SBI79LLO5822694,18,27,20,7,1
SBI22ZHJ8710893,73,33,31,2,1
SBI82ASL3009685,67,28,16,12,1
SBI08LOE4025439,87,28,17,11,1
SBI90GTY1553303,21,24,22,2,1
SBI58VQT1643431,81,23,16,7,1
SBI44SAA0138272,85,15,8,7,1
SBI57AEH0451247,71,30,18,12,1
SBI32WZD4726965,75,24,16,8,1
SBI76ACY0001767,94,19,15,4,1
SBI22WJD8520033,83,27,24,3,1
SBI69TKX7785822,62,23,18,5,1
SBI86RRF6003652,81,21,12,9,1
SBI22TTX9496699,61,25,16,9,1
SBI61PNB6665858,82,26,22,4,1
SBI81DLY2619825,96,22,16,6,1
SBI97TWE2278936,91,23,12,11,1
SBI95TAI0430010,74,26,17,9,1
SBI14BCJ8747999,94,15,12,3,1
SBI96TBX1432488,25,25,19,6,1
SBI19BYQ8543156,71,24,14,10,1
SBI03JNX4038180,18,22,14,8,1
SBI66VSC5632542,82,23,17,6,1
SBI90FWM2031825,74,23,20,3,1
SBI62REA6446882,92,28,20,8,1
SBI95ISU9574490,92,26,14,12,1
SBI21FTV5529601,88,19,11,8,1
SBI60JIN4341903,22,19,10,9,1
SBI20VZI1180733,64,18,11,7,1
SBI52REI6026092,65,18,16,2,1
SBI19OWZ6426132,21,22,19,3,1
SBI35XER6266428,65,26,16,10,1
SBI59JNP2303460,73,27,23,4,1
SBI63WNL3156355,62,30,29,1,1
SBI45VRU5404132,69,23,16,7,1
SBI44FBQ0330790,18,37,29,8,1
SBI41DXI3450104,24,21,12,9,1
SBI16INS7444982,70,22,18,4,1
SBI04HCA8374773,98,33,29,4,1
SBI22JSA8605610,78,21,18,3,1
SBI91DEH8139025,72,25,19,6,1
SBI59GBT6954929,23,26,25,1,1
SBI94RHN3511094,96,24,19,5,1
SBI23ZAY4946337,96,32,31,1,1
SBI92YKR9733494,64,26,25,1,1
SBI40UCX9010777,72,22,15,7,1
SBI40RDH9862023,76,30,25,5,1
SBI56ZEM1646760,20,26,22,4,1
SBI15CJR0349909,64,18,11,7,1
SBI04KFS8155230,81,24,22,2,1
SBI36YWQ9805045,63,29,16,13,1
SBI51YCX9789815,22,34,31,3,1
SBI72FVI5914355,71,29,23,6,1
SBI32YXC9884357,66,23,15,8,1
SBI82JSS1841515,99,20,19,1,1
SBI72XYH4433604,18,20,14,6,1
SBI75RIM6589330,91,27,14,13,1
SBI34XCA8479955,96,19,14,5,1
SBI76YFF0971003,90,18,14,4,1
SBI44RVU0915602,70,24,21,3,1
SBI26OMV7888584,98,27,14,13,1
SBI58QII5990843,82,22,16,6,1
SBI92SXJ8082246,63,34,28,6,1
SBI13JPY2428102,22,25,24,1,1
SBI31EZX1127458,21,22,16,6,1
SBI00SOZ5498292,80,17,15,2,1
SBI27VMJ2143507,20,17,9,8,1
SBI28JTS7490712,63,22,13,9,1
SBI79HGH4104289,61,21,16,5,1
SBI87FTJ0473309,62,11,8,3,1
SBI67HYL8627375,19,28,21,7,1
SBI54JCF1916906,61,22,13,9,1
SBI45TYW3817832,76,27,20,7,1
SBI11NBR0973032,73,32,21,11,1
SBI91SCQ7841326,19,30,23,7,1
SBI91TDF4656160,71,18,13,5,1
SBI04WMS0780765,87,24,23,1,1
SBI82OSW7207439,75,21,20,1,1
SBI29IZF6464069,22,23,21,2,1
SBI76YKB7692582,64,21,18,3,1
SBI91WJI6614888,65,18,15,3,1
SBI57VNJ8016613,96,21,14,7,1
SBI56JMF3422141,66,18,17,1,1
SBI41SYD7955006,90,28,16,12,1
SBI20VCI1970412,70,25,15,10,1
SBI39GST4566584,82,25,19,6,1
SBI81XXA1733710,85,31,28,3,1
SBI38AFP9353062,80,20,11,9,1
SBI64NRD0375104,74,18,16,2,1
SBI03CLW2492321,77,23,17,6,1
SBI15NRN7854638,86,26,22,4,1
SBI48PPJ0928562,18,20,16,4,1
SBI90SEF6353156,77,15,13,2,1
SBI93GJN7416526,67,21,17,4,1
SBI60FBN1959020,94,16,15,1,1
SBI57IZQ4914637,85,23,17,6,1
SBI16NRU5814668,70,26,22,4,1
SBI03OTC2263939,78,30,22,8,1
SBI03WTE5710858,86,24,22,2,1
SBI05MGZ3041727,71,23,21,2,1
SBI31ZET7069197,20,30,16,14,1
SBI24BDL1540296,75,33,24,9,1
SBI84CXJ1602663,82,26,18,8,1
SBI83SPB0584092,92,27,17,10,1
SBI10DLK2389529,89,26,19,7,1
SBI62SMI5225235,72,19,10,9,1
SBI60WAG3395259,97,19,17,2,1
SBI73BCR6289581,97,19,14,5,1
SBI76FPO0883471,97,16,14,2,1
SBI02RFZ2096082,64,25,23,2,1
SBI51TFO0140672,85,29,15,14,1
SBI73PHU0778371,87,29,20,9,1
SBI90ZDF3723920,62,22,20,2,1
SBI28PGE5113514,82,28,23,5,1
SBI16SSV4417717,86,23,18,5,1
SBI91YDT3900963,23,33,21,12,1
SBI28VCK1099111,68,26,23,3,1
SBI67UTS2338931,87,31,24,7,1
SBI06BYC0736729,66,23,18,5,1
SBI00WGA6959580,23,27,20,7,1
SBI52EBA2724680,99,26,19,7,1
SBI07UAG2058715,71,25,13,12,1
SBI56OVX0104756,61,22,12,10,1
SBI55EPL2123688,20,18,13,5,1
SBI58GOC8035953,88,29,22,7,1
SBI28MIW2437977,85,33,20,13,1
SBI27JBY6951231,87,21,15,6,1
SBI06GQJ0737140,78,19,14,5,1
SBI87ZUD6239697,24,20,11,9,1
SBI99KXD8539903,62,25,17,8,1
SBI85BRN4431597,62,20,19,1,1
SBI83LDK5511811,23,27,18,9,1
SBI03MKG8574538,67,16,13,3,1
SBI58JPL2826878,60,29,17,12,1
SBI66RSP7564022,98,35,20,15,1
SBI33CVX3950090,23,18,15,3,1
SBI41ONJ6814189,89,32,29,3,1
SBI45GMU7753402,84,28,19,9,1
SBI02DLX0663151,18,28,21,7,1
SBI44SAT5819817,61,17,12,5,1
SBI00OAV9495021,94,21,20,1,1
SBI86FUX9996543,81,23,18,5,1
SBI57ESJ0202198,21,29,28,1,1
SBI39LWC6060754,84,27,23,4,1
SBI60TKD1231303,97,24,21,3,1
SBI36HKH4436959,71,28,17,11,1
SBI72VLJ3125388,62,20,12,8,1
SBI51AAG0070203,19,24,15,9,1
SBI14DZY7719122,84,15,8,7,1
SBI08VEL6707905,77,29,25,4,1
SBI44VQV7083437,62,19,15,4,1
SBI98PZS0207239,64,16,13,3,1
SBI00EJK1309138,67,31,23,8,1
SBI10QQV3149495,90,31,19,12,1
SBI02BTO7934568,92,24,17,7,1
SBI42HYQ0215398,63,22,15,7,1
SBI63GFH2447586,82,27,15,12,1
SBI30TSM4048959,79,20,17,3,1
SBI81RRO0115367,93,32,29,3,1
SBI07ETS3700356,85,31,19,12,1
SBI62TTC7557358,60,26,17,9,1
SBI26ZVQ2830424,90,33,27,6,1
SBI75FPT9862118,78,24,22,2,1
SBI89AEA9897252,84,31,25,6,1
SBI46AMR7219370,71,20,16,4,1
SBI68SRI1142534,75,32,22,10,1
SBI60AQV0813933,95,18,16,2,1
SBI15FYM3358792,63,25,19,6,1
SBI29KZV7993686,65,30,24,6,1
SBI29GWC9467158,63,26,16,10,1
SBI62RED3403183,94,16,13,3,1
SBI05VYB4121256,94,24,17,7,1
SBI60ZGV5773705,91,25,19,6,1
SBI83BCI5300229,95,24,13,11,1
SBI49CTY5814212,92,26,25,1,1
SBI82BCM2793238,70,27,21,6,1
SBI82MNY6281938,92,17,9,8,1
SBI17ATD7693192,82,12,10,2,1
SBI20CAD6770807,67,34,32,2,1
SBI10MUI1765556,75,28,23,5,1
SBI86WJI0037421,96,23,14,9,1
SBI73BFR3748866,91,28,23,5,1
SBI28LJZ9570885,21,30,22,8,1
SBI16QEM6939643,85,21,11,10,1
SBI71EYS0910112,96,29,18,11,1
SBI67ITE7768743,74,24,19,5,1
SBI30UOC9261336,93,32,22,10,1
SBI46FLA3384823,79,26,18,8,1
SBI59CPJ6971859,84,32,23,9,1
SBI56WXR6354794,72,31,24,7,1
SBI33ZLL8834304,88,27,22,5,1
SBI55HBI9591651,80,23,22,1,1
SBI29CSC3173399,70,27,16,11,1
SBI74BTB5021016,90,27,18,9,1
SBI86JIS6219896,21,25,24,1,1
SBI09ZVT9341916,92,26,22,4,1
SBI97UAI9199281,25,26,14,12,1
SBI26PQA9684114,68,20,13,7,1
SBI06XTJ4099450,23,26,15,11,1
SBI34OIQ3189710,21,27,21,6,1
SBI86VZP9159179,79,21,18,3,1
SBI18CEP2394883,73,22,19,3,1
SBI47THT9441117,80,22,13,9,1
SBI68FPZ8783789,78,29,16,13,1
SBI44XDM1446872,25,33,27,6,1
SBI97LDT6322895,77,20,17,3,1
SBI50COX4785577,23,25,15,10,1
SBI39MYH3738473,25,24,14,10,1
SBI32HXN1014861,72,25,21,4,1
SBI42YWX3489638,25,28,17,11,1
SBI08NYB5498094,99,30,26,4,1
SBI71XWA0515860,84,27,26,1,1
SBI49QBL6945403,71,26,16,10,1
SBI84ZWN5865040,72,22,15,7,1
SBI05AYD3558128,85,19,16,3,1
SBI28IIL3458259,95,21,15,6,1
SBI80WAS3406392,97,20,13,7,1
SBI55JGT7973261,73,21,17,4,1
SBI71PMZ7768339,20,20,15,5,1
SBI16BZD6786658,68,29,22,7,1
SBI70AQO6043686,60,23,16,7,1
SBI23ACP0083204,73,18,12,6,1
SBI89FOR0882967,97,14,10,4,1
SBI08QAO9754567,93,37,19,18,1
SBI88CWH2953093,86,30,18,12,1
SBI72IWQ6826483,94,25,13,12,1
SBI91ZJM2153811,20,26,17,9,1
SBI00MCL2923352,65,20,16,4,1
SBI04DLO3147261,64,24,23,1,1
SBI08VIM0006347,18,18,15,3,1
SBI11YAD9146124,64,26,16,10,1
SBI46TWF2255067,62,29,19,10,1
SBI59ZAE0451625,70,23,12,11,1
SBI94PCL0670247,96,22,15,7,1
SBI60WOB8577303,23,23,15,8,1
SBI72ZSX8003390,83,32,22,10,1
SBI30DPA8595097,75,24,19,5,1
SBI00OSS3793027,18,23,22,1,1
SBI08DBW6137933,76,23,18,5,1
SBI26UQU9070217,23,24,18,6,1
SBI80OXF3801240,19,14,10,4,1
SBI89BLX3281496,72,24,14,10,1
SBI10YTR3069610,64,38,29,9,1
SBI63ZEL2917977,19,28,25,3,1
SBI33JEM6749959,87,17,9,8,1
SBI56HMJ2907983,70,27,16,11,1
SBI43DAC6796883,22,21,18,3,1
SBI92UAW2611724,87,30,20,10,1
SBI14NSN2698010,90,23,21,2,1
SBI69ASY5756248,73,26,15,11,1
SBI10NOB0415969,84,27,15,12,1
SBI76UII5276006,80,24,23,1,1
SBI12YHZ2306875,80,27,18,9,1
SBI62DXW4868793,70,35,34,1,1
SBI42TFU3658375,80,27,24,3,1
SBI97ULH4989631,61,27,23,4,1
SBI04XRY8356171,82,19,17,2,1
SBI08SYY6806511,87,23,19,4,1
SBI53WNI8860445,98,27,23,4,1
SBI67EOI6876818,90,26,20,6,1
SBI27ORA4822231,78,13,11,2,1
SBI11JQP9167066,99,24,18,6,1
SBI72LTQ2576232,78,27,18,9,1
SBI32NQH6084738,74,28,22,6,1
SBI02FZI7894475,72,27,24,3,1
SBI97QBK9554736,83,27,17,10,1
SBI62NWC3250089,79,22,20,2,1
SBI54HGM3969689,21,24,19,5,1
SBI73AZI1839135,76,18,14,4,1
SBI90FCK4906955,99,24,19,5,1
SBI09QWK4114605,93,24,23,1,1
SBI23NPV1490985,20,28,27,1,1
SBI03GCY1549130,77,26,23,3,1
SBI05AUL4464852,94,17,16,1,1
SBI47KQQ0767792,84,27,23,4,1
SBI67LNA6849249,21,30,18,12,1
SBI78VAL5956391,74,27,14,13,1
SBI55ZGJ6620598,60,25,18,7,1
SBI06LTS1751298,98,31,16,15,1
SBI91DRI9241221,67,34,28,6,1
SBI74ZXS7055509,90,20,16,4,1
SBI38PZU6202796,63,20,17,3,1
SBI80GDF7226179,99,35,31,4,1
SBI88BQR4313394,82,22,14,8,1
SBI80DXT4307578,65,25,21,4,1
SBI57FWI0123509,62,23,20,3,1
SBI85WEL4336828,68,23,22,1,1
SBI81UHS8063110,75,20,15,5,1
SBI69RXV9247820,67,23,21,2,1
SBI89TII3962926,69,35,24,11,1
SBI41CCI7499430,91,23,14,9,1
SBI29OLV5877856,71,30,29,1,1
SBI22YXK5550537,61,21,11,10,1
SBI14FHH2049444,64,25,13,12,1
SBI29YQW6322905,96,28,17,11,1
SBI03WVR0353090,70,37,36,1,1
SBI22FFC7380787,96,23,19,4,1
SBI96PJW9735807,74,23,16,7,1
SBI85YBB1900058,80,23,19,4,1
SBI87HOJ4586413,74,21,14,7,1
SBI92IJL2157186,69,27,19,8,1
SBI43CUF4894129,80,28,20,8,1
SBI70QUW4764386,77,19,10,9,1
SBI75XEH9649137,80,27,15,12,1
SBI16BQE0818203,24,21,17,4,1
SBI09XPW2035482,98,24,14,10,1
SBI40MMU7329302,66,30,17,13,1
SBI80KYC7328323,85,19,18,1,1
SBI63MIF1735821,60,30,20,10,1
SBI79ZCT0077238,61,14,13,1,1
SBI58QMU2462680,64,19,14,5,1
SBI42PYW8231635,97,30,18,12,1
SBI16MGV8516663,71,25,20,5,1
SBI31JDH8807348,24,24,22,2,1
SBI74JQY7115602,63,24,22,2,1
SBI10UUD2850823,62,22,21,1,1
SBI95NQB8474282,78,21,14,7,1
SBI46QBF8815510,88,18,14,4,1
SBI18YZI8487550,62,24,19,5,1
SBI85NHG3085698,18,33,22,11,1
SBI16WYV8675075,81,16,15,1,1
SBI66XIR5626647,86,18,17,1,1
SBI16SHZ2109397,19,26,25,1,1
SBI77TOE3778205,23,28,26,2,1
SBI87GPP1173445,75,31,19,12,1
SBI85RDK0920695,64,26,21,5,1
SBI14GPK1021370,60,29,20,9,1
SBI68BKZ4405830,78,28,22,6,1
SBI59ORW5683952,91,29,19,10,1
SBI02LYQ7853082,87,32,24,8,1
SBI28XJQ5422552,75,21,20,1,1
SBI31LIO6975935,76,20,13,7,1
SBI94LZD2406370,99,25,15,10,1
SBI45ARE8562203,23,26,18,8,1
SBI08MIE0126092,23,25,22,3,1
SBI85VSV1684575,95,19,12,7,1
SBI93HLK1496883,83,21,18,3,1
SBI92QYA0369057,85,13,10,3,1
SBI53VVE1277171,79,28,16,12,1
SBI90BFT8980752,70,24,17,7,1
SBI74KSH0905411,74,24,15,9,1
SBI22EZR8049414,71,25,19,6,1
SBI61JQD4944087,95,31,24,7,1
SBI30FEU6043619,81,26,19,7,1
SBI90SQY5882025,74,24,21,3,1
SBI47CCB3524964,72,25,13,12,1
SBI62HDR5417406,91,29,16,13,1
SBI72VOE3356564,94,25,23,2,1
SBI05JQL4055004,76,25,17,8,1
SBI44PJG7261494,89,22,17,5,1
SBI37HBL9674609,67,27,22,5,1
SBI74TMS9496978,21,22,13,9,1
SBI44KQM2791614,65,21,17,4,1
SBI38HNE7086816,98,21,14,7,1
SBI97CIM0149265,78,28,18,10,1
SBI83KTN8810879,77,26,15,11,1
SBI91HJE5978824,68,26,21,5,1
SBI26ACN0395508,86,24,13,11,1
SBI16ONK8173690,88,22,14,8,1
SBI05PRR4541199,90,24,19,5,1
SBI63SHF6885246,61,27,23,4,1
SBI54QNN8009190,20,16,9,7,1
SBI45BAK4574423,88,26,21,5,1
SBI88GDM9390224,79,17,14,3,1
SBI14OXI2320135,91,25,21,4,1
SBI70IKU8505544,78,21,11,10,1
SBI34VXF9968389,90,23,12,11,1
SBI57TDT9110270,99,27,15,12,1
SBI67REV4104821,95,24,23,1,1
SBI35RLX3054140,93,27,21,6,1
SBI78NWF0878557,98,32,29,3,1
SBI52HQF3346532,76,25,14,11,1
SBI71THX8907247,77,34,19,15,1
SBI67BPP7962795,74,19,14,5,1
SBI71OQE2645231,82,19,15,4,1
SBI71UJP9282700,79,27,21,6,1
SBI91IMS5038056,64,29,18,11,1
SBI69COD1496229,76,23,12,11,1
SBI32FCX3607891,73,26,24,2,1
SBI10ICM7496708,95,23,21,2,1
SBI14RNX4103538,88,21,15,6,1
SBI89CWY8238731,61,21,13,8,1
SBI53PUO5500925,70,33,19,14,1
SBI67XEN4145142,98,31,20,11,1
SBI53ZGF1210556,65,24,23,1,1
SBI52QLH0785438,61,26,18,8,1
SBI70YTB9490428,24,17,15,2,1
SBI53IBB8858766,83,24,21,3,1
SBI45ESD5846471,60,27,26,1,1
SBI12SCJ9950828,95,21,14,7,1
SBI73LXN7760781,23,22,17,5,1
SBI87JMY3806389,68,31,22,9,1
SBI80KRE5100639,68,14,10,4,1
SBI31NCU2540076,88,27,22,5,1
SBI42QWW5926741,92,22,13,9,1
SBI03TZR4298626,19,19,12,7,1
SBI13UKF1333252,70,17,10,7,1
SBI68ZHR6327145,66,24,21,3,1
SBI37DDP5374306,78,26,24,2,1
SBI41ANT5785274,62,25,22,3,1
SBI16ARC9975496,63,29,28,1,1
SBI53QSG3958456,84,32,21,11,1
SBI31PDO9700806,84,15,12,3,1
SBI47CRN8147052,85,22,17,5,1
SBI50AUU6909303,20,23,14,9,1
SBI95XWZ9113927,63,25,14,11,1
SBI84UZL9405017,60,26,20,6,1
SBI05PBO7798789,66,32,20,12,1
SBI14CRT7947427,83,21,19,2,1
SBI24WZO6385898,96,26,15,11,1
SBI42WHW3509386,68,23,21,2,1
SBI92TAC7746063,24,24,19,5,1
SBI92DDK0728235,67,19,18,1,1
SBI84LZZ4949608,94,26,14,12,1
SBI65UQU0777119,78,26,16,10,1
SBI50FAS6244583,93,19,16,3,1
SBI64FQR4493809,90,30,29,1,1
SBI70NGN7802999,93,22,16,6,1
SBI83QCX5726593,66,26,16,10,1
SBI86OWI5654840,63,18,10,8,1
SBI27EHY5751424,75,25,17,8,1
SBI13AHH3002063,66,19,14,5,1
SBI79SDA2967412,81,32,18,14,1
SBI50LOR1964647,83,25,13,12,1
SBI59QIC8617439,81,27,17,10,1
SBI62BAK4039630,91,27,24,3,1
SBI51OCU6794733,76,29,24,5,1
SBI94ZZW1146430,24,24,21,3,1
SBI33XVR3078068,78,21,11,10,1
SBI43EIL7831198,22,28,25,3,1
SBI83FII0939897,93,31,16,15,1
SBI17QYA4149008,85,19,16,3,1
SBI06RKC1735119,84,25,13,12,1
SBI79PGN7198869,99,19,10,9,1
SBI98MZG6058275,80,33,23,10,1
SBI16JFM5289702,93,14,13,1,1
SBI69JSN3756902,63,35,23,12,1
SBI77ZGR5675402,65,30,16,14,1
SBI87WZD3389899,82,31,30,1,1
SBI01NNY3622452,60,18,14,4,1
SBI60OTQ2907615,67,23,14,9,1
SBI37BYZ4305934,95,30,23,7,1
SBI90EHY0140392,90,11,6,5,1
SBI67VPJ2491819,71,21,17,4,1
SBI10BFO6720387,60,21,15,6,1
SBI44EXN5071650,81,23,12,11,1
SBI85UFE1218055,92,38,21,17,1
SBI11IOY5607004,63,28,25,3,1
SBI95BDC9274240,62,26,21,5,1
SBI96FGO5597372,74,22,18,4,1
SBI18GNZ1708924,82,26,22,4,1
SBI93BVK8968543,72,28,27,1,1
SBI53CWC4438819,80,26,22,4,1
SBI29DTA0415614,73,25,13,12,1
SBI17MIJ0142074,75,21,18,3,1
SBI38YCL6773945,91,31,18,13,1
SBI26ZRV1523733,70,20,17,3,1
SBI33CSK8209860,21,19,16,3,1
SBI75LNJ2016445,61,32,18,14,1
SBI84QCV8707129,91,20,18,2,1
SBI90AFO7308615,66,25,14,11,1
SBI12ZHJ6986003,87,28,27,1,1
SBI03AXH1993083,23,20,11,9,1
SBI92MIV2186347,68,29,28,1,1
SBI01FXG6847118,24,25,23,2,1
SBI32FTW3915625,72,17,13,4,1
SBI89GLH5833002,64,25,13,12,1
SBI68ZJJ0449497,24,21,16,5,1
SBI78OIZ3488013,71,18,11,7,1
SBI35NYO4368587,79,31,18,13,1
SBI66EQB0816626,64,26,23,3,1
SBI75YQW3449682,19,22,13,9,1
SBI04CEJ1115301,77,19,18,1,1
SBI11SWU0077192,85,22,18,4,1
SBI13PFA7483758,63,23,17,6,1
SBI57VYW5817621,89,17,10,7,1
SBI20CXQ3739684,93,25,17,8,1
SBI70PIQ5973357,89,21,11,10,1
SBI85COA2643879,20,34,24,10,1
SBI67KEI2384722,91,29,28,1,1
SBI30GTF2645415,61,26,23,3,1
SBI46CEJ9216892,93,31,28,3,1
SBI65OVY6644237,99,27,21,6,1
SBI47ROY4451663,24,27,15,12,1
SBI66OEW2474511,79,20,15,5,1
SBI44VET7684340,91,29,16,13,1
SBI84XIN8449209,99,24,23,1,1
SBI54DUX1530113,24,24,17,7,1
SBI13BTP3319309,83,32,22,10,1
SBI67RQV4335716,93,22,17,5,1
SBI49ZUD9016746,83,23,16,7,1
SBI60IRE5504593,78,14,11,3,1
SBI67HZR5846750,65,17,10,7,1
SBI57HQO2152217,75,26,24,2,1
SBI13CWH7765931,80,30,16,14,1
SBI21FFM3270282,74,21,17,4,1
SBI33PND9531960,79,33,24,9,1
SBI59GBI9273501,96,28,19,9,1
SBI32ZWY2809147,61,22,12,10,1
SBI62LFF5737842,96,29,25,4,1
SBI41IFQ2204935,67,35,29,6,1
SBI00QGJ5753809,85,31,29,2,1
SBI29NNW5383969,65,22,17,5,1
SBI62LRB6423254,93,23,14,9,1
SBI00CPL9343937,93,26,25,1,1
SBI89WNX0697799,90,34,32,2,1
SBI66HSQ9576236,22,15,8,7,1
SBI80TIC3765801,71,22,13,9,1
SBI50EFY3448929,77,22,21,1,1
SBI89JAE3106484,87,15,14,1,1
SBI62NSG2521206,71,19,14,5,1
SBI48LHN0680113,75,28,21,7,1
SBI85MSD2607193,83,27,21,6,1
SBI45OJL3789390,63,35,33,2,1
SBI39YGQ4961611,78,17,15,2,1
SBI87FUT7566130,73,27,20,7,1
SBI58PMW5104802,73,26,19,7,1
SBI99MTK5798594,66,30,27,3,1
SBI15SBW4084207,75,22,13,9,1
SBI75NWF1872983,89,22,16,6,1
SBI10FYP5645945,91,26,22,4,1
SBI52ZIN0393201,99,23,22,1,1
SBI42RXM0366825,71,25,16,9,1
SBI30BWX3240375,84,30,26,4,1
SBI26SZW7015149,75,25,18,7,1
SBI56UVQ5598526,20,20,12,8,1
SBI41AQZ5055773,76,34,29,5,1
SBI91ZCJ9824737,61,26,16,10,1
SBI29SRO1431623,75,25,21,4,1
SBI74PDQ5725352,95,12,7,5,1
SBI98ISW1702905,61,18,17,1,1
SBI49AUV4225666,72,27,19,8,1
SBI07URR9579957,77,31,18,13,1
SBI21JHW8665031,96,17,11,6,1
SBI98VWZ1750357,18,20,14,6,1
SBI71KLZ5498295,61,23,17,6,1
SBI47IBW4568073,95,25,17,8,1
SBI81BCB3419764,95,22,15,7,1
SBI11DGJ6923708,69,30,25,5,1
SBI49XFY0712500,83,21,20,1,1
SBI80SZE1881631,67,17,10,7,1
SBI55GCB6916245,86,22,16,6,1
SBI93OXD4251379,66,25,14,11,1
SBI08GSF1137005,74,20,15,5,1
SBI48PVA5711138,96,25,20,5,1
SBI10WZB0543059,78,22,17,5,1
SBI01PNV6297905,93,27,23,4,1
SBI50QJK6735401,80,17,15,2,1
SBI28ZNW1506688,87,32,17,15,1
SBI66OOU9509819,86,26,22,4,1
SBI11DOU5366918,72,21,18,3,1
SBI64ZVT4388119,25,24,14,10,1
SBI87SNS9092103,85,16,14,2,1
SBI02HLM5070677,82,31,24,7,1
SBI50GRJ4165331,79,23,14,9,1
SBI72RLT7161067,75,20,17,3,1
SBI58NQC1745360,84,16,14,2,1
SBI08WUJ8013811,82,26,18,8,1
SBI78KSY3444245,72,23,19,4,1
SBI15FTC4380309,92,12,11,1,1
SBI25MQB5905659,65,28,16,12,1
SBI76AGU0620524,79,24,22,2,1
SBI86FQN8187041,86,25,24,1,1
SBI75EBH9410592,24,18,13,5,1
SBI93CRP7108093,88,30,27,3,1
SBI92EEW0701083,63,21,12,9,1
SBI27TFC1145958,21,33,29,4,1
SBI32UMN8225282,99,38,22,16,1
SBI98MJF2368259,61,18,14,4,1
SBI16OPO8479559,86,24,14,10,1
SBI23NAZ3579611,98,22,18,4,1
SBI87DKT0769081,98,23,16,7,1
SBI31EQC8459717,90,22,20,2,1
SBI95WUB9501624,71,13,7,6,1
SBI49GVP1206924,84,23,13,10,1
SBI77FCA0671285,72,32,17,15,1
SBI46LZU3877001,91,17,12,5,1
SBI17TUK7910420,74,27,14,13,1
SBI36QAL4052632,66,28,20,8,1
SBI22FHU7494439,22,17,11,6,1
SBI15MPT8290977,94,31,22,9,1
SBI66TWU7037449,19,23,19,4,1
SBI52JTE2222033,85,30,22,8,1
SBI58KEB3028580,69,30,16,14,1
SBI15LLS6413491,69,24,19,5,1
SBI91JQC7818151,80,25,20,5,1
SBI60GFW5207085,89,19,10,9,1
SBI65UTC1035599,72,20,16,4,1
SBI01GTX4307811,71,27,18,9,1
SBI04VNR6685293,94,29,23,6,1
SBI66RDZ4945383,97,19,18,1,1
SBI95OAP8136220,75,21,17,4,1
SBI89PDD7317848,66,17,10,7,1
SBI76XTP8276875,67,20,18,2,1
SBI80EJH7899577,24,30,27,3,1
SBI99UUZ8018682,93,14,10,4,1
SBI59YOS0039615,92,36,35,1,1
SBI61MOV2460484,77,24,20,4,1
SBI48PQH0460167,68,21,17,4,1
SBI80CCQ3638639,96,30,28,2,1
SBI90YWX4564939,72,27,26,1,1
SBI20ZFD7272161,77,25,22,3,1
SBI07PGV3734048,71,19,14,5,1
SBI19AKC5730252,83,18,14,4,1
SBI93SOB8552058,94,23,13,10,1
SBI75ZQP6759691,93,27,19,8,1
SBI15MGO2736020,92,17,12,5,1
SBI34SVZ2571659,75,25,15,10,1
SBI67HOJ8589864,21,23,15,8,1
SBI85GFK0142066,82,26,22,4,1
SBI42FZP1164438,61,19,17,2,1
SBI47VAN2510177,94,25,15,10,1
SBI06AMZ1422359,63,30,20,10,1
SBI84CII2622664,74,23,16,7,1
SBI43XBH2607487,86,26,17,9,1
SBI81NSM1464003,25,25,23,2,1
SBI20WAJ2304221,22,32,20,12,1
SBI57YVU3912595,22,36,32,4,1
SBI96SCV7403665,85,27,19,8,1
SBI67XOC6063677,76,24,17,7,1
SBI58MTQ2559136,24,27,15,12,1
SBI90ZTB7680769,94,26,21,5,1
SBI60QFH2581680,25,35,26,9,1
SBI05CGN0402565,18,21,19,2,1
SBI11MEP0776585,83,29,16,13,1
SBI88VSQ5945380,69,28,21,7,1
SBI52EFV0349751,62,33,28,5,1
SBI88SGM6922220,25,25,17,8,1
SBI43XHZ9603794,73,25,18,7,1
SBI19VET4851144,73,23,12,11,1
SBI74USE8344742,89,22,15,7,1
SBI40TMQ1253776,95,20,17,3,1
SBI26CGO3578914,82,28,26,2,1
SBI38OPA2151569,76,20,15,5,1
SBI65GMD0171397,80,16,10,6,1
SBI78VYR6140226,82,18,17,1,1
SBI86UEO1157249,81,18,11,7,1
SBI41IID5320751,79,26,17,9,1
SBI66DKD3536135,24,24,22,2,1
SBI22RHM8331823,91,22,13,9,1
SBI02IZO6599047,87,28,22,6,1
SBI49FUT2402408,72,28,21,7,1
SBI97ZTB1045593,87,17,13,4,1
SBI11MTA6828067,68,33,31,2,1
SBI07FII2978300,78,19,14,5,1
SBI68DUZ9259002,86,21,20,1,1
SBI13IBW8103873,23,14,11,3,1
SBI02FDC8986096,71,26,15,11,1
SBI11ZSU4619259,77,20,17,3,1
SBI31XJJ3525217,66,25,17,8,1
SBI57NDD1753229,97,27,15,12,1
SBI67OSG7784836,91,26,18,8,1
SBI47TYP9354183,70,25,17,8,1
SBI33GGS6253322,76,32,17,15,1
SBI64HPG7658506,83,33,17,16,1
SBI09TMV3871854,72,29,18,11,1
SBI93VJI9783905,81,21,11,10,1
SBI34MGN6867837,22,34,30,4,1
SBI80JQK8836320,89,18,15,3,1
SBI96POQ1682272,93,28,15,13,1
SBI80FLE0625031,60,23,12,11,1
SBI61XYT2951329,77,29,18,11,1
SBI91AEY2065622,24,26,15,11,1
SBI32BGC4181007,83,19,10,9,1
SBI17UYS2773297,68,25,17,8,1
SBI25JDH8167746,77,26,24,2,1
SBI50JKQ1006650,77,29,20,9,1
SBI89IND1955103,62,28,25,3,1
SBI78IKO1532407,78,25,23,2,1
SBI56XPG2145241,18,31,20,11,1
SBI00FVH0038225,76,25,20,5,1
SBI22DZX7401548,22,23,15,8,1
SBI85BMR0915224,25,24,22,2,1
SBI44KJQ6165002,25,23,15,8,1
SBI26ADV8142885,61,25,14,11,1
SBI07RKA7008901,85,20,15,5,1
SBI43PNK9712838,99,22,20,2,1
SBI08DMG2936713,81,25,23,2,1
SBI26QVL9979456,89,24,18,6,1
SBI53CLM9335206,63,27,25,2,1
SBI24ZWJ5057119,64,27,14,13,1
SBI59NQF0798082,65,21,18,3,1
SBI78VXH1753066,86,25,18,7,1
SBI42IKW0211561,76,16,10,6,1
SBI33LJF3638584,63,16,12,4,1
SBI17DXJ7363449,62,30,26,4,1
SBI56CHD8292228,81,29,28,1,1
SBI76RPJ2972418,82,31,22,9,1
SBI40FGO2925804,88,20,15,5,1
SBI38TBV6056150,73,21,15,6,1
SBI31AHL5068225,78,26,25,1,1
SBI08WVA5390098,22,27,21,6,1
SBI10ERL3487151,85,13,8,5,1
SBI51BHO7153582,70,24,19,5,1
SBI51UPS0918610,75,20,14,6,1
SBI29LSZ9359576,62,23,13,10,1
SBI50GDL0760932,82,30,24,6,1
SBI23DLR1660940,86,22,21,1,1
SBI23NZV7433108,99,22,13,9,1
SBI09XJL0790387,80,23,16,7,1
SBI92ZNZ1887020,24,30,28,2,1
SBI79ZLF1773215,80,24,16,8,1
SBI11FQA4471655,85,24,21,3,1
SBI60DCB8290069,60,29,23,6,1
SBI86RNG3971625,66,31,30,1,1
SBI57EGE0860447,63,21,20,1,1
SBI40SPN2825300,71,30,18,12,1
SBI91UEM1496515,78,25,22,3,1
SBI93HVY5318934,93,28,25,3,1
SBI61IUX4673180,98,31,26,5,1
SBI08KSL4747465,96,23,16,7,1
SBI63YUQ2730797,20,23,17,6,1
SBI38SHL2252308,71,30,29,1,1
SBI18RKT8741735,22,28,17,11,1
SBI37SSH1726389,87,21,16,5,1
SBI46BBL6394034,92,22,19,3,1
SBI39TRQ1856760,81,29,27,2,1
SBI34QHV6208461,88,29,23,6,1
SBI30EAR0910286,77,18,14,4,1
SBI69BOT6009645,96,25,23,2,1
SBI85KAJ1508122,81,22,19,3,1
SBI61MIL6553146,70,29,26,3,1
SBI93TWZ5881527,76,16,10,6,1
SBI87KLQ6222885,91,30,25,5,1
SBI16KKJ2029820,93,28,17,11,1
SBI99UGC4141037,80,14,11,3,1
SBI77TRQ6359810,70,16,11,5,1
SBI60OLD5391076,72,27,19,8,1
SBI69EVL1411204,19,14,9,5,1
SBI14INE5218828,19,25,20,5,1
SBI35XEX9890586,70,27,19,8,1
SBI55MKG5144356,99,34,18,16,1
SBI44FYV3596268,62,23,16,7,1
SBI38RVU3467866,18,17,14,3,1
SBI33EYK0370602,88,26,22,4,1
SBI35XOS2253825,24,22,21,1,1
SBI10EKA6113892,22,28,23,5,1
SBI74YCD4670118,81,33,30,3,1
SBI90LIQ1331499,75,28,22,6,1
SBI38XEI8911785,75,30,19,11,1
SBI83MRV6370016,96,27,19,8,1
SBI62EGT3171298,21,26,18,8,1
SBI13SJL4080663,69,30,26,4,1
SBI00UPK2023116,65,19,12,7,1
SBI21ZMF5858457,95,28,27,1,1
SBI16XZS0759198,77,15,12,3,1
SBI90JNK1040139,96,25,18,7,1
SBI90XYB1224364,62,30,18,12,1
SBI76QUX1079483,69,30,25,5,1
SBI03KIJ4384910,93,23,22,1,1
SBI02YUJ6482482,77,28,16,12,1
SBI22CFB1029676,83,12,10,2,1
SBI57WXN0717797,73,11,7,4,1
SBI19GII3455760,74,21,14,7,1
SBI58DPC3441886,64,24,20,4,1
SBI98BUU8201896,78,17,15,2,1
SBI07ZSO8498043,74,20,11,9,1
SBI21MLS5270864,97,26,20,6,1
SBI80HAB2813975,95,32,20,12,1
SBI73MMT1218364,75,27,17,10,1
SBI49GGX6257906,65,22,12,10,1
SBI30GJA3429631,97,28,17,11,1
SBI06XSM3749585,79,21,16,5,1
SBI45OXW4235357,73,24,17,7,1
SBI41WXB9223235,86,22,13,9,1
SBI60ULD9504862,99,27,21,6,1
SBI36WRO2870214,73,24,19,5,1
SBI27QHR7629887,22,25,13,12,1
SBI16AHU3561368,78,27,18,9,1
SBI77YZB5671224,91,24,19,5,1
SBI07IAN1754105,86,16,10,6,1
SBI78ZHJ2657823,82,25,17,8,1
SBI58FNT6222901,86,22,16,6,1
SBI55WNJ9785703,25,20,13,7,1
SBI37UIY8130453,88,26,24,2,1
SBI73ZTA1317736,96,28,25,3,1
SBI72RBT2233245,82,20,11,9,1
SBI60WTG3534639,81,23,14,9,1
SBI00VAD3648478,63,22,17,5,1
SBI05BNL9455631,24,19,16,3,1
SBI73TUJ2584377,79,22,19,3,1
SBI93HCU0127609,72,27,26,1,1
SBI78QBU9172959,92,35,22,13,1
SBI56IDD2429512,19,28,25,3,1
SBI38XOX6351243,72,22,12,10,1
SBI99WND8767876,96,27,22,5,1
SBI36NUP9312745,91,25,24,1,1
SBI03OKG5964996,76,18,12,6,1
SBI16QPT1147782,94,21,14,7,1
SBI47YAL5113163,19,22,17,5,1
SBI21EOE6902371,76,25,17,8,1
SBI22UAQ3107487,70,24,18,6,1
SBI18YFA6812188,92,25,18,7,1
SBI93VOJ7572928,93,28,17,11,1
SBI79CFZ9198266,18,21,17,4,1
SBI95UMU6205603,77,24,23,1,1
SBI93XKC9177886,25,20,13,7,1
SBI24SFE7279103,78,36,28,8,1
SBI08XZR6408302,74,29,26,3,1
SBI88IMV9491278,98,23,19,4,1
SBI45YQW7202368,94,21,18,3,1
SBI81QSB9132473,84,29,23,6,1
SBI82KMO7770006,76,21,12,9,1
SBI98UUE5632496,78,18,16,2,1
SBI88KBN1912943,76,21,12,9,1
SBI62MVS8952971,73,27,22,5,1
SBI66TLG0667266,64,25,22,3,1
SBI59UBW3072625,19,30,28,2,1
SBI06MEL9104421,96,18,12,6,1
SBI98BLH9638196,86,20,12,8,1
SBI75BFQ3454681,78,27,25,2,1
SBI53SQL5587008,99,17,13,4,1
SBI73FTI2754329,99,30,22,8,1
SBI63BRN4645913,97,26,24,2,1
SBI12FXW4129212,60,23,20,3,1
SBI39MEY7726959,75,28,18,10,1
SBI47CSR1456992,62,12,10,2,1
SBI71ASD9319607,62,34,20,14,1
SBI68LVN9186569,84,22,21,1,1
SBI70PIN7439966,23,23,18,5,1
SBI24KIF7929048,79,31,18,13,1
SBI70GID5488503,23,28,19,9,1
SBI94SEO3815270,88,24,13,11,1
SBI28KGB8783295,78,16,10,6,1
SBI04VCE3096601,21,17,13,4,1
SBI00FMR5867841,89,25,15,10,1
SBI84SSX5892157,87,19,15,4,1
SBI38IDT5743853,83,28,19,9,1
SBI73MCM5776298,69,27,17,10,1
SBI99PEH4908714,76,22,14,8,1
SBI27LGC4850687,96,17,15,2,1
SBI66VAK7370698,75,26,24,2,1
SBI01HEY0754959,98,22,18,4,1
SBI18VDW0870453,91,16,13,3,1
SBI87HOJ6981620,79,27,22,5,1
SBI43BCI7888022,64,15,10,5,1
SBI04GLN0488227,96,24,21,3,1
SBI85PVI1156089,90,23,17,6,1
SBI64WPI3497762,71,25,23,2,1
SBI20OZT1180526,68,22,18,4,1
SBI52LWT2008810,74,24,23,1,1
SBI86LXV4574995,22,28,21,7,1
SBI86UGV4392707,25,24,18,6,1
SBI10UML5320912,95,29,24,5,1
SBI18JWZ5158658,88,23,18,5,1
SBI49GEE1810187,84,31,26,5,1
SBI89PWL1618293,67,19,11,8,1
SBI07UVH5981956,81,25,13,12,1
SBI00XZC7212420,81,22,17,5,1
SBI65EWT7064675,18,19,15,4,1
SBI47NHL8275734,62,31,17,14,1
SBI16XQK4415970,79,29,19,10,1
SBI64FRI1472385,81,23,12,11,1
SBI35POR5449973,67,23,12,11,1
SBI71SPZ3660441,75,30,25,5,1
SBI76KYF7789164,87,15,12,3,1
SBI28ZKB1752569,71,24,19,5,1
SBI95FAQ1546909,83,11,7,4,1
SBI00QJG1547708,19,32,31,1,1
SBI68LZU0378402,79,30,21,9,1
SBI17GQM8952883,75,36,30,6,1
SBI93ONH2597584,72,25,19,6,1
SBI85YZD1090011,60,24,15,9,1
SBI09DTT2483465,86,22,13,9,1
SBI27EUT0584027,99,37,31,6,1
SBI14CLK6518639,92,16,10,6,1
SBI73CGB0489749,22,14,10,4,1
SBI78JDF5833661,89,16,10,6,1
SBI08OWT9729212,85,15,8,7,1
SBI05FJE1337674,89,27,19,8,1
SBI04NFM9654353,92,28,25,3,1
SBI77OSK1528850,62,26,16,10,1
SBI65QBJ0067245,98,28,17,11,1
SBI45FVH2946550,91,26,18,8,1
SBI07ZSD0105663,82,21,19,2,1
SBI74KXM0100747,90,29,17,12,1
SBI62POZ3681781,81,25,18,7,1
SBI60PKU4143501,66,26,21,5,1
SBI91LET4861066,23,35,18,17,1
SBI08QOD4429692,83,25,21,4,1
SBI52XGQ7881494,21,23,15,8,1
SBI37UEZ9341308,60,24,21,3,1
SBI87NCB1928839,84,8,5,3,1
SBI52KKW9681203,88,35,21,14,1
SBI19VXG3913385,86,21,12,9,1
SBI76PCU4129032,65,27,25,2,1
SBI44CNP5225643,75,15,12,3,1
SBI53SPR7305518,21,33,23,10,1
SBI69KOJ4359321,86,27,26,1,1
SBI39QHF0629745,62,30,19,11,1
SBI81SLZ8469255,89,24,22,2,1
SBI61RQG8642707,65,27,18,9,1
SBI46RZT5596285,87,27,26,1,1
SBI75EWQ8186814,19,15,8,7,1
SBI23GOG2030896,81,32,29,3,1
SBI46JQK4936498,72,17,15,2,1
SBI22TBG7394794,78,29,18,11,1
SBI69FZR5528418,81,22,20,2,1
SBI83MAQ1359800,74,38,24,14,1
SBI60GTL0624117,24,32,29,3,1
SBI77UMO1611944,86,19,10,9,1
SBI71MAQ7978305,90,23,19,4,1
SBI52WZJ7058675,89,27,16,11,1
SBI84VFG1174439,77,23,12,11,1
SBI34HNI8172287,25,29,26,3,1
SBI94MEF7930087,76,28,16,12,1
SBI31WIR3621395,18,25,14,11,1
SBI62BJB4728069,64,30,26,4,1
SBI19IBE0356343,64,19,14,5,1
SBI76HAS6093210,76,23,17,6,1
SBI48THC4092815,21,29,16,13,1
SBI14PEH7785463,68,20,13,7,1
SBI33NZW4363015,73,35,23,12,1
SBI08SGE9869194,22,26,18,8,1
SBI84LFI1066328,60,7,6,1,1
SBI00BBB0407003,83,27,19,8,1
SBI15AHX6629937,94,31,27,4,1
SBI81ZLX3748498,21,25,14,11,1
SBI39LWY5349753,77,24,20,4,1
SBI20KRV7812277,60,33,18,15,1
SBI47GFX8074193,25,19,13,6,1
SBI46RJY4794142,97,29,27,2,1
SBI92EKV4644186,18,25,17,8,1
SBI75QCD7831621,65,28,19,9,1
SBI43BJE1256580,64,30,29,1,1
SBI35FXW9611039,64,30,16,14,1
SBI77KXL3224023,66,20,17,3,1
SBI52LLU4839483,72,29,22,7,1
SBI83INU7530954,20,26,16,10,1
SBI17OOP8310714,97,33,25,8,1
SBI58YLI1334647,84,28,23,5,1
SBI22EEV4325233,69,20,14,6,1
SBI93UZM1493361,94,24,22,2,1
SBI47YNY0047376,70,25,24,1,1
SBI03EAU6431838,18,32,27,5,1
SBI54QIZ0509577,61,24,22,2,1
SBI94NCR5761609,70,29,20,9,1
SBI73DZG8394140,92,24,13,11,1
SBI50JPD8536671,60,29,25,4,1
SBI96NCQ4660371,68,26,21,5,1
SBI64SZU1952622,20,26,24,2,1
SBI67DFZ3179663,73,20,15,5,1
SBI16BBB7246892,97,30,20,10,1
SBI16NOG2594581,91,21,20,1,1
SBI44OAD3826879,69,16,14,2,1
SBI16GHX5898387,99,19,18,1,1
SBI92CQU8532542,19,34,18,16,1
SBI85SIM1741095,94,25,19,6,1
SBI03BQD7456615,95,39,37,2,1
SBI76ZKD8829329,65,27,21,6,1
SBI65PJT4005984,78,25,19,6,1
SBI86TRQ9065467,72,19,11,8,1
SBI08LJO6498528,82,23,15,8,1
SBI70ULH9737984,78,22,12,10,1
SBI49IMF0148733,79,29,16,13,1
SBI76TSF8679452,65,25,24,1,1
SBI12QLH5292972,97,28,26,2,1
SBI81JUH5203002,24,24,22,2,1
SBI80AFA6530656,75,27,25,2,1
SBI57TFY0707226,99,28,21,7,1
SBI38INK2255705,73,26,22,4,1
SBI42EHL9089292,82,20,19,1,1
SBI15OOZ8343015,71,20,16,4,1
SBI60SID7617878,77,22,21,1,1
SBI32FTM9244456,25,23,19,4,1
SBI39KQC8438457,86,30,17,13,1
SBI31GHE2592240,61,26,24,2,1
SBI56UJK9097935,21,29,17,12,1
SBI46FPY8339705,76,16,13,3,1
SBI67KJP0584550,99,21,18,3,1
SBI59HOV2069113,67,23,19,4,1
SBI40TUX9371730,72,26,16,10,1
SBI74LTT9389155,20,27,26,1,1
SBI99GJM7359355,90,31,23,8,1
SBI89VFF3643460,91,25,20,5,1
SBI58MGG2409193,80,16,12,4,1
SBI28ELS1811869,91,27,18,9,1
SBI88EXT5464313,25,33,24,9,1
SBI54REB1435096,71,21,18,3,1
SBI76EQO2862425,23,21,11,10,1
SBI60TNM4425619,74,20,19,1,1
SBI97JYJ2794609,83,23,21,2,1
SBI96VHQ6157426,84,31,20,11,1
SBI98SQG4253939,19,30,19,11,1
SBI57SKG4296989,64,24,14,10,1
SBI97YXA8717216,75,28,26,2,1
SBI94GDM2056575,91,25,13,12,1
SBI91EWF8568613,20,26,15,11,1
SBI93NHT7920462,99,23,18,5,1
SBI15PUI4109973,19,26,22,4,1
SBI85UFR3406272,91,30,22,8,1
SBI07FCP7372386,90,28,15,13,1
SBI94DJJ7703620,71,24,23,1,1
SBI07RIV7305371,20,23,17,6,1
SBI74RBD4993201,64,23,18,5,1
SBI96QTY8182504,94,26,23,3,1
SBI28VLU4264197,91,25,21,4,1
SBI76VYF8280338,23,26,22,4,1
SBI01ULD0271486,69,26,17,9,1
SBI20HSE7030859,18,26,21,5,1
SBI38YXN9108756,60,29,15,14,1
SBI56ZQI9663864,74,39,32,7,1
SBI30KFQ9972608,78,24,23,1,1
SBI62WUM1244509,77,19,10,9,1
SBI98SDJ0101474,20,27,21,6,1
SBI82KZX8443825,18,23,21,2,1
SBI97KUN9981916,86,31,18,13,1
SBI10YKK5475166,22,26,20,6,1
SBI46NKA4962516,85,21,11,10,1
SBI24SPH4690802,96,35,24,11,1
SBI17YSR7904974,80,20,19,1,1
SBI19WGO8949770,68,24,14,10,1
SBI34NRF7624019,84,19,14,5,1
SBI35ZBP4223336,22,25,19,6,1
SBI27SEU5642498,88,23,21,2,1
SBI23RRJ7335872,71,23,22,1,1
SBI72TFD0408253,68,20,14,6,1
SBI99VOW2337015,74,25,17,8,1
SBI75FGJ4158601,24,20,17,3,1
SBI45RWL9800803,65,18,12,6,1
SBI68CVU9033016,71,22,20,2,1
SBI06RDD7539405,63,26,23,3,1
SBI95UKV9015600,76,19,14,5,1
SBI91KOD6741511,72,36,33,3,1
SBI75JSV0055960,73,22,12,10,1
SBI62UEI5489053,78,16,10,6,1
SBI10TYE5931560,68,26,14,12,1
SBI44CTL1474382,71,32,23,9,1
SBI17GWP5094051,92,16,11,5,1
SBI23VLR1040114,79,29,19,10,1
SBI22KVY2192082,88,29,18,11,1
SBI43OJM2168617,74,21,12,9,1
SBI70IRA7407447,91,27,20,7,1
SBI91KKZ1382281,23,19,17,2,1
SBI24DLQ3533382,66,16,10,6,1
SBI15CMN4911363,94,23,14,9,1
SBI05APC0512736,80,27,22,5,1
SBI35PIW8896662,92,25,15,10,1
SBI16YTH2750981,87,28,24,4,1
SBI65YCV1980125,75,23,19,4,1
SBI21HYQ0678887,94,19,10,9,1
SBI91OPT1926499,99,19,11,8,1
SBI72SBK7164995,65,26,17,9,1
SBI87OCW2037031,73,29,27,2,1
SBI29SBF7478597,76,36,34,2,1
SBI74EFE1954158,80,25,14,11,1
SBI04EFU4384710,18,36,19,17,1
SBI55TVV8722717,23,25,23,2,1
SBI72CLE0184966,99,23,15,8,1
SBI65DLN8229990,22,27,24,3,1
SBI23JTF4003743,18,23,17,6,1
SBI56AYW5799479,75,25,21,4,1
SBI65WZR1368342,78,31,18,13,1
SBI32RAN6924438,87,30,27,3,1
SBI71QHC8328975,79,22,20,2,1
SBI49OOS8357170,69,19,14,5,1
SBI81UMY5084021,78,23,14,9,1
SBI27ODC8978360,71,15,11,4,1
SBI15VXR9359575,21,20,17,3,1
SBI29CWZ6028698,70,29,24,5,1
SBI77UZS2989014,77,30,22,8,1
SBI93XPI2325530,88,29,18,11,1
SBI14DCY9012997,96,18,13,5,1
SBI51PAB1410832,19,28,15,13,1
SBI36ADI3605851,73,27,25,2,1
SBI18ZYK3198783,76,29,15,14,1
SBI16HAE4558187,93,34,18,16,1
SBI74QWR5241024,24,26,14,12,1
SBI96QFH3745536,97,31,29,2,1
SBI92RLS3481633,73,31,30,1,1
SBI72IGQ8976957,60,22,12,10,1
SBI03JHV2257267,75,22,12,10,1
SBI65NEM7140577,73,19,12,7,1
SBI43XUP3159189,64,21,12,9,1
SBI20XYD4369168,73,23,15,8,1
SBI78FRQ5096962,20,10,9,1,1
SBI01VHG8122145,88,26,21,5,1
SBI17RMH0715667,77,23,14,9,1
SBI35HWC5150352,95,26,19,7,1
SBI30MOP2435479,93,27,25,2,1
SBI47COA7792805,70,28,18,10,1
SBI91BIN2543762,22,28,17,11,1
SBI14XWT3700028,67,31,20,11,1
SBI20CQY3861450,72,33,22,11,1
SBI47RBE2643806,85,25,21,4,1
SBI29ARU3964599,64,31,26,5,1
SBI50KQM8948298,95,24,14,10,1
SBI83IEI1088882,70,29,25,4,1
SBI33XQJ2856812,22,18,12,6,1
SBI40GNU3550533,67,25,17,8,1
SBI78PQE2344173,63,30,23,7,1
SBI66XFD7532297,74,19,18,1,1
SBI00IQE1687342,84,33,27,6,1
SBI33VMM7474303,64,29,16,13,1
SBI80VPC3063504,74,28,23,5,1
SBI62ZQH4148687,64,32,22,10,1
SBI78OPL6964296,72,35,27,8,1
SBI79RSV5425754,22,15,11,4,1
SBI57IHG9011303,18,20,12,8,1
SBI44IDP0079516,74,28,17,11,1
SBI28LZD2814364,66,26,17,9,1
SBI74XEQ7195246,91,18,13,5,1
SBI05BIJ8420784,71,24,18,6,1
SBI31HTE1171700,92,26,21,5,1
SBI25OYW3684853,87,24,16,8,1
SBI77DIP4019518,23,27,23,4,1
SBI37JIJ0124302,69,19,11,8,1
SBI30VFJ9956564,97,22,19,3,1
SBI85NCC8830364,97,28,15,13,1
SBI65DPJ5936616,75,17,10,7,1
SBI02WUT5757745,24,24,21,3,1
SBI18IUR7764069,85,23,21,2,1
SBI11UMH2194989,62,26,15,11,1
SBI63PEQ2362963,68,25,22,3,1
SBI27LIP8860504,65,27,21,6,1
SBI13FCG1015837,67,18,14,4,1
SBI53HGM8113706,89,20,15,5,1
SBI10EKA4651058,62,34,25,9,1
SBI73XML7282722,78,25,16,9,1
SBI11ZAI3585012,64,21,12,9,1
SBI04OJO7798467,96,20,14,6,1
SBI27BNS9542984,83,23,20,3,1
SBI49KKY5968338,81,22,19,3,1
SBI39SII6041783,77,26,16,10,1
SBI72BHI1267086,90,22,18,4,1
SBI61PVQ7637047,60,21,14,7,1
SBI07CKN8626328,91,27,14,13,1
SBI71KUM4285679,90,18,14,4,1
SBI77EKW9413726,70,20,15,5,1
SBI08EAZ0382970,86,23,14,9,1
SBI46MTJ4280855,99,20,15,5,1
SBI94YMB5433450,96,10,9,1,1
SBI00AFO9224840,98,15,10,5,1
SBI33FYG9643640,19,30,28,2,1
SBI13GYO3677987,63,22,21,1,1
SBI05GHR7849461,71,22,14,8,1
SBI56QQH7673476,24,24,21,3,1
SBI24CWS2006183,74,24,22,2,1
SBI81ZAS9687352,21,21,12,9,1
SBI75NYG3985587,99,21,15,6,1
SBI73MEZ5628357,22,19,11,8,1
SBI02PQH2086163,18,34,29,5,1
SBI59XOL9813307,23,32,29,3,1
SBI39VDO8030677,97,26,16,10,1
SBI71NHX9404447,20,30,18,12,1
SBI90TCI2789296,76,18,14,4,1
SBI30AZP0034443,89,28,20,8,1
SBI29IQG1621524,62,17,11,6,1
SBI98CVI9978497,93,27,18,9,1
SBI16IYT9067432,92,28,22,6,1
SBI17YNA7725341,68,25,13,12,1
SBI78UKU0978837,92,31,17,14,1
SBI81LSS6590668,70,24,18,6,1
SBI57YJR3340719,64,28,15,13,1
SBI59TVJ7301173,79,36,31,5,1
SBI64PQB9703514,81,21,11,10,1
SBI15RCF9572218,20,27,18,9,1
SBI24UOO5891844,82,41,37,4,1
SBI67KLA3295593,67,26,19,7,1
SBI99DWO6728152,82,21,12,9,1
SBI33YCK3107027,25,28,26,2,1
SBI27OZX6525754,77,24,13,11,1
SBI17DZP3559913,77,31,29,2,1
SBI34FIH9863388,82,29,27,2,1
SBI72MSI5065825,92,27,14,13,1
SBI08QDA7964905,69,25,20,5,1
SBI81YQO9757925,83,33,25,8,1
SBI77MET7844788,95,21,19,2,1
SBI19AGG0124833,18,24,21,3,1
SBI70OKZ4143269,61,27,23,4,1
SBI93RFT4747846,64,31,19,12,1
SBI49WKJ2975143,86,32,26,6,1
SBI05XPA7241854,81,21,11,10,1
SBI62XLS2198742,86,24,18,6,1
SBI95HVY9712781,84,27,15,12,1
SBI22LBB5459736,18,28,15,13,1
SBI63MYI4632130,24,32,20,12,1
SBI15VLD2192897,83,33,26,7,1
SBI59WCE6035342,60,32,17,15,1
SBI81KIT9091390,72,23,16,7,1
SBI10CLQ0456654,85,26,18,8,1
SBI45EZB0423447,89,26,17,9,1
SBI50CCH1574661,81,31,17,14,1
SBI36DMR1202304,71,21,17,4,1
SBI51AIP5075905,97,29,15,14,1
SBI56VXD9922806,20,26,23,3,1
SBI86MJQ3693501,82,21,13,8,1
SBI69XZN5086363,64,15,9,6,1
SBI08VDG7231107,21,23,14,9,1
SBI46IZR7020198,89,24,18,6,1
SBI12WQB4560173,74,25,14,11,1
SBI68FVJ9016932,92,30,29,1,1
SBI04GYH0177707,93,21,15,6,1
SBI68UVB8061727,78,26,19,7,1
SBI86FNA6049443,87,29,19,10,1
SBI44KTQ4478660,82,23,17,6,1
SBI57AOQ6932693,84,31,26,5,1
SBI10FDM4823096,76,24,17,7,1
SBI59TAO0637592,73,22,21,1,1
SBI11CMR1683107,92,25,20,5,1
SBI35YQV0896004,61,24,16,8,1
SBI36KUV6331289,85,15,12,3,1
SBI60FJN4581623,73,32,17,15,1
SBI26OJC6210975,86,25,18,7,1
SBI42ISB1557472,94,19,11,8,1
SBI37UKK4425619,81,21,14,7,1
SBI50PCT3580761,82,32,25,7,1
SBI56TGY9197932,70,17,14,3,1
SBI52VKH3797190,94,27,19,8,1
SBI31SLX0142445,99,28,22,6,1
SBI92NKC4096894,20,20,18,2,1
SBI29KSA0890292,90,17,11,6,1
SBI60RGE1377357,92,19,10,9,1
SBI40YDQ6652621,76,24,22,2,1
SBI27FVY1088101,60,26,15,11,1
SBI31ANS5239611,74,28,24,4,1
SBI04IIU8165615,83,23,16,7,1
SBI07MFD1115423,81,16,11,5,1
SBI89AEK0999617,71,33,23,10,1
SBI32COM7551290,77,19,11,8,1
SBI76RKX3760017,25,21,17,4,1
SBI58EUD8151821,91,26,17,9,1
SBI39LRL6829562,19,27,19,8,1
SBI82LNE4952287,70,26,21,5,1
SBI98PLA6039962,84,19,16,3,1
SBI69HTP6733166,83,24,20,4,1
SBI60DQQ1329403,63,26,22,4,1
SBI09BLT0937559,74,26,24,2,1
SBI25IMP5032959,97,29,18,11,1
SBI04PCO6106206,65,26,23,3,1
SBI84LUF2778278,96,28,23,5,1
SBI16ZLZ5790778,60,28,24,4,1
SBI21VNU8551390,98,20,17,3,1
SBI83RBV8439849,93,24,19,5,1
SBI93EZC7197726,84,25,19,6,1
SBI71YIT2197484,20,19,15,4,1
SBI46NSP8936056,98,27,24,3,1
SBI42YVC8795016,91,19,13,6,1
SBI23GGW4680096,69,23,15,8,1
SBI18RAV5290069,77,27,18,9,1
SBI32SXP8458714,80,26,17,9,1
SBI05FHL3168527,78,20,18,2,1
SBI18RSY3379625,25,22,14,8,1
SBI72RAG4066987,76,25,17,8,1
SBI98EEI1878969,65,31,23,8,1
SBI17ZCB6556190,82,27,24,3,1
SBI88PNI4647460,75,25,17,8,1
SBI11FQJ4249427,78,11,7,4,1
SBI04VDI8191701,94,29,23,6,1
SBI32VWK2263717,21,27,23,4,1
SBI53CUH7802687,22,23,21,2,1
SBI10DDD4967420,79,32,25,7,1
SBI19ASH3385581,23,22,21,1,1
SBI81PYI7657162,83,19,17,2,1
SBI47NBA6974869,75,24,17,7,1
SBI87KLZ7825852,65,23,18,5,1
SBI05SBB0397517,25,26,18,8,1
SBI08RZD6957188,66,22,16,6,1
SBI86OVT2304629,77,24,13,11,1
SBI76IVL3889205,24,28,27,1,1
SBI97VFA0006515,69,21,12,9,1
SBI09STT1306129,61,16,11,5,1
SBI82NUL7343388,68,29,26,3,1
SBI52PQG9214881,98,19,10,9,1
SBI06VVB3815417,71,23,13,10,1
SBI40FOG5877169,97,23,21,2,1
SBI86KYH2696984,87,18,16,2,1
SBI16VFV6327532,63,28,24,4,1
SBI25KTM3695402,19,26,15,11,1
SBI13ALB8790119,80,22,12,10,1
SBI26KRV8407991,23,23,14,9,1
SBI03BZW7725508,82,21,14,7,1
SBI67VAQ9082350,64,14,13,1,1
SBI94PEV4803174,82,29,28,1,1
SBI97JNA4094868,99,29,28,1,1
SBI95JDQ1816224,87,25,13,12,1
SBI97ELC8666663,89,25,19,6,1
SBI53OAH3286328,67,34,29,5,1
SBI49RNF3464382,95,30,17,13,1
SBI28MZI7999821,97,36,29,7,1
SBI19NXY3429184,97,23,14,9,1
SBI80ZNX7663167,19,33,27,6,1
SBI76UGW9183023,24,22,17,5,1
SBI60TRR3606232,78,22,19,3,1
SBI09RWC8380641,89,19,16,3,1
SBI45RPK5964606,24,23,13,10,1
SBI18GNP9390150,85,29,24,5,1
SBI25SWU5530110,71,34,33,1,1
SBI90QOE9851048,99,16,10,6,1
SBI87DUC6903216,25,24,15,9,1
SBI42AOB3422782,69,14,13,1,1
SBI87XIE7693197,18,22,19,3,1
SBI13ICC8883342,76,23,22,1,1
SBI06MAY2659920,60,24,13,11,1
SBI76BWV2570731,19,29,18,11,1
SBI22HAQ9515646,60,36,23,13,1
SBI64KTK3412237,83,20,16,4,1
SBI58TOK9695668,18,24,22,2,1
SBI12HVU8337060,18,29,27,2,1
SBI46CHQ9861678,94,26,20,6,1
SBI04WFN0441794,67,21,19,2,1
SBI51ZUC6631285,77,16,11,5,1
SBI62CTV3360573,79,21,17,4,1
SBI83SUU0991076,75,28,16,12,1
SBI29VWB9703933,61,26,16,10,1
SBI80CDL7786202,80,19,18,1,1
SBI03HUK2278767,85,33,22,11,1
SBI67ULH7356606,63,24,23,1,1
SBI64XXR7799956,99,28,18,10,1
SBI44THR3591182,81,30,25,5,1
SBI19NTT6660144,97,29,25,4,1
SBI80KMG2680645,99,19,18,1,1
SBI74XWL1141988,68,25,15,10,1
SBI90MHG0560063,92,22,19,3,1
SBI82NXQ4426640,80,34,26,8,1
SBI59TQJ8927174,88,19,14,5,1
SBI41TFT2152608,87,31,27,4,1
SBI72AUB8385147,76,24,16,8,1
SBI86MHT2001005,72,24,18,6,1
SBI54KDD3808491,20,26,15,11,1
SBI06XDA6510512,61,19,13,6,1
SBI54OWO3125747,96,20,14,6,1
SBI94JWJ8676233,83,27,17,10,1
SBI08DGG9377815,72,25,15,10,1
SBI48YSJ0395273,94,27,22,5,1
SBI05TNO2321736,66,27,16,11,1
SBI03NND0940716,77,26,25,1,1
SBI05HDY7801127,94,22,16,6,1
SBI23JNM2066134,92,29,15,14,1
SBI88SRP1396856,98,28,25,3,1
SBI86OKY5922028,86,27,14,13,1
SBI57WBK0345512,71,20,14,6,1
SBI56YTK1919424,65,23,18,5,1
SBI44AWI2802424,19,24,16,8,1
SBI56JRZ6357395,25,17,14,3,1
SBI08RRM2480159,83,29,19,10,1
SBI99RGL4856391,84,25,14,11,1
SBI84PRQ4317465,61,24,16,8,1
SBI77BWV3146894,23,21,17,4,1
SBI67EXK8548403,83,28,18,10,1
SBI53ASZ5965156,21,26,23,3,1
SBI13AXJ0313828,86,16,11,5,1
SBI29BAE5067600,75,28,21,7,1
SBI72MUX9984440,19,23,17,6,1
SBI61HKJ2283476,62,28,24,4,1
SBI25LEY8429447,19,25,19,6,1
SBI56HGQ9493228,82,27,21,6,1
SBI71HWO3569031,69,27,21,6,1
SBI87SQX1222031,79,33,27,6,1
SBI50DSE1659200,67,28,27,1,1
SBI25OJQ2976514,89,31,23,8,1
SBI31NUS0737950,18,31,22,9,1
SBI44XOL5830112,87,16,14,2,1
SBI52YKK8536801,80,22,14,8,1
SBI73TFS8590860,77,20,16,4,1
SBI13PZX2222189,66,24,22,2,1
SBI21WYK6052986,94,25,24,1,1
SBI48FYJ8161058,69,30,16,14,1
SBI13FNV4175255,71,23,20,3,1
SBI43MVT2975539,71,31,27,4,1
SBI43YZB4213737,82,34,19,15,1
SBI12DAS9061531,20,27,18,9,1
SBI81MIM3339614,96,21,12,9,1
SBI75NDG5934886,90,23,15,8,1
SBI30QXX6313471,98,27,23,4,1
SBI23CPF8915597,83,28,23,5,1
SBI05GWB2375884,64,25,19,6,1
SBI14COJ1420253,85,35,33,2,1
SBI25GTH8912749,66,15,10,5,1
SBI21TWZ5637162,67,25,14,11,1
SBI13ZXC4755561,79,21,17,4,1
SBI48HLP2122018,62,21,15,6,1
SBI66MSW4859496,90,29,19,10,1
SBI15TTP5357141,74,34,23,11,1
SBI32JXB3576872,60,23,14,9,1
SBI24FIY9999267,63,21,11,10,1
SBI74VTA9040435,72,30,28,2,1
SBI06KAH4816275,73,22,13,9,1
SBI53BWN7652527,95,23,20,3,1
SBI35BDP7479412,65,24,18,6,1
SBI86ZZR9821745,25,33,17,16,1
SBI64LZP0777516,25,22,20,2,1
SBI43RUL5609805,77,29,18,11,1
SBI60THY0399707,89,32,24,8,1
SBI36IHA3884490,84,23,22,1,1
SBI98ZGC0790247,77,19,10,9,1
SBI88BIM9017236,71,20,12,8,1
SBI62RER4810429,80,19,16,3,1
SBI92YDZ5418870,72,25,24,1,1
SBI95KBT1035580,92,24,20,4,1
SBI88AYV6673108,98,16,10,6,1
SBI15VQD2597585,75,30,28,2,1
SBI82NDS3978388,99,15,13,2,1
SBI09NVP6780796,67,16,9,7,1
SBI61ABX6862898,98,19,16,3,1
SBI59XWN7459586,64,25,20,5,1
SBI01NSB7667393,84,25,21,4,1
SBI65IAY8749287,80,23,14,9,1
SBI66CCV3206088,90,27,22,5,1
SBI34QDQ4662281,83,35,34,1,1
SBI71MLY5799411,18,19,16,3,1
SBI50AZV3318217,19,24,19,5,1
SBI71CXK9581878,90,25,14,11,1
SBI04BEY6338627,63,29,22,7,1
SBI38WLL5745446,74,27,25,2,1
SBI04HFC5145493,24,31,20,11,1
SBI61OJR0303214,89,22,18,4,1
SBI81SUO3470722,21,29,15,14,1
SBI12JFX2742939,67,23,22,1,1
SBI84SSU3401977,21,32,24,8,1
SBI30VQG3653718,95,29,22,7,1
SBI03BSJ3759042,80,13,8,5,1
SBI41MLC7742565,73,27,15,12,1
SBI17HBP5108414,71,25,19,6,1
SBI32BGW3003295,72,18,11,7,1
SBI76JJW1435080,83,24,13,11,1
SBI41TWE1840056,87,25,24,1,1
SBI50FQV9514143,94,30,23,7,1
SBI04NWL7943744,95,18,17,1,1
SBI74FDJ4931399,61,14,9,5,1
SBI19HMD4705145,62,24,17,7,1
SBI21MMF4685776,68,23,17,6,1
SBI11YZW5612188,85,17,14,3,1
SBI16QSR5280563,83,19,18,1,1
SBI97RDH4304393,62,34,24,10,1
SBI94RYO0013639,68,24,20,4,1
SBI64KLL8539838,20,28,17,11,1
SBI32ATQ9480312,71,23,13,10,1
SBI03TVG1455475,69,24,21,3,1
SBI77JGN6544747,22,26,24,2,1
SBI38WUG8568191,88,27,21,6,1
SBI15NRF2942322,72,23,18,5,1
SBI33DXX0000088,18,12,9,3,1
SBI64BHG5640926,18,25,17,8,1
SBI48AFY4171772,97,13,10,3,1
SBI89BCG6698400,91,22,17,5,1
SBI37PWL5044778,95,22,14,8,1
SBI55QMM4117364,63,21,20,1,1
SBI82AMY0827180,83,20,18,2,1
SBI92FMZ0928339,86,20,17,3,1
SBI57DFE5682293,85,25,19,6,1
SBI40FDY0938307,83,24,16,8,1
SBI80VBT8045275,94,28,19,9,1
SBI12HJD5822984,79,24,19,5,1
SBI57CJO5483450,99,23,18,5,1
SBI59TAB2478948,99,22,16,6,1
SBI43YGU2170338,24,25,16,9,1
SBI16ADP8272913,72,25,14,11,1
SBI10ZKY5767022,23,34,27,7,1
SBI07UDC7837568,21,24,22,2,1
SBI80RUO2813435,91,30,17,13,1
SBI95FBZ0117613,99,22,20,2,1
SBI97GQZ2149035,63,23,15,8,1
SBI16QEH3151082,76,28,22,6,1
SBI24UQK9370960,92,27,17,10,1
SBI97AKN0298612,77,12,9,3,1
SBI54GNG0529182,70,25,20,5,1
SBI56ZJL5144090,84,26,14,12,1
SBI22XWN6881095,90,16,13,3,1
SBI68YIG4065242,66,26,18,8,1
SBI32PXK2762678,78,31,28,3,1
SBI57MMI4331998,88,23,13,10,1
SBI10KRW7775212,71,37,19,18,1
SBI55IKL3299676,61,16,11,5,1
SBI99CKE7760919,18,17,13,4,1
SBI57LYH7935308,67,23,15,8,1
SBI32YEE5526698,78,21,11,10,1
SBI26TFA9754850,61,23,16,7,1
SBI32OWR8704638,72,29,24,5,1
SBI83CJX3189975,95,34,22,12,1
SBI45VKW6596305,98,29,20,9,1
SBI15MKB1706723,73,19,17,2,1
SBI18HSQ8560945,74,21,20,1,1
SBI74WHC4066945,95,22,13,9,1
SBI61FWA2897433,85,21,14,7,1
SBI69XDD0789470,84,29,19,10,1
SBI46CQB6613305,23,17,11,6,1
SBI03AFD1399983,65,23,16,7,1
SBI40UOW6229503,91,28,23,5,1
SBI04NFH8927865,60,25,24,1,1
SBI27BZA3135509,90,25,13,12,1
SBI66ANG2412903,19,24,14,10,1
SBI43JQL2829353,75,32,23,9,1
SBI61LPI9310698,79,20,11,9,1
SBI40XML5090859,94,25,24,1,1
SBI14GGF9941592,89,22,14,8,1
SBI77WQT2894041,71,27,23,4,1
SBI17UAW7567141,80,32,31,1,1
SBI23BDU8663932,91,26,17,9,1
SBI57RNL9308312,88,26,24,2,1
SBI50IHP5690233,90,24,20,4,1
SBI46DYC6086276,25,21,18,3,1
SBI19IHA4694548,80,28,22,6,1
SBI80BBS0017906,24,29,27,2,1
SBI73TUH4737465,87,26,14,12,1
SBI27FBY3623217,69,25,17,8,1
SBI41DJF1109112,89,26,18,8,1
SBI93OEI6915966,97,29,20,9,1
SBI65NGM9314685,75,30,23,7,1
SBI17RCU9799232,82,21,12,9,1
SBI16UKF5205394,77,25,15,10,1
SBI44ELL2339165,86,22,12,10,1
SBI84ESP0594921,81,18,10,8,1
SBI28RNN6683429,82,26,20,6,1
SBI68NRZ5151782,94,20,14,6,1
SBI92MSK7298026,65,23,13,10,1
SBI87OOI4824624,76,23,18,5,1
SBI62HBU6438097,74,29,28,1,1
SBI95URO3724661,25,17,15,2,1
SBI60COJ5443041,93,30,18,12,1
SBI79DYJ4891784,93,29,26,3,1
SBI90OSU3825156,60,17,9,8,1
SBI92OXO9006607,62,32,26,6,1
SBI59REN5475228,66,28,17,11,1
SBI32FXJ5536784,92,26,25,1,1
SBI11ULC7320108,86,26,25,1,1
SBI44MEF4045699,18,30,16,14,1
SBI55LPS8654026,85,17,11,6,1
SBI61OZZ4229928,60,29,18,11,1
SBI08VVG4356881,94,7,5,2,1
SBI90VKC0369064,72,28,27,1,1
SBI90DHO4712631,60,26,19,7,1
SBI77XVB8323191,63,22,21,1,1
SBI67NQR2354760,91,26,16,10,1
SBI67ZQO9492028,74,28,21,7,1
SBI77VIW1430796,82,24,21,3,1
SBI41OQU7093112,77,20,11,9,1
SBI22ZBE3591738,62,21,19,2,1
SBI55IUS5961958,87,29,22,7,1
SBI10SFV6481576,18,28,22,6,1
SBI29WMM2682962,71,19,18,1,1
SBI35SFQ2359360,70,25,13,12,1
SBI91JIH3968098,65,14,8,6,1
SBI21VSM7282565,83,20,18,2,1
SBI17FOM7209119,79,26,14,12,1
SBI10CRB0875037,61,21,18,3,1
SBI23ICH8650241,60,23,14,9,1
SBI38BSN6154155,23,19,16,3,1
SBI32KGW3829811,66,24,18,6,1
SBI00AAR0758940,82,29,23,6,1
SBI02URN9206481,98,18,15,3,1
SBI31HRE4043669,21,18,16,2,1
SBI87NQO4437170,95,25,21,4,1
SBI65ITU7639693,62,25,18,7,1
SBI07AVB7126197,19,21,12,9,1
SBI31XNN5125076,83,34,29,5,1
SBI38KDZ3152530,64,31,21,10,1
SBI22CPL1184417,90,24,17,7,1
SBI01XNP9169020,20,26,17,9,1
SBI18SXX6509421,76,22,14,8,1
SBI34FGB4297350,75,20,19,1,1
SBI30IBW7469556,72,35,18,17,1
SBI18IOU8236003,73,25,14,11,1
SBI20DNA6581205,94,31,22,9,1
SBI20ZCL3395264,85,15,13,2,1
SBI29SCW5465793,18,34,21,13,1
SBI61FBV3403259,73,25,15,10,1
SBI26NOT2135205,86,29,25,4,1
SBI41VTX8629774,24,18,17,1,1
SBI01SXQ5068430,65,22,18,4,1
SBI54RTE6667247,99,27,14,13,1
SBI56VJP3608614,94,30,17,13,1
SBI19FXQ0922137,89,20,17,3,1
SBI43WKZ9363867,83,26,15,11,1
SBI52NRD0096805,70,25,14,11,1
SBI44VBM0812244,67,24,17,7,1
SBI62XRZ7262033,77,27,16,11,1
SBI77FAL5736390,91,18,14,4,1
SBI41CQT9065834,72,24,16,8,1
SBI48APT1827474,77,25,21,4,1
SBI50FUF7207653,66,25,17,8,1
SBI79HIQ9723146,84,24,19,5,1
SBI33GYW9727037,77,22,13,9,1
SBI72PHB9619869,66,18,17,1,1
SBI95DNJ0735446,94,26,21,5,1
SBI74FJG0027338,78,28,19,9,1
SBI30WSW5275222,64,21,18,3,1
SBI25UCD5193853,99,17,13,4,1
SBI26AIW6556244,89,21,13,8,1
SBI59QVI9798725,65,27,17,10,1
SBI91AMC9416800,98,34,28,6,1
SBI03ZCU6620153,96,22,17,5,1
SBI44SAO7050217,74,21,11,10,1
SBI16UMY2310434,67,26,14,12,1
SBI97VTP0925220,72,16,12,4,1
SBI14WMK5860624,68,18,12,6,1
SBI39BDP2800469,97,27,14,13,1
SBI20CBP7311448,64,25,21,4,1
SBI53BPI2796649,79,26,24,2,1
SBI68LKJ8601614,22,18,12,6,1
SBI09OQD5362520,65,19,16,3,1
SBI82KNM8632203,60,27,14,13,1
SBI74HDY7921227,18,30,26,4,1
SBI80OPB0107166,60,28,27,1,1
SBI28TYX7032169,95,27,20,7,1
SBI41NEM2524878,86,28,21,7,1
SBI64BTJ0500432,69,16,12,4,1
SBI11OWL3090888,18,30,23,7,1
SBI03JWI4359318,93,25,13,12,1
SBI97MYW7122311,89,20,19,1,1
SBI35ATJ0642808,63,32,21,11,1
SBI01VZZ0025902,21,22,20,2,1
SBI29TSI1212110,63,24,15,9,1
SBI82XFW9067706,89,26,25,1,1
SBI24HRW2138859,63,26,15,11,1
SBI45FPD7716039,65,12,7,5,1
SBI31OFL8559591,83,24,20,4,1
SBI46LBF2067907,79,25,22,3,1
SBI47ZWL7851198,73,29,26,3,1
SBI75HHH6634342,83,12,9,3,1
SBI94KXW8716049,23,25,14,11,1
SBI47BEU8769948,95,24,21,3,1
SBI77BUA5544602,78,15,11,4,1
SBI75SDI4109086,79,25,20,5,1
SBI19BHO8430232,92,28,21,7,1
SBI16HVG5209543,81,19,16,3,1
SBI55JSH8030679,18,24,20,4,1
SBI58SOD5689045,94,19,15,4,1
SBI12MBX0189856,92,22,14,8,1
SBI78IJK6445971,84,20,15,5,1
SBI02KLN7877218,97,27,23,4,1
SBI41RSP7585355,88,22,13,9,1
SBI47HOS6208277,92,34,23,11,1
SBI39VGN3828913,79,23,18,5,1
SBI94NJQ1665722,85,15,8,7,1
SBI07WDW8058374,91,30,26,4,1
SBI95IZV6612582,86,17,14,3,1
SBI44TBR7109445,69,28,27,1,1
SBI67FNA9574003,80,30,18,12,1
SBI69FUA6387978,92,18,10,8,1
SBI81WDE2561302,72,24,22,2,1
SBI97QGK4042834,73,22,15,7,1
SBI83FCX0725847,78,22,20,2,1
SBI99NPN3334805,78,21,20,1,1
SBI79MHC2814665,18,26,17,9,1
SBI82AZR8351331,81,25,18,7,1
SBI24TFH4378964,82,24,13,11,1
SBI06UDF7211018,24,17,13,4,1
SBI33FPB0526998,99,25,13,12,1
SBI16DDC8441124,68,32,25,7,1
SBI05TDW2906866,75,28,18,10,1
SBI20SFN1511135,77,31,26,5,1
SBI57NXK2074790,63,29,16,13,1
SBI01KRP6627803,25,25,24,1,1
SBI95FEP2123769,90,26,24,2,1
SBI20FRT2446160,73,18,17,1,1
SBI72SSQ1209830,62,20,18,2,1
SBI82DSR5227096,75,27,18,9,1
SBI33MBO8663075,92,21,20,1,1
SBI28ABZ2940423,61,24,23,1,1
SBI82PKJ9015339,60,25,14,11,1
SBI83VRA4072032,67,38,25,13,1
SBI32DZY8437600,73,20,19,1,1
SBI83TTL8194524,94,25,22,3,1
SBI28SSS2616470,91,31,19,12,1
SBI27RVN2977176,61,29,16,13,1
SBI18XRF2215551,92,23,21,2,1
SBI15JIE4084953,62,33,29,4,1
SBI04WVT0947243,69,25,15,10,1
SBI69RTQ5146005,67,17,10,7,1
SBI51XMH7825995,68,25,15,10,1
SBI32QWF5047726,74,35,32,3,1
SBI85YCG9034234,68,22,14,8,1
SBI70NTX2893917,85,32,27,5,1
SBI20JWG9835136,97,25,21,4,1
SBI78FZH3874807,22,25,24,1,1
SBI85SWI3092960,72,18,16,2,1
SBI91XJO6386308,89,31,22,9,1
SBI36CTC6754187,90,31,29,2,1
SBI57ASR0950089,74,24,22,2,1
SBI91TQN9475626,64,20,13,7,1
SBI85ZPA2495888,76,29,21,8,1
SBI47JXF8019526,90,30,25,5,1
SBI43REE0298989,25,19,12,7,1
SBI46NXB8603375,25,36,23,13,1
SBI92PKM9661819,87,23,14,9,1
SBI86MYX0050113,76,27,22,5,1
SBI43UQL8848941,68,28,25,3,1
SBI57PAO3764387,70,32,26,6,1
SBI72OTF6763391,84,19,13,6,1
SBI94MVF3410511,73,22,20,2,1
SBI25CDN7929875,72,16,9,7,1
SBI15EOU5727551,22,26,16,10,1
SBI73FTO5568694,84,18,10,8,1
SBI73FVT0212851,70,25,17,8,1
SBI37FHX3213274,83,26,24,2,1
SBI27DFM8195422,66,21,15,6,1
SBI27PLC8110921,66,18,15,3,1
SBI65QDG9376555,19,27,20,7,1
SBI75EEF1889055,68,29,25,4,1
SBI58SSI6888246,62,22,20,2,1
SBI13JFI9904498,62,26,14,12,1
SBI58LTP9872119,90,24,23,1,1
SBI04VPT7396734,94,26,14,12,1
SBI86JZG9133315,76,13,8,5,1
SBI83IDN7938912,90,27,26,1,1
SBI58PDM7633002,91,27,25,2,1
SBI02OBR4892003,62,27,21,6,1
SBI81NQA4184559,98,24,23,1,1
SBI38EFP7362871,94,24,23,1,1
SBI10URU8911756,67,25,18,7,1
SBI27OMQ0804454,67,27,25,2,1
SBI85SKG5935763,22,23,16,7,1
SBI12XSL5394463,95,24,15,9,1
SBI58XAB9903504,96,21,11,10,1
SBI05QBS5571237,21,36,34,2,1
SBI07JPG1773771,73,23,19,4,1
SBI76PML3507472,22,30,28,2,1
SBI33LKW1819267,81,15,14,1,1
SBI92IXH9277108,73,28,18,10,1
SBI38DME1104870,18,27,16,11,1
SBI70SEG5295733,23,19,17,2,1
SBI88RQT4931682,89,18,12,6,1
SBI46ZFS2130828,65,28,19,9,1
SBI40VPP4089071,92,26,23,3,1
SBI01TDU0908411,92,15,12,3,1
SBI11RMH2888280,69,21,19,2,1
SBI89JCW6189833,21,30,16,14,1
SBI36LAB2986640,20,29,19,10,1
SBI90LGI4219221,64,23,12,11,1
SBI68ZET3455122,84,22,19,3,1
SBI48OMC5444438,92,21,13,8,1
SBI22VWD6882525,92,27,19,8,1
SBI88AJY1677593,86,29,26,3,1
SBI32KRV9169289,85,23,19,4,1
SBI17EBT2722881,77,23,22,1,1
SBI65ALC4143653,60,26,24,2,1
SBI54NJU4322044,65,25,20,5,1
SBI30JRR0890793,69,28,21,7,1
SBI28XAW2363885,21,21,12,9,1
SBI14IUC1192547,91,25,17,8,1
SBI45VXC6128788,60,33,24,9,1
SBI95UUV8635305,63,29,15,14,1
SBI83DSE4885852,97,31,24,7,1
SBI20GDG7916574,82,23,20,3,1
SBI92NYK0820788,69,32,19,13,1
SBI41CSP9656056,96,34,26,8,1
SBI10EFS4833015,68,23,21,2,1
SBI27RUA7584222,70,23,12,11,1
SBI43UDX9399966,96,34,19,15,1
SBI83XUT8853957,22,25,16,9,1
SBI50BPJ6705966,77,26,22,4,1
SBI92DIO7282845,18,29,17,12,1
SBI02LXI1266239,62,21,17,4,1
SBI34YPL3225151,81,21,17,4,1
SBI94TNR6663773,60,20,13,7,1
SBI07OSW9753073,78,29,20,9,1
SBI78QGD7689450,84,25,24,1,1
SBI14BTD1923704,99,20,17,3,1
SBI56WTT5688089,86,16,14,2,1
SBI63YVN0805843,25,18,15,3,1
SBI89LID8245406,63,27,21,6,1
SBI63NXS3717837,98,24,20,4,1
SBI46EIH0269521,78,18,13,5,1
SBI83KKY7057632,98,22,21,1,1
SBI77EIH9024233,96,28,26,2,1
SBI02GLJ4856134,22,29,18,11,1
SBI98HEI9975359,87,28,15,13,1
SBI92WYU3187045,64,37,19,18,1
SBI00LFZ4401875,66,26,17,9,1
SBI48PXD0942902,99,25,15,10,1
SBI83GHW4436673,84,25,18,7,1
SBI60MXG1648714,93,12,10,2,1
SBI11LHC9058936,93,16,14,2,1
SBI67ARA9380838,68,23,12,11,1
SBI52IAU6834052,80,34,22,12,1
SBI23JHW4154063,61,18,15,3,1
SBI11NDB6186642,97,29,19,10,1
SBI94GNP8207912,81,13,8,5,1
SBI90ILQ9763303,64,26,15,11,1
SBI07WOW4641026,94,25,23,2,1
SBI53GDZ3828616,77,23,13,10,1
SBI48ZAC6533107,19,25,24,1,1
SBI01DUI9948101,71,21,16,5,1
SBI23TUK1457444,91,26,25,1,1
SBI68FUQ4706182,23,31,17,14,1
SBI15CJW1560154,23,21,16,5,1
SBI78WJH1605964,90,26,25,1,1
SBI93ZOU2216641,95,21,14,7,1
SBI30DUK7301013,68,25,18,7,1
SBI76KQD5233496,90,31,18,13,1
SBI26UCL8667703,86,35,29,6,1
SBI90YMI9731233,71,21,13,8,1
SBI90GWE6890097,66,23,17,6,1
SBI81RCI6176600,24,26,19,7,1
SBI08QSS5407228,61,20,16,4,1
SBI83TMY5686193,77,24,22,2,1
SBI41HSX2862516,18,21,16,5,1
SBI18VIG2549134,68,24,19,5,1
SBI55FDQ6312487,85,19,11,8,1
SBI29WTQ2834670,91,16,9,7,1
SBI17QUE4404377,79,24,23,1,1
SBI14TEE2092329,87,31,21,10,1
SBI99WLG2843973,63,18,16,2,1
SBI14KOC4802966,64,32,19,13,1
SBI81LRN5967934,88,24,21,3,1
SBI82ZUR2045989,76,19,14,5,1
SBI29WJF4082666,84,14,11,3,1
SBI70GTH3237437,70,22,12,10,1
SBI69MEH1118333,18,25,15,10,1
SBI39MYC3732638,23,26,16,10,1
SBI14PGT7690329,24,27,17,10,1
SBI98BSZ6812615,97,25,23,2,1
SBI44FMS9124497,70,27,16,11,1
SBI82ILY6125678,76,26,18,8,1
SBI66ZKE8680845,69,29,20,9,1
SBI46SOB2451886,99,29,28,1,1
SBI30NAW9431752,92,21,13,8,1
SBI84XZJ4610270,81,29,26,3,1
SBI09NOD3549770,24,23,19,4,1
SBI14BFE1313924,19,17,15,2,1
SBI68UHF7912435,63,31,29,2,1
SBI35UVA0221439,95,23,16,7,1
SBI71UVQ2731265,84,26,20,6,1
SBI44MLJ0552235,90,20,12,8,1
SBI75EGI5746508,69,19,18,1,1
SBI32NMW7100085,87,21,18,3,1
SBI15FMZ8124788,65,24,14,10,1
SBI58IIW6878031,77,22,14,8,1
SBI28MDM2553993,21,32,19,13,1
SBI27JXJ3896957,77,31,20,11,1
SBI15XRW9143595,84,30,23,7,1
SBI57YST7960483,91,23,12,11,1
SBI68VYA1455150,86,27,25,2,1
SBI36ZJS9330498,20,25,15,10,1
SBI20FBS7046554,65,21,13,8,1
SBI89KWM8756336,60,20,15,5,1
SBI51HHX2277350,95,27,14,13,1
SBI94URO6018597,23,23,18,5,1
SBI79MLE1990771,73,22,15,7,1
SBI90PCY4129957,92,25,18,7,1
SBI93HZE2492690,97,27,15,12,1
SBI27FRG9984439,89,28,20,8,1
SBI96THO8065075,73,23,16,7,1
SBI62ABF2670820,95,21,16,5,1
SBI42YAT8792032,61,29,21,8,1
SBI38HTL6724138,76,24,13,11,1
SBI11CXJ4399770,25,31,16,15,1
SBI70TIP1168893,81,25,15,10,1
SBI61YBK0962280,90,27,25,2,1
SBI52AZF8772994,89,24,20,4,1
SBI90UXL8757992,76,29,17,12,1
SBI18WCF0118257,20,23,16,7,1
SBI15THY2491919,72,19,16,3,1
SBI06HNQ6252895,94,28,24,4,1
SBI22AKB5009343,89,26,18,8,1
SBI77CIV8028612,85,30,23,7,1
SBI29ZZX5199112,65,24,19,5,1
SBI53JHR0725307,81,19,10,9,1
SBI61AVM4120745,90,34,33,1,1
SBI09PGF4799478,91,23,16,7,1
SBI12IVT4431668,76,20,12,8,1
SBI85DBQ6178488,60,34,27,7,1
SBI97DBP6349484,78,26,15,11,1
SBI47YOZ3272907,24,23,13,10,1
SBI26YMY6740255,21,27,17,10,1
SBI51RSI7356116,94,23,14,9,1
SBI23TEQ6579154,85,21,18,3,1
SBI25GRS8173659,92,26,23,3,1
SBI77RPX3873431,20,17,15,2,1
SBI16ZKC3643310,95,22,21,1,1
SBI15SGG3608994,22,25,23,2,1
SBI97YVM7832284,84,27,23,4,1
SBI55FMJ2564853,92,18,11,7,1
SBI07INM2962737,18,32,20,12,1
SBI42RAV7108202,90,26,25,1,1
SBI59DDF6592932,72,17,12,5,1
SBI14WYQ0950609,86,23,12,11,1
SBI72HYM5239682,66,29,24,5,1
SBI07CQI4771216,70,21,16,5,1
SBI72BMZ0659741,19,33,24,9,1
SBI90QQW6346504,69,22,19,3,1
SBI17RRY7317172,76,23,20,3,1
SBI81BYA8360188,20,26,14,12,1
SBI09DIF5479683,25,25,13,12,1
SBI66SIN3835489,66,15,9,6,1
SBI15JAL9939901,74,26,25,1,1
SBI71ZGX1151674,61,33,19,14,1
SBI95RQW7655779,97,15,8,7,1
SBI43JYF6932777,74,24,19,5,1
SBI23FHV0677757,61,29,26,3,1
SBI75FNI0670605,64,33,22,11,1
SBI20URO9970721,70,22,14,8,1
SBI84KXJ2203861,66,25,18,7,1
SBI25IKN2656179,70,13,8,5,1
SBI75HIN0356309,90,17,9,8,1
SBI46YCT8307893,99,18,17,1,1
SBI63YXK1956161,74,22,20,2,1
SBI90NUA4396639,74,17,16,1,1
SBI09UCA6367110,69,27,16,11,1
SBI30VFF4107640,98,25,17,8,1
SBI46HKZ4855125,22,28,15,13,1
SBI20PDT5867637,68,16,11,5,1
SBI02LQZ6644336,96,27,21,6,1
SBI42XUH7715719,91,25,17,8,1
SBI69CNF2934334,18,17,9,8,1
SBI48JSZ1912816,68,19,15,4,1
SBI85GTA4983242,70,17,11,6,1
SBI04NAD7654314,62,13,9,4,1
SBI42ZTS0097227,24,20,12,8,1
SBI75GRK0297985,63,17,15,2,1
SBI70BWW4915986,22,14,11,3,1
SBI02DTH7308126,67,21,17,4,1
SBI45AJZ8225991,83,29,18,11,1
SBI76NNO6774035,80,22,14,8,1
SBI37WAN8063730,77,29,20,9,1
SBI29GBE3936459,88,26,21,5,1
SBI13DOF6061801,68,20,19,1,1
SBI27BPC6110569,99,25,13,12,1
SBI40UOV4137743,88,21,20,1,1
SBI67DAG3860584,23,23,17,6,1
SBI85SEX2796306,25,22,17,5,1
SBI56AYY3189335,94,16,10,6,1
SBI76ZKM7557388,66,22,17,5,1
SBI17HWO1915512,97,19,17,2,1
SBI14PBO4393055,61,19,12,7,1
SBI71KOB6384220,74,31,24,7,1
SBI32BXD8491469,19,23,12,11,1
SBI22XQJ6988608,70,26,18,8,1
SBI50RIQ8393699,80,22,19,3,1
SBI97QHL9435014,65,35,30,5,1
SBI17RUW1177821,63,22,14,8,1
SBI83OUL0545565,83,16,14,2,1
SBI31UFM8652073,76,26,18,8,1
SBI31KZG7693191,20,29,17,12,1
SBI58AWV9799582,83,25,24,1,1
SBI64XVZ2751546,95,18,17,1,1
SBI65OZN8240740,79,28,16,12,1
SBI36DYX8191519,86,30,18,12,1
SBI61HXT5046034,64,20,12,8,1
SBI01QUO2804997,85,29,18,11,1
SBI08MVL1987566,68,26,21,5,1
SBI30SAC8314309,76,24,20,4,1
SBI26YXK3306677,87,17,12,5,1
SBI21DEG5258460,87,18,16,2,1
SBI04VYO2131824,69,25,17,8,1
SBI39DRS9021205,71,26,18,8,1
SBI26DPA5428105,64,31,29,2,1
SBI99DTC4229921,91,21,18,3,1
SBI48TZY8778698,97,27,26,1,1
SBI14NFV0240078,72,32,18,14,1
SBI11IWT3147760,83,26,21,5,1
SBI45ZJE3291118,23,27,25,2,1
SBI86TDJ3989232,84,22,19,3,1
SBI34QEZ9648315,90,22,18,4,1
SBI83HZW6890850,82,29,28,1,1
SBI98MYE7791604,69,21,19,2,1
SBI83KCW0452067,63,23,18,5,1
SBI48DOS3986118,83,31,29,2,1
SBI53HYS1638783,63,29,18,11,1
SBI49TUJ8021721,82,22,17,5,1
SBI86TVC4489426,80,24,19,5,1
SBI48CAI6510801,83,17,16,1,1
SBI23GYF8175261,85,21,14,7,1
SBI91TZJ7783547,63,35,32,3,1
SBI72LOA5036595,24,21,16,5,1
SBI75AXN8438611,60,23,13,10,1
SBI71VZL5940598,21,23,15,8,1
SBI28JCZ5108576,60,29,23,6,1
SBI75TQH5690011,87,30,16,14,1
SBI34CQT2280858,63,29,19,10,1
SBI00PWM2181251,96,25,17,8,1
SBI07LRH8754872,93,22,13,9,1
SBI15MEW7396231,98,17,16,1,1
SBI65DPS1994857,88,23,21,2,1
SBI54XEZ8690100,93,22,14,8,1
SBI90MXT5001104,93,23,22,1,1
SBI31LUL4481559,97,31,27,4,1
SBI57RXK3067538,88,26,16,10,1
SBI20EWD1849953,64,22,13,9,1
SBI96DBR8630702,79,31,24,7,1
SBI61FPX6949863,21,25,19,6,1
SBI22HCB7978039,74,21,12,9,1
SBI60FVA1697924,22,28,16,12,1
SBI52GJT2721289,88,20,15,5,1
SBI47GEV0241287,72,27,21,6,1
SBI04KBZ4774775,84,23,16,7,1
SBI15ESL7838457,74,27,14,13,1
SBI66LHI9946985,97,25,23,2,1
SBI90VYW1967237,60,28,16,12,1
SBI56VEY5239432,88,24,17,7,1
SBI41IHC1440189,95,29,20,9,1
SBI78DQT9913663,95,23,19,4,1
SBI64VUM5943263,94,34,30,4,1
SBI65RAO5658712,18,31,29,2,1
SBI15ZWL7481062,19,32,19,13,1
SBI65BNN6738907,25,24,23,1,1
SBI88HSG2243299,61,26,23,3,1
SBI92MIS0538052,76,26,21,5,1
SBI38AWC5016649,71,27,24,3,1
SBI88OOZ5788899,76,29,18,11,1
SBI40OLE6265142,62,19,15,4,1
SBI64JIM2337391,71,26,19,7,1
SBI93QTR2485851,71,23,19,4,1
SBI66OFM4466226,67,25,18,7,1
SBI05LKH7592783,62,29,20,9,1
SBI46TWF4781687,66,23,20,3,1
SBI56NYZ6725725,68,24,14,10,1
SBI63BCV7231797,79,17,12,5,1
SBI32GCM1330320,66,30,17,13,1
SBI25VNZ4872446,18,19,18,1,1
SBI37EGK1809437,67,21,12,9,1
SBI72RTT4887191,74,26,24,2,1
SBI68HQM5274371,82,27,14,13,1
SBI55VXZ7318552,74,23,20,3,1
SBI69IMF8749747,93,25,20,5,1
SBI70ZZE6783730,91,20,19,1,1
SBI36EUD6804296,87,21,20,1,1
SBI26YPJ6814176,87,21,19,2,1
SBI64AEY9256907,97,28,18,10,1
SBI63HSU1766023,93,22,12,10,1
SBI49ILY9767859,64,23,12,11,1
SBI91PBB2650096,67,18,15,3,1
SBI77GFX3226362,66,23,12,11,1
SBI98KRE8380883,79,29,15,14,1
SBI31BRC5122161,97,25,15,10,1
SBI08TCW5658458,93,27,26,1,1
SBI89WSK1358016,90,26,14,12,1
SBI21NEB0294088,89,29,22,7,1
SBI13SVL5538319,19,27,20,7,1
SBI59HIH9273094,87,29,20,9,1
SBI30QDU0000644,19,26,17,9,1
SBI47RGI8948091,25,15,11,4,1
SBI72NQW3302347,99,22,13,9,1
SBI70INN7116693,18,23,22,1,1
SBI20JMD9996840,19,24,13,11,1
SBI34QNL9733401,77,24,22,2,1
SBI04HAD9417128,84,29,25,4,1
SBI37ICY8539366,89,19,11,8,1
SBI32RYK5250016,22,25,16,9,1
SBI71MJL4327601,19,28,16,12,1
SBI25TSE8486766,89,25,19,6,1
SBI74FDP8028336,21,27,25,2,1
SBI07JLZ2460880,97,25,15,10,1
SBI67MWX1574398,18,29,27,2,1
SBI26AVO1645829,71,20,19,1,1
SBI90KZK7312491,93,22,18,4,1
SBI87HID8032748,76,26,25,1,1
SBI75HOX3825537,62,23,17,6,1
SBI80VJA7607248,84,17,16,1,1
SBI28ISI9714901,22,23,17,6,1
SBI11XPO4231913,80,23,21,2,1
SBI71WYB1212681,99,18,14,4,1
SBI54BKQ8798358,20,28,23,5,1
SBI29UJL0679139,20,27,14,13,1
SBI19VYF1727160,61,24,18,6,1
SBI22CXN7289800,95,27,23,4,1
SBI79XQL7944824,60,21,20,1,1
SBI13TFT0314954,77,26,25,1,1
SBI79OIE7186557,97,21,12,9,1
SBI54OPU7115927,21,24,19,5,1
SBI18TMO2649350,19,30,18,12,1
SBI99XXR9720260,78,26,19,7,1
SBI45RQY9549980,24,12,8,4,1
SBI40MPC1775114,72,17,13,4,1
SBI35DDR7467561,22,19,10,9,1
SBI91MHX6456304,91,21,15,6,1
SBI70RDZ4932677,20,22,19,3,1
SBI77BFA0935273,95,25,15,10,1
SBI87KLL5154827,23,26,22,4,1
SBI85RGH4087161,61,18,10,8,1
SBI11CXY5645744,70,33,19,14,1
SBI45SDC4588743,87,20,16,4,1
SBI90EJN6490872,23,16,9,7,1
SBI86OUT5931920,18,24,14,10,1
SBI97LOY8739742,20,25,19,6,1
SBI81CEU5804108,94,24,20,4,1
SBI90IFS9926521,97,29,25,4,1
SBI31NQS4332746,63,12,8,4,1
SBI08QBI1192870,73,24,15,9,1
SBI76CSZ6427799,95,25,22,3,1
SBI68LLV4695472,81,17,11,6,1
SBI33MPO8083755,66,32,28,4,1
SBI65CJM9111500,69,28,15,13,1
SBI06YUX1159597,83,25,18,7,1
SBI43KYZ4062255,24,28,18,10,1
SBI92HHA4515614,25,25,14,11,1
SBI85WTM8730262,85,24,19,5,1
SBI67UOC3997024,85,17,9,8,1
SBI80CBQ3074838,88,24,21,3,1
SBI06JAH5452755,21,19,15,4,1
SBI40VHU4913583,62,21,14,7,1
SBI82DIP3793314,71,26,18,8,1
SBI07RAE9841626,97,21,19,2,1
SBI24ZNO1665966,87,15,9,6,1
SBI08RJS9908322,93,31,26,5,1
SBI25KSV8581029,93,25,16,9,1
SBI35XIE2273680,79,18,16,2,1
SBI33YIF9207588,92,18,11,7,1
SBI09UHP8443286,19,33,31,2,1
SBI30JNA3832394,18,18,16,2,1
SBI91FOJ0142784,22,30,27,3,1
SBI97WZA2549882,25,22,12,10,1
SBI75HWG8129673,68,25,14,11,1
SBI03MGQ2714764,66,14,10,4,1
SBI24GZO8615691,66,26,14,12,1
SBI99KUJ8065864,24,32,26,6,1
SBI99NBQ7655378,96,15,8,7,1
SBI84OUQ7329214,85,25,16,9,1
SBI41UMW8918772,19,31,17,14,1
SBI13JDG6310672,68,29,21,8,1
SBI80ABM1497675,76,31,23,8,1
SBI82KOJ1500430,99,31,24,7,1
SBI61JES7970169,61,29,27,2,1
SBI78YVU2289734,90,25,21,4,1
SBI84BLL9533044,62,31,26,5,1
SBI64FLN0648431,19,27,15,12,1
SBI94SWS5879797,83,31,30,1,1
SBI11YPU6822444,95,20,16,4,1
SBI24ZVG7581562,86,29,17,12,1
SBI61DRO1395966,69,25,13,12,1
SBI44KUZ1329743,84,22,15,7,1
SBI37SXZ6023672,97,33,26,7,1
SBI52JVL3016519,23,21,18,3,1
SBI12HUR9248978,61,26,15,11,1
SBI91QRH2930901,93,22,20,2,1
SBI21ZHJ6558582,90,35,19,16,1
SBI61KDT1336030,61,28,16,12,1
SBI98RGH1119947,88,28,27,1,1
SBI46JIE0631363,69,23,14,9,1
SBI01JSS3358631,22,34,24,10,1
SBI23GMY3899474,90,30,19,11,1
SBI29YDL4591044,18,19,17,2,1
SBI40CLY8031105,18,31,24,7,1
SBI58XII3505533,91,24,17,7,1
SBI40ZRO7117159,24,20,17,3,1
SBI88MTQ3962435,24,21,19,2,1
SBI98CSS5529441,25,29,22,7,1
SBI58UDW1060549,91,28,21,7,1
SBI22OUN8529882,18,22,16,6,1
SBI31ZTB4741743,74,25,13,12,1
SBI16MXD7193507,99,15,11,4,1
SBI86NZD0160342,25,13,7,6,1
SBI10KFL6147111,75,22,21,1,1
SBI67BJG3031729,65,31,27,4,1
SBI54VXU4297407,65,20,18,2,1
SBI05LQX4853441,67,19,10,9,1
SBI25NRC5998841,62,31,19,12,1
SBI01BNL2686925,94,27,24,3,1
SBI16FOH7406498,95,15,11,4,1
SBI51SQV7326053,88,18,10,8,1
SBI43QNN0614777,67,30,24,6,1
SBI68JHY0237493,88,32,26,6,1
SBI52CFJ9701116,77,25,14,11,1
SBI53KMC6423145,21,24,15,9,1
SBI15QJA9835727,22,21,12,9,1
SBI12TFA7347793,18,24,14,10,1
SBI95SYF0034283,62,30,28,2,1
SBI36SFW6294406,74,22,14,8,1
SBI31ZOU5937559,99,21,14,7,1
SBI90LLV3939471,76,12,8,4,1
SBI12NNK0565081,24,35,19,16,1
SBI61AWY6200744,96,24,19,5,1
SBI69BMQ4081599,74,16,12,4,1
SBI15PSW4954372,73,16,14,2,1
SBI77AGL8389907,79,21,19,2,1
SBI44JVZ6128829,95,32,20,12,1
SBI08CQP4202960,83,26,20,6,1
SBI68TTU0298391,82,21,15,6,1
SBI15EYC5888592,91,24,18,6,1
SBI95GKP9976318,66,23,16,7,1
SBI80EPK8158215,25,24,15,9,1
SBI79HBL1297276,18,32,23,9,1
SBI61STX5812109,77,30,20,10,1
SBI33ZKO1348865,80,32,22,10,1
SBI38FHO2709353,85,21,13,8,1
SBI98FHJ5424118,74,24,14,10,1
SBI00AJI1060114,99,24,15,9,1
SBI05TLS5752826,25,28,23,5,1
SBI36QHP5280656,94,23,15,8,1
SBI38LLL9055005,79,24,13,11,1
SBI29VPG3999150,23,15,9,6,1
SBI67WAP3147903,91,31,20,11,1
SBI35RBK0907359,83,26,18,8,1
SBI92RXW0704543,84,25,17,8,1
SBI04ZFC7945525,74,30,19,11,1
SBI28QAT1466558,91,28,15,13,1
SBI89LWU3290895,73,33,17,16,1
SBI87IBE7784385,25,27,15,12,1
SBI12CMB4704744,65,27,21,6,1
SBI36IGH5123836,75,22,14,8,1
SBI48VBN1517299,74,27,20,7,1
SBI97AMI1972847,80,23,16,7,1
SBI36DNB9063331,75,26,20,6,1
SBI19UWQ8468880,66,18,16,2,1
SBI74XZD1553562,63,26,16,10,1
SBI10AXH5838138,76,30,26,4,1
SBI51QYX2120352,81,22,19,3,1
SBI12LND4578799,22,29,18,11,1
SBI52KAZ5267669,66,30,18,12,1
SBI48TCO6335216,18,21,13,8,1
SBI24CJX5880732,98,31,18,13,1
SBI87AAT9397138,79,32,20,12,1
SBI18HQJ3692864,72,26,24,2,1
SBI71YPO2297625,68,20,15,5,1
SBI07QFD8913481,70,33,24,9,1
SBI74JQB7849449,24,28,22,6,1
SBI32PWM7900086,70,27,14,13,1
SBI43SHR5290921,82,25,14,11,1
SBI11FUD1245255,63,27,16,11,1
SBI57SGE2919516,82,22,17,5,1
SBI16XTX7733662,60,28,16,12,1
SBI97NOR8588315,77,21,13,8,1
SBI61IKN3332584,75,25,19,6,1
SBI66BXS0702889,96,20,12,8,1
SBI60MHZ2036999,98,31,21,10,1
SBI35NXG7549598,95,23,12,11,1
SBI41QET1971309,92,26,19,7,1
SBI01SSI7358277,97,35,24,11,1
SBI50ZYU3472919,71,33,31,2,1
SBI57DOT0797815,99,19,14,5,1
SBI05HMI1135545,61,27,22,5,1
SBI88XEZ4054472,94,24,22,2,1
SBI40KSG9325270,61,28,20,8,1
SBI19ANI9667176,60,25,14,11,1
SBI95KSI6607361,20,19,11,8,1
SBI05PUX7604292,91,23,20,3,1
SBI32JGJ6083748,79,25,24,1,1
SBI83DQT9848618,78,30,23,7,1
SBI18ZXN8174230,64,17,12,5,1
SBI53EZE6708471,91,12,10,2,1
SBI24IZQ7369378,62,27,16,11,1
SBI53IST7604394,77,24,15,9,1
SBI20GKO8142664,96,24,22,2,1
SBI38EHN7103371,60,18,11,7,1
SBI36SSO6904537,97,21,16,5,1
SBI27XCL6031598,64,14,10,4,1
SBI40DFD1994343,76,23,21,2,1
SBI97LBZ8754548,88,18,15,3,1
SBI75FGZ4461503,20,22,19,3,1
SBI14XLH1056226,25,30,29,1,1
SBI30GWL7137555,90,21,16,5,1
SBI99OJE5930116,94,16,12,4,1
SBI27DBJ3271266,75,18,13,5,1
SBI01JRL4994149,74,22,19,3,1
SBI14RQJ8285891,24,23,13,10,1
SBI76CWN4808511,98,29,20,9,1
SBI91YJS2272710,91,20,14,6,1
SBI31OBR4099983,80,21,12,9,1
SBI01PJL0795717,75,33,19,14,1
SBI85OXF5769809,70,29,19,10,1
SBI41FAX2672437,66,22,15,7,1
SBI34YUM1990682,72,28,25,3,1
SBI59CPI5974693,19,25,23,2,1
SBI32QOC7535504,88,20,13,7,1
SBI47BFY3336411,68,25,14,11,1
SBI11QSE9219356,18,25,18,7,1
SBI40IVP1823772,91,28,18,10,1
SBI93GDD4495119,76,24,13,11,1
SBI16HIE9256315,94,17,12,5,1
SBI98MQJ1161087,20,17,10,7,1
SBI38FVA9598021,92,20,14,6,1
SBI04OKY1307326,89,20,16,4,1
SBI39LQT6943943,81,29,22,7,1
SBI70TGR9070000,21,31,28,3,1
SBI93YEZ8173431,79,17,13,4,1
SBI54KIS1575829,77,29,15,14,1
SBI95QUE9116167,93,22,18,4,1
SBI21RSZ3568965,98,32,21,11,1
SBI33DQW3586808,83,31,24,7,1
SBI66KLU8163286,71,29,19,10,1
SBI04JIO4045640,66,18,16,2,1
SBI33KQV6778092,93,29,21,8,1
SBI02ITV8268083,87,22,15,7,1
SBI67PSB0694655,68,28,19,9,1
SBI58RUE6160584,97,23,17,6,1
SBI76MXC2702177,72,19,13,6,1
SBI69PGZ7655666,99,25,16,9,1
SBI24CNQ5323411,86,22,16,6,1
SBI39ACG3366921,18,25,23,2,1
SBI43RNG9045520,94,15,13,2,1
SBI94YYI3106720,85,25,21,4,1
SBI28NPE6546475,86,19,10,9,1
SBI90PNG1687382,19,30,26,4,1
SBI04GNY0301629,60,24,22,2,1
SBI31PPO6986925,80,26,22,4,1
SBI18ACE4917912,76,25,23,2,1
SBI47VBS0477619,82,25,19,6,1
SBI13IQU4262642,96,33,29,4,1
SBI24MNX8648818,99,18,16,2,1
SBI03YBT1373626,81,18,16,2,1
SBI47KVP0617819,65,21,18,3,1
SBI02KUJ8203755,99,16,11,5,1
SBI00FIB5387819,64,21,20,1,1
SBI00TWB6033865,86,33,30,3,1
SBI39BTH8235818,63,30,21,9,1
SBI91ATV8040090,79,24,15,9,1
SBI38IIH3505896,64,24,15,9,1
SBI34OYL6792866,81,17,13,4,1
SBI55LOV5203901,64,19,14,5,1
SBI98YNH3848940,87,16,10,6,1
SBI94TKZ9850946,79,25,19,6,1
SBI22CUC4544776,95,25,24,1,1
SBI60FXY2874881,93,26,24,2,1
SBI95SEF3182676,24,27,18,9,1
SBI24QKO3695653,68,24,21,3,1
SBI96BZY8437622,93,28,17,11,1
SBI48ARN3471197,67,21,11,10,1
SBI31DYP7142204,92,27,17,10,1
SBI31APS4007783,74,26,20,6,1
SBI91YWN7069248,77,16,15,1,1
SBI14SUH4865598,60,24,21,3,1
SBI03PLC6147871,22,19,17,2,1
SBI52BAQ5090270,72,28,21,7,1
SBI82HDE4006985,91,24,21,3,1
SBI42NNO9194586,64,19,13,6,1
SBI57NVP4685318,91,24,15,9,1
SBI38ZFW0757122,87,16,15,1,1
SBI99OCB7168355,19,25,15,10,1
SBI93CNX2980025,71,23,19,4,1
SBI52AVZ4378356,65,25,19,6,1
SBI55FQR0659434,61,26,19,7,1
SBI71HLJ4352422,78,26,22,4,1
SBI55OVH3987460,98,36,32,4,1
SBI65JCY1678798,86,20,12,8,1
SBI50NWP7935225,97,31,25,6,1
SBI03JDY8497749,76,25,24,1,1
SBI05CXG2768516,65,28,17,11,1
SBI84QSG3567680,70,20,12,8,1
SBI75DEV5179516,94,33,21,12,1
SBI88VRX5328719,94,27,26,1,1
SBI00EBI7263804,90,31,21,10,1
SBI68PFU1206509,25,22,19,3,1
SBI18XVR9814161,24,28,26,2,1
SBI33NKF1565694,24,27,19,8,1
SBI10JCQ9242961,90,26,21,5,1
SBI47ARJ8709748,95,27,14,13,1
SBI98RHD0842376,92,17,9,8,1
SBI74ZRH4307584,80,19,13,6,1
SBI36YHG8044904,62,20,16,4,1
SBI92GOJ4152851,70,28,18,10,1
SBI78JDL3288101,82,19,15,4,1
SBI23BYF9171551,62,31,24,7,1
SBI11RRQ8834544,73,35,20,15,1
SBI83ZAL9855540,18,20,13,7,1
SBI33JQX0412072,95,20,11,9,1
SBI67VST1368650,60,27,24,3,1
SBI18JUC4677304,84,22,21,1,1
SBI14PAW1995249,89,26,14,12,1
SBI79YKY2246907,24,29,19,10,1
SBI89VUO0524133,98,15,11,4,1
SBI15MVB6305871,23,25,15,10,1
SBI22NLM5438223,20,27,23,4,1
SBI70ITM9285854,89,27,20,7,1
SBI71YXL8029938,60,25,23,2,1
SBI96OMV7903558,23,22,19,3,1
SBI37VLG2556085,72,23,21,2,1
SBI44HAK3449234,87,16,12,4,1
SBI40XRP6904024,77,24,16,8,1
SBI80MLS4162006,65,19,17,2,1
SBI30RTP3863519,77,31,23,8,1
SBI85UXO5353845,66,27,26,1,1
SBI91KPT1184251,85,25,17,8,1
SBI46HRN2299880,85,29,15,14,1
SBI31OHA1924148,76,21,15,6,1
SBI54WJJ1327442,78,26,17,9,1
SBI13AMZ9252689,98,27,19,8,1
SBI82SFP2877595,24,15,14,1,1
SBI44TUV3145027,70,23,13,10,1
SBI33QAC3860518,94,23,17,6,1
SBI58IXT6841514,66,29,28,1,1
SBI66EFF1942185,62,25,13,12,1
SBI37GVI1979487,64,27,19,8,1
SBI61PBF3308020,74,25,20,5,1
SBI36EEC5179478,23,13,9,4,1
SBI95DXZ7877277,65,29,15,14,1
SBI20UTG8295031,98,31,19,12,1
SBI85PEY5456794,97,26,24,2,1
SBI08SVJ3243784,65,26,22,4,1
SBI66LYV7042759,62,25,13,12,1
SBI07QJR2824807,89,20,17,3,1
SBI12HJY4979015,25,26,18,8,1
SBI39SAQ0403635,83,23,12,11,1
SBI01WPI1615308,67,22,13,9,1
SBI74XCF1267892,81,20,18,2,1
SBI64VBY5481786,60,26,17,9,1
SBI68KNT0451990,66,24,19,5,1
SBI25MFQ7550815,66,31,16,15,1
SBI38LML6424795,79,23,17,6,1
SBI06DSM2312554,72,22,18,4,1
SBI85DQP3619247,66,26,24,2,1
SBI52FMK1158625,81,28,17,11,1
SBI11TFL7963077,85,28,21,7,1
SBI62SLQ8612406,97,23,21,2,1
SBI87PXL5257502,81,25,16,9,1
SBI00VUF4382002,99,23,18,5,1
SBI70UBI3102147,94,20,17,3,1
SBI58BJR0181333,97,24,19,5,1
SBI19UTY9034851,97,36,26,10,1
SBI76TWZ1335522,98,24,15,9,1
SBI00LZR6462702,87,32,23,9,1
SBI72DOQ1668682,88,20,18,2,1
SBI42DEN7864169,72,29,16,13,1
SBI33YEY1273133,73,28,22,6,1
SBI64STJ3730174,20,24,20,4,1
SBI79UGL4756580,91,24,17,7,1
SBI12OME3746734,73,18,12,6,1
SBI37EEL1118078,90,19,14,5,1
SBI83FER9989987,69,27,23,4,1
SBI04OPG5829048,23,29,19,10,1
SBI41FFJ1841062,76,22,19,3,1
SBI32XEN7807511,72,15,12,3,1
SBI92DYG9873933,71,33,28,5,1
SBI48PYD0150348,24,26,20,6,1
SBI74ZZL4838372,61,23,19,4,1
SBI51JBF7116460,98,31,28,3,1
SBI46NFD6648587,79,28,24,4,1
SBI04NZM9857342,67,24,19,5,1
SBI88UHX5043097,76,32,29,3,1
SBI15DEU3442238,68,24,19,5,1
SBI68ZZG9251250,75,29,21,8,1
SBI37DJL0040491,63,20,17,3,1
SBI00UIB5242483,93,26,18,8,1
SBI86ISX5478192,71,24,17,7,1
SBI08YVA1971525,86,27,24,3,1
SBI68VCD5185520,66,26,19,7,1
SBI42GAH1652033,70,28,24,4,1
SBI60VTB0505557,73,31,23,8,1
SBI11XYO7862751,82,25,22,3,1
SBI97IAF0880975,70,28,18,10,1
SBI25EXN0535574,81,28,20,8,1
SBI89BWS7675313,91,33,30,3,1
SBI94FLW5180595,66,23,12,11,1
SBI99AJA5333489,87,23,16,7,1
SBI02FCC6005763,85,18,10,8,1
SBI12ZWN3342302,72,24,13,11,1
SBI42VJC9369401,86,22,16,6,1
SBI13EPK8230573,95,21,15,6,1
SBI96CDW4911268,19,22,12,10,1
SBI09BAN6163442,21,30,27,3,1
SBI52KKJ4454596,61,20,14,6,1
SBI76LNQ6031408,23,29,15,14,1
SBI36UQQ4031895,79,28,15,13,1
SBI66XIU1550473,65,22,17,5,1
SBI43KND9729229,72,29,20,9,1
SBI75MVV2843595,97,25,14,11,1
SBI46UCE8815830,71,24,18,6,1
SBI35MVP1249048,81,30,21,9,1
SBI00YRE6832581,89,22,17,5,1
SBI79EFD4071058,92,25,24,1,1
SBI31LOV1031307,19,26,21,5,1
SBI11IPD8144124,93,22,20,2,1
SBI68DME1109062,86,27,18,9,1
SBI33GXT5130268,68,27,20,7,1
SBI90VEX0660647,67,18,11,7,1
SBI02IRW8714641,76,25,21,4,1
SBI50LHL0960673,61,23,14,9,1
SBI98EDZ7140509,65,23,18,5,1
SBI39AQU1980461,91,31,28,3,1
SBI22HBL6132288,88,22,13,9,1
SBI40GRH0587794,68,27,17,10,1
SBI90SZF0215463,68,30,28,2,1
SBI38INS7097545,96,32,30,2,1
SBI91UKP9886629,72,24,21,3,1
SBI50HQO4136114,88,27,24,3,1
SBI98XIL7057940,21,23,12,11,1
SBI39VHQ5389293,96,27,19,8,1
SBI61ANN3830502,89,27,21,6,1
SBI55KQE9112342,18,19,16,3,1
SBI89PIX8030554,74,32,24,8,1
SBI53CGQ9465185,67,21,11,10,1
SBI61POB0781393,72,25,20,5,1
SBI56BVK8751496,69,22,18,4,1
SBI53SBQ8191870,86,17,10,7,1
SBI33HIS4605429,89,25,17,8,1
SBI46BRN9591757,78,34,18,16,1
SBI00ZMQ9456553,79,19,10,9,1
SBI27PAW2705877,68,33,21,12,1
SBI08LZZ5136356,86,28,17,11,1
SBI96NPZ1162894,72,20,11,9,1
SBI87YFA5488906,77,32,19,13,1
SBI56YYE8649051,98,21,12,9,1
SBI03YSM3724738,77,26,14,12,1
SBI63ZUE4018489,90,22,20,2,1
SBI75QXG7895873,96,21,15,6,1
SBI60ZZX9707461,68,25,15,10,1
SBI17HLC3242403,71,30,21,9,1
SBI29KTX5939679,79,30,21,9,1
SBI93IGO7640996,99,28,16,12,1
SBI73DDE0103494,77,22,18,4,1
SBI92VZU6013547,85,29,19,10,1
SBI22FNS5731004,94,24,19,5,1
SBI70NAZ9244146,83,33,32,1,1
SBI96QMB4165641,80,27,16,11,1
SBI78YRP4521235,96,20,16,4,1
SBI16DFY2408433,70,22,14,8,1
SBI33RQY0556817,98,23,20,3,1
SBI13OOB5996369,75,28,26,2,1
SBI03RFA4930208,95,27,19,8,1
SBI07MWO3145314,90,30,25,5,1
SBI82PVI8247764,19,22,13,9,1
SBI69LHB2626486,98,24,20,4,1
SBI11XWV6819082,22,23,19,4,1
SBI25SGP0414893,72,22,12,10,1
SBI81XZC5339638,73,35,20,15,1
SBI39EIF2877474,77,20,12,8,1
SBI95KZW1363222,92,26,14,12,1
SBI57GRD8736529,72,22,19,3,1
SBI55NIF2273091,85,29,22,7,1
SBI81SPL9641397,23,29,16,13,1
SBI76UBT3173627,78,17,9,8,1
SBI78NEG2039272,99,23,18,5,1
SBI01UPK2209856,93,29,25,4,1
SBI78XUS0949670,66,19,15,4,1
SBI66HGR1013109,79,29,16,13,1
SBI53JTA5292316,70,27,21,6,1
SBI51HYL9881270,77,30,24,6,1
SBI97WNX9129336,85,17,11,6,1
SBI25VJW6756539,23,25,13,12,1
SBI19IYW7857412,64,26,22,4,1
SBI79BAZ6937299,88,22,21,1,1
SBI12PRG3594391,23,32,31,1,1
SBI54LBD7062782,75,21,17,4,1
SBI28SIK1839941,74,19,13,6,1
SBI95XNO2479813,98,28,21,7,1
SBI39ATV9544210,76,20,12,8,1
SBI38FJP4928629,70,20,11,9,1
SBI93VEZ5840160,89,29,28,1,1
SBI72RNN5608845,88,21,20,1,1
SBI70RGQ6093719,90,23,12,11,1
SBI07KUW6898762,25,19,15,4,1
SBI76IRM0670871,95,26,24,2,1
SBI16BML1685337,20,24,16,8,1
SBI77KOZ4441611,99,34,27,7,1
SBI86DOS6346305,76,22,18,4,1
SBI38DGC8346689,66,34,23,11,1
SBI35XGS2212601,83,25,23,2,1
SBI34SAC1509593,78,28,27,1,1
SBI44TVF1931483,89,31,21,10,1
SBI72NAV5780320,88,38,37,1,1
SBI73XWI9283363,75,36,34,2,1
SBI55TPZ0511684,94,23,12,11,1
SBI04YEC6518683,70,20,13,7,1
SBI90WGJ8558417,95,26,15,11,1
SBI41GMZ3184932,92,22,13,9,1
SBI84WQS6237127,63,24,21,3,1
SBI28QAK3161240,79,26,16,10,1
SBI88CTQ5288497,67,22,20,2,1
SBI49NGJ6751677,78,27,16,11,1
SBI76ZHI1069650,85,15,8,7,1
SBI96JAW1518096,23,14,11,3,1
SBI76RED5803088,76,13,7,6,1
SBI92YEV2353115,20,18,10,8,1
SBI57OXD3192838,83,31,28,3,1
SBI83LEF7099271,64,25,21,4,1
SBI58XWB1852889,90,32,31,1,1
SBI09DGJ2738906,78,13,11,2,1
SBI79FJL6644926,82,26,20,6,1
SBI40WVS8235684,61,25,14,11,1
SBI95RLB0596607,95,26,15,11,1
SBI70PXK0187741,62,24,22,2,1
SBI27QAF0646151,79,28,21,7,1
SBI46RHD4360772,18,34,18,16,1
SBI67NRF7498397,61,25,21,4,1
SBI96PIE7118865,18,25,15,10,1
SBI04ADK4883059,24,26,15,11,1
SBI07LMT0424944,20,22,16,6,1
SBI02QBE6958088,82,24,18,6,1
SBI79ECV7782493,86,23,15,8,1
SBI72CZR9741778,82,32,26,6,1
SBI00KOB6388362,21,14,10,4,1
SBI06FKM8466955,84,26,25,1,1
SBI38ZTA6507158,80,18,13,5,1
SBI59CNB8512295,25,26,15,11,1
SBI59PMJ6388014,18,31,23,8,1
SBI17SDU8537555,72,27,17,10,1
SBI65ZOC2836885,97,26,19,7,1
SBI98QQI8473921,85,23,17,6,1
SBI65RRX6553901,64,28,19,9,1
SBI71NLX7446894,94,24,16,8,1
SBI15QQT1942334,93,28,15,13,1
SBI00USI1850835,63,28,18,10,1
SBI00KNA9580361,90,18,17,1,1
SBI60XOJ8976615,79,26,24,2,1
SBI61PQQ4137607,71,22,13,9,1
SBI94OTR1592809,70,22,12,10,1
SBI04PTT2236461,60,26,18,8,1
SBI48ZDN7591657,81,20,19,1,1
SBI91KPZ0802515,77,30,28,2,1
SBI77BMV5163262,76,32,26,6,1
SBI81MEA1183858,91,25,14,11,1
SBI96YCX2896107,69,16,9,7,1
SBI97BYR2340129,83,23,18,5,1
SBI27ZJS0073718,84,25,16,9,1
SBI21GXC6661194,19,34,22,12,1
SBI24DKF6072481,74,25,23,2,1
SBI14GCY8380491,70,28,22,6,1
SBI39MCA4543702,94,11,7,4,1
SBI37JCA1492699,85,22,12,10,1
SBI37QAF8375224,80,27,24,3,1
SBI37OTO6772277,19,26,16,10,1
SBI24JDO3870518,20,23,21,2,1
SBI02JBZ4614576,66,28,15,13,1
SBI62GBP3876718,81,24,19,5,1
SBI05CAO2969882,65,29,27,2,1
SBI20NVO5145247,71,25,19,6,1
SBI08TJY6900487,77,21,20,1,1
SBI93DNO0150557,90,12,10,2,1
SBI80ZGA8427174,80,27,19,8,1
SBI00HUX5453386,97,23,16,7,1
SBI50YQZ6129256,88,23,13,10,1
SBI35NAE8930261,22,26,24,2,1
SBI10AUD2613376,20,26,15,11,1
SBI39WQM6187269,25,27,20,7,1
SBI79UIW2065185,88,27,26,1,1
SBI22OXG0203818,92,20,19,1,1
SBI92NVG5963323,76,25,19,6,1
SBI05NIE4475807,76,27,24,3,1
SBI76ZFS7095335,25,30,19,11,1
SBI83PEG9998242,65,22,19,3,1
SBI88VSN2054528,91,34,29,5,1
SBI14UHA3347588,25,27,18,9,1
SBI42BKN2924728,67,27,23,4,1
SBI06VPP8926187,79,26,17,9,1
SBI41LWX0118083,73,27,23,4,1
SBI37OFQ9086045,91,23,22,1,1
SBI52CJZ5868799,96,20,16,4,1
SBI59HBU5153494,87,22,17,5,1
SBI26NWL4403376,80,24,18,6,1
SBI85DQJ4263620,88,25,17,8,1
SBI08ZQJ8077670,21,21,18,3,1
SBI33WRW2726061,73,9,6,3,1
SBI77WQB1831344,97,30,24,6,1
SBI96NLF5841125,91,35,24,11,1
SBI22GNC6845227,62,29,27,2,1
SBI66UTL8134416,96,17,12,5,1
SBI45PFX5538626,93,31,17,14,1
SBI07TSH0885594,83,16,15,1,1
SBI70PKW6455069,70,23,12,11,1
SBI35AKY4145737,74,22,20,2,1
SBI39SLG5714226,20,31,26,5,1
SBI43RSB9793858,66,26,16,10,1
SBI55BEV4193026,77,31,29,2,1
SBI52GOQ9231560,67,35,33,2,1
SBI53BST5769719,23,29,22,7,1
SBI68XON5764130,66,15,11,4,1
SBI33TJJ1435781,70,27,22,5,1
SBI43SBN0471996,76,19,11,8,1
SBI30STG5773521,97,15,14,1,1
SBI04ORR2090970,61,29,15,14,1
SBI79ZBA7431801,63,25,18,7,1
SBI88IIS8721968,98,26,19,7,1
SBI54FII4873391,22,23,12,11,1
SBI54MZQ2320495,74,27,26,1,1
SBI72CVB7288975,24,22,18,4,1
SBI56NPG9910465,20,18,12,6,1
SBI86QEV2463752,21,17,11,6,1
SBI34ZSA4258354,70,19,11,8,1
SBI99TSC3381777,63,20,14,6,1
SBI44SQI9581060,23,21,17,4,1
SBI00NSX3760438,20,18,13,5,1
SBI77GBF9813251,91,26,23,3,1
SBI49HHW0807119,21,33,27,6,1
SBI50EXB9054833,99,34,19,15,1
SBI91UPT5853343,63,22,18,4,1
SBI68IQW4766653,72,23,12,11,1
SBI06BLT5715434,64,24,19,5,1
SBI36GUV7897400,82,22,12,10,1
SBI81WCS1831843,88,26,17,9,1
SBI64YVV8392254,72,23,18,5,1
SBI83LQY2074145,82,30,24,6,1
SBI90YES6203377,19,26,21,5,1
SBI45QCA2673122,99,28,15,13,1
SBI65IDY4698370,66,21,17,4,1
SBI70HDB8343344,77,26,18,8,1
SBI90RPG8217032,86,22,15,7,1
SBI66TAB7105394,65,15,9,6,1
SBI62FBH7601957,69,25,20,5,1
SBI88BST9737981,75,17,9,8,1
SBI92IHS6879684,88,31,27,4,1
SBI48PRN4551499,69,26,17,9,1
SBI30BGL3207151,84,33,25,8,1
SBI29SIW4539345,98,23,16,7,1
SBI57WAG5048413,83,24,14,10,1
SBI81SIH9748580,61,21,15,6,1
SBI32AST7192963,88,18,11,7,1
SBI75KPI2550036,67,23,15,8,1
SBI64BYF0277758,87,15,10,5,1
SBI23GCE8351701,62,24,13,11,1
SBI57FZL2757985,73,18,10,8,1
SBI10ADZ3521153,25,31,30,1,1
SBI73SFW0901723,84,26,21,5,1
SBI03JNC1999786,71,26,20,6,1
SBI26UDK2045694,60,26,16,10,1
SBI90AMR0733479,21,17,11,6,1
SBI25QTV8829179,84,25,13,12,1
SBI47JTR4262341,75,22,13,9,1
SBI29BIN1565926,95,34,27,7,1
SBI66FJU5341854,62,25,17,8,1
SBI32UPK5386373,88,23,12,11,1
SBI51QYF7184676,23,27,14,13,1
SBI08PSQ7214939,99,21,20,1,1
SBI33CEE0735112,66,21,13,8,1
SBI15WMF2567733,97,31,16,15,1
SBI66ZEQ2822069,68,24,19,5,1
SBI05ACH7130391,60,23,22,1,1
SBI24FYQ4570638,81,28,22,6,1
SBI30NKA6328691,95,24,13,11,1
SBI20XSD8141035,96,28,15,13,1
SBI91ZCR8840791,78,30,21,9,1
SBI54AKU8481500,97,16,13,3,1
SBI58HAW8178553,18,14,10,4,1
SBI88IMR1988251,99,20,17,3,1
SBI57PKK7957216,61,27,20,7,1
SBI23ZKC1266070,75,20,15,5,1
SBI99VJN3480296,70,26,18,8,1
SBI88ZJJ2258432,91,31,16,15,1
SBI68OJR4149772,84,28,26,2,1
SBI96OKH0863714,79,29,21,8,1
SBI50LTD6034142,72,25,18,7,1
SBI66KKC8994220,96,25,15,10,1
SBI55INH1131200,89,16,10,6,1
SBI38NLL1860463,96,24,13,11,1
SBI17TJB0565102,21,22,13,9,1
SBI98ZDT7829250,72,27,25,2,1
SBI36FCU6918397,77,24,22,2,1
SBI24XER9839290,86,24,14,10,1
SBI78PXO7386381,76,24,18,6,1
SBI64BEU7522512,66,22,21,1,1
SBI12CIP5050085,71,29,22,7,1
SBI47BII3270350,90,23,18,5,1
SBI16TXF2450598,65,25,20,5,1
SBI33HTN5672440,80,23,14,9,1
SBI75MZE5237528,99,24,14,10,1
SBI83SQN9511960,60,27,16,11,1
SBI30RRY5090449,95,28,26,2,1
SBI84MOL8736705,20,28,23,5,1
SBI69EVK3095640,75,26,25,1,1
SBI12XVV9798704,78,30,27,3,1
SBI14VFO7217127,90,19,10,9,1
SBI20RVZ0366697,73,30,19,11,1
SBI27ILR3592116,78,24,22,2,1
SBI90XZE2135290,65,22,18,4,1
SBI26VUP1197380,96,27,26,1,1
SBI37RGG0874048,63,23,15,8,1
SBI34TKW7043119,85,28,25,3,1
SBI23QNE7510592,75,14,8,6,1
SBI71DDG5803242,67,35,29,6,1
SBI10GBL6267658,87,28,18,10,1
SBI30YJT6820348,89,24,13,11,1
SBI66TTT8454015,80,23,16,7,1
SBI04AGH4015271,24,24,16,8,1
SBI27CTM8837374,25,29,17,12,1
SBI93GLU6313795,87,18,10,8,1
SBI61XOE1677070,22,23,13,10,1
SBI92VBP5936729,94,25,24,1,1
SBI19ZJT4907356,80,33,17,16,1
SBI57GGH0876828,92,25,17,8,1
SBI22LHJ0487600,94,26,15,11,1
SBI49CCM8865125,71,17,14,3,1
SBI61OLV9957868,72,21,15,6,1
SBI37JHD1465422,85,23,15,8,1
SBI11BLC2858059,25,30,18,12,1
SBI40VEY3115648,20,24,14,10,1
SBI41EZM5212957,97,20,11,9,1
SBI98QAQ8456938,89,27,19,8,1
SBI82WKE7397997,18,16,13,3,1
SBI73GVI3515549,82,33,21,12,1
SBI86JRS5513607,94,26,18,8,1
SBI59UDO8433276,93,23,20,3,1
SBI29JEZ0305925,94,23,13,10,1
SBI52BAT1251712,62,27,18,9,1
SBI05YOA0925936,67,32,29,3,1
SBI89YMA0249739,99,22,17,5,1
SBI66DVN2907466,86,20,15,5,1
SBI72REF0429082,91,22,14,8,1
SBI63CZM7635434,97,31,23,8,1
SBI88XWS0971007,21,27,16,11,1
SBI59APN1497119,87,24,13,11,1
SBI11KBD2060393,81,22,18,4,1
SBI46RAO7780946,77,27,24,3,1
SBI91XRN6795131,78,22,12,10,1
SBI32JAZ8909145,87,26,21,5,1
SBI46FLK7472922,21,29,19,10,1
SBI86FJC1972346,24,21,16,5,1
SBI97QTZ3399232,18,20,15,5,1
SBI41YBM4202280,80,22,20,2,1
SBI49HLB3848423,61,22,15,7,1
SBI18QWP9720961,18,37,32,5,1
SBI54DVN0008277,96,31,16,15,1
SBI26LHT5964559,94,22,13,9,1
SBI82ZIP2326567,93,27,20,7,1
SBI35CMC8071383,21,24,23,1,1
SBI08UGL6579886,70,24,20,4,1
SBI04ATK1710307,80,26,21,5,1
SBI81REN9120860,93,25,23,2,1
SBI43SBK3150951,94,25,23,2,1
SBI69CZZ2262797,87,23,12,11,1
SBI51SSR2199421,93,31,29,2,1
SBI08BYP0388143,64,32,28,4,1
SBI16XZF3219856,81,28,17,11,1
SBI23EEC7196335,80,19,16,3,1
SBI60BYW8493563,85,31,26,5,1
SBI49LAP1962457,63,21,13,8,1
SBI78ICV2226545,24,27,20,7,1
SBI28RIA8856629,76,27,15,12,1
SBI22CNA6177643,25,35,26,9,1
SBI52UGX6541432,72,26,18,8,1
SBI97NQC5855375,94,27,20,7,1
SBI28BBE3480228,98,23,16,7,1
SBI19LZF4616452,86,20,17,3,1
SBI15STP0993031,60,30,19,11,1
SBI85NHQ6202903,99,37,33,4,1
SBI73EUL7985320,86,23,15,8,1
SBI01TWZ2867218,60,26,17,9,1
SBI84KCC6556142,66,27,23,4,1
SBI90PMV5536525,71,30,27,3,1
SBI66RVQ4952631,21,26,15,11,1
SBI54YCF7324685,70,30,16,14,1
SBI15BJN3733276,98,28,18,10,1
SBI41NKP1271333,60,26,22,4,1
SBI34GTC8516407,81,24,16,8,1
SBI41JBZ7048053,78,28,18,10,1
SBI00QCJ9742333,25,22,15,7,1
SBI58NNS4687116,82,29,15,14,1
SBI51NSH9684766,20,23,14,9,1
SBI07VYR4824796,92,15,8,7,1
SBI48WHK8715630,64,20,13,7,1
SBI46LNB4482914,85,26,24,2,1
SBI23PYA8780047,99,23,16,7,1
SBI74ZFX3903748,75,25,21,4,1
SBI86ZOI5952027,75,31,22,9,1
SBI99DLJ3034511,81,20,17,3,1
SBI29GBO0605130,24,22,19,3,1
SBI50BMB2025825,94,22,15,7,1
SBI28HWX2992339,91,18,13,5,1
SBI40KLX2387430,20,24,16,8,1
SBI14MYF3938857,71,23,16,7,1
SBI13GOY6613914,69,19,11,8,1
SBI28TKA4775331,89,26,16,10,1
SBI28HGR7802657,60,28,22,6,1
SBI35UVB8380470,86,22,13,9,1
SBI33AWU3556055,89,24,14,10,1
SBI95PIE1287962,99,28,26,2,1
SBI21FMM5248204,94,28,27,1,1
SBI95JMO7196684,87,27,20,7,1
SBI41UWI0577516,19,26,14,12,1
SBI12DEK0973003,99,22,13,9,1
SBI03DVT3761206,19,21,12,9,1
SBI30RGO4056187,74,24,13,11,1
SBI07OAM8300878,23,29,26,3,1
SBI00ZNO1513651,23,36,24,12,1
SBI80LPE1397741,78,18,11,7,1
SBI85LDR0619673,23,26,25,1,1
SBI50NNQ8038489,73,24,15,9,1
SBI23TDL9859841,86,29,25,4,1
SBI75IUZ2654937,22,28,24,4,1
SBI70UMT8989234,99,22,20,2,1
SBI15NLL4670196,22,28,17,11,1
SBI15HDM1011424,88,26,19,7,1
SBI31MFB8155325,22,32,23,9,1
SBI97LFH0716104,75,17,14,3,1
SBI83QCH9951415,23,26,17,9,1
SBI32WUB0558180,77,17,13,4,1
SBI35NKH9066176,88,14,13,1,1
SBI35QJP1404768,63,22,20,2,1
SBI95MNT6533886,24,27,14,13,1
SBI54NVT0396821,67,24,23,1,1
SBI56NJG3625465,88,33,17,16,1
SBI22YGY2233996,88,20,17,3,1
SBI51DMO6317570,74,29,22,7,1
SBI76ODL7472879,77,22,19,3,1
SBI28VIM5771534,79,31,23,8,1
SBI74GQF0428808,69,17,12,5,1
SBI46RAP6964834,24,24,22,2,1
SBI36DZJ0489006,72,30,16,14,1
SBI90WMA5264628,86,30,19,11,1
SBI12OOP4129841,22,23,17,6,1
SBI42NPU8126952,62,24,22,2,1
SBI31EUE4817538,19,28,16,12,1
SBI04QHD6482972,25,21,12,9,1
SBI80XCM4480153,83,17,9,8,1
SBI30ATY5860785,70,30,26,4,1
SBI87KMQ4088065,74,24,16,8,1
SBI48DYX7876365,86,24,18,6,1
SBI28PDD8266735,76,23,20,3,1
SBI68MEV1602070,22,15,14,1,1
SBI75DNW7183690,65,30,29,1,1
SBI36KSS0661505,72,21,19,2,1
SBI59AYJ8095043,94,23,18,5,1
SBI55FIG0271826,99,28,26,2,1
SBI78XZP7961835,73,24,14,10,1
SBI76DKP4049793,22,25,24,1,1
SBI09GPX9051967,86,25,23,2,1
SBI02USF1579840,96,29,17,12,1
SBI79NRF5073484,90,29,22,7,1
SBI70DOA7568634,67,24,19,5,1
SBI14WYX9180753,89,27,20,7,1
SBI49STJ2968595,91,28,20,8,1
SBI37ULW4653883,65,21,11,10,1
SBI49CES7286486,82,23,16,7,1
SBI38SKR7690902,21,24,13,11,1
SBI24JBQ9060848,68,24,22,2,1
SBI95DBY3395543,19,25,23,2,1
SBI93FVG9712615,62,31,23,8,1
SBI08QWS2833196,73,34,19,15,1
SBI10VBD7604832,69,28,21,7,1
SBI20TZU5001266,99,25,13,12,1
SBI16LVT8464025,25,34,32,2,1
SBI23YLR6301703,89,30,28,2,1
SBI93HSB5473193,80,23,16,7,1
SBI96SRC5993193,95,33,23,10,1
SBI88ENT5073411,85,21,15,6,1
SBI17KSY2765966,75,29,24,5,1
SBI25EJS6050092,21,20,14,6,1
SBI84FDR0233381,24,25,24,1,1
SBI65MOV1761997,98,42,40,2,1
SBI95MLP4329469,24,24,20,4,1
SBI15BPG5293629,84,20,13,7,1
SBI27YXL1893748,92,19,13,6,1
SBI52JXJ1391847,62,30,26,4,1
SBI04LWO2385026,20,25,19,6,1
SBI02WCC3808589,71,19,10,9,1
SBI25FVR3941181,84,20,14,6,1
SBI65UHE0343469,85,26,24,2,1
SBI20RRR0148235,96,19,17,2,1
SBI08IOW6969428,22,28,23,5,1
SBI95TBI0407156,25,27,18,9,1
SBI92AJN2374610,18,19,17,2,1
SBI48DQD1955623,99,21,20,1,1
SBI66BFI4259650,74,26,20,6,1
SBI55ALP5209127,80,26,18,8,1
SBI82ZYF1811568,76,17,16,1,1
SBI13CJZ4883270,21,17,11,6,1
SBI05HFO4809983,91,24,22,2,1
SBI24SOS0704561,61,24,23,1,1
SBI55RTN4967380,81,34,33,1,1
SBI71POY8914329,78,26,14,12,1
SBI05TQP9597804,67,31,25,6,1
SBI57YOM6222304,90,26,23,3,1
SBI54KJW2115785,80,20,15,5,1
SBI04QFO0461771,86,14,9,5,1
SBI53MGQ8834821,74,15,9,6,1
SBI90MCU5369715,98,28,25,3,1
SBI47FLH2311411,73,24,22,2,1
SBI66SBV9719772,70,24,21,3,1
SBI10YXM9119081,22,26,19,7,1
SBI23GPW6876844,60,29,16,13,1
SBI38GZV2189718,73,18,17,1,1
SBI24NFL4922945,21,27,24,3,1
SBI26RHO3101542,18,21,17,4,1
SBI06CBN8724369,98,23,16,7,1
SBI84TBJ0340188,72,27,17,10,1
SBI94SLG8928516,60,30,28,2,1
SBI36UKH1837259,61,22,14,8,1
SBI29YHD5454152,70,28,15,13,1
SBI27CAE6686273,18,25,16,9,1
SBI46EJQ2705440,25,23,18,5,1
SBI73LWV7062242,73,29,26,3,1
SBI40QKH3598282,86,23,12,11,1
SBI24XFV2850914,86,22,21,1,1
SBI06PRI7752382,62,30,26,4,1
SBI91KAZ7457150,71,18,16,2,1
SBI00UXX4243868,86,23,21,2,1
SBI75DZI0622426,60,24,17,7,1
SBI34GTK9747001,72,21,19,2,1
SBI87QVF5419081,87,15,8,7,1
SBI85WMX0981817,86,27,16,11,1
SBI15LSR7940292,81,22,21,1,1
SBI39DNM0704207,68,17,16,1,1
SBI07KGG9008380,76,29,21,8,1
SBI94TDP5553089,78,20,12,8,1
SBI64EFL6026200,82,32,29,3,1
SBI19UDW6554688,66,20,12,8,1
SBI49ZIO2161885,69,34,20,14,1
SBI67GDJ5855778,75,25,13,12,1
SBI00LPW5117351,89,18,11,7,1
SBI85JWL6420698,99,25,23,2,1
SBI29ZQM6840329,23,23,20,3,1
SBI78MYW2818097,77,25,16,9,1
SBI06MTX8912616,72,28,24,4,1
SBI00UZH5270697,19,24,19,5,1
SBI32PIM9768722,22,26,25,1,1
SBI28NOD5769865,82,20,14,6,1
SBI83FSX1593686,78,25,19,6,1
SBI84LBF9026359,71,26,22,4,1
SBI50DZF5492080,75,31,26,5,1
SBI86QZP8662074,96,18,15,3,1
SBI53AFJ6129639,65,26,15,11,1
SBI44HKF6786067,95,29,25,4,1
SBI17SPM5385624,94,30,29,1,1
SBI66GYH1431804,93,26,20,6,1
SBI72GJD2545057,94,26,14,12,1
SBI37LWQ9821020,83,31,17,14,1
SBI87XPC5146102,98,19,12,7,1
SBI91SNK3481116,78,21,12,9,1
SBI68CVT4276527,21,23,20,3,1
SBI33DQM2431273,18,8,7,1,1
SBI05WCJ8278957,24,33,18,15,1
SBI50VPF0308282,78,25,16,9,1
SBI75VUA8644875,70,13,9,4,1
SBI71MVS5641894,77,28,17,11,1
SBI83DSH8124941,93,18,13,5,1
SBI12GTZ5356728,22,16,14,2,1
SBI11QPT6857715,93,25,13,12,1
SBI11SHZ7541830,63,26,23,3,1
SBI02MDX7086719,79,27,20,7,1
SBI00DIY2020162,61,21,17,4,1
SBI33RFE5192803,75,28,23,5,1
SBI47PVE0183228,18,25,16,9,1
SBI69MMT1393697,82,23,12,11,1
SBI15LXG2412017,70,28,23,5,1
SBI04MHP2577138,77,35,31,4,1
SBI61TAV2265093,85,30,19,11,1
SBI46AKN3503630,23,25,20,5,1
SBI44PSS6427263,83,31,23,8,1
SBI88JZR6661029,80,16,11,5,1
SBI09TIZ8053390,69,25,20,5,1
SBI37UMH1528302,92,30,17,13,1
SBI80YSD5616633,79,11,8,3,1
SBI98TXX5864881,97,28,27,1,1
SBI49FPW7215126,83,25,22,3,1
SBI89BYA2051889,22,24,19,5,1
SBI25NUE3301162,98,21,12,9,1
SBI82DUJ3267348,22,18,14,4,1
SBI42JAU4002384,67,21,17,4,1
SBI11UHX8194406,89,27,20,7,1
SBI90AUJ8218683,64,24,14,10,1
SBI24VFY8928483,68,28,17,11,1
SBI74XTG0915491,72,32,23,9,1
SBI68YOP4544887,95,23,18,5,1
SBI01UUH3323617,65,28,17,11,1
SBI45ROO8744894,70,22,16,6,1
SBI61RUX2560724,89,23,20,3,1
SBI90PLI8352072,73,28,25,3,1
SBI35JIN4230993,98,23,17,6,1
SBI46AGX6013616,87,18,11,7,1
SBI01LHQ1435029,75,26,22,4,1
SBI80OCS5127462,99,22,17,5,1
SBI05WEJ6038481,80,17,14,3,1
SBI33XMO3400530,80,17,13,4,1
SBI35TCP2991454,73,16,12,4,1
SBI46VNT6983369,71,21,16,5,1
SBI78KWZ2878961,91,23,13,10,1
SBI26JHL5315848,71,23,12,11,1
SBI90YBZ9725846,91,25,23,2,1
SBI97BXM1618526,79,22,17,5,1
SBI76PUT0031646,90,23,21,2,1
SBI61FQG7504110,73,23,13,10,1
SBI91ZJU9315091,75,20,17,3,1
SBI65XBG8171251,75,30,24,6,1
SBI25GGW9982423,66,25,17,8,1
SBI33IDT8087674,94,24,19,5,1
SBI80ZDR4707713,21,24,20,4,1
SBI48MRW9058121,22,24,15,9,1
SBI76AZE7276054,87,25,15,10,1
SBI56OYB6191849,95,23,12,11,1
SBI56GVF4539735,98,20,19,1,1
SBI88MFF3041955,21,29,27,2,1
SBI19PVG6715989,88,22,20,2,1
SBI66ZBV9669959,79,31,17,14,1
SBI42AGJ0915032,71,19,14,5,1
SBI68RXP9910074,75,22,14,8,1
SBI91GEE7419682,61,33,24,9,1
SBI28CYY2011224,80,28,23,5,1
SBI22BPK7529628,19,27,25,2,1
SBI92LBV4108117,23,20,17,3,1
SBI34FAI2646633,82,25,19,6,1
SBI40TRW8584024,93,23,20,3,1
SBI56CZT0167081,67,23,21,2,1
SBI77HRY5222719,21,32,17,15,1
SBI77TMT6210693,62,23,19,4,1
SBI70TAA6801857,95,34,33,1,1
SBI82QIV2586335,70,25,22,3,1
SBI54JRA1329733,95,14,8,6,1
SBI39VZE6515013,75,18,14,4,1
SBI14KMK7439282,99,27,14,13,1
SBI06TYW3845444,94,36,32,4,1
SBI77ZWU4548963,69,21,12,9,1
SBI74WXH8424083,85,18,10,8,1
SBI72XAJ7326653,74,17,11,6,1
SBI00GPJ5286577,62,24,20,4,1
SBI47YSO1485963,66,28,16,12,1
SBI29ABQ1093740,89,26,21,5,1
SBI87LUM5643058,95,21,16,5,1
SBI70ITX1629378,69,25,16,9,1
SBI75MOM6011933,79,27,25,2,1
SBI31MXA3534241,73,24,13,11,1
SBI49LLO3096764,87,21,12,9,1
SBI59NYZ3724437,18,28,15,13,1
SBI38LDX5999085,72,26,17,9,1
SBI24LWO3787322,82,22,21,1,1
SBI90CTZ8987009,75,16,13,3,1
SBI18XRH9519362,76,12,10,2,1
SBI46FMD8609013,71,21,19,2,1
SBI66ZBV6098131,87,24,18,6,1
SBI39TRX5704651,98,25,19,6,1
SBI91KNX8543048,78,25,15,10,1
SBI52DES2691130,61,16,9,7,1
SBI16CDM1712952,76,38,24,14,1
SBI84LYM0516642,20,24,14,10,1
SBI01AXM4255753,97,22,14,8,1
SBI76XWZ7763642,21,8,6,2,1
SBI06UTK3154911,64,34,32,2,1
SBI89WMV5786126,71,22,17,5,1
SBI83DNC2755501,88,26,23,3,1
SBI36IEH4211610,60,23,12,11,1
SBI05YEY9840922,84,21,19,2,1
SBI10HRN5717846,22,20,12,8,1
SBI95DYQ8185641,87,34,26,8,1
SBI17UHG0447921,80,23,22,1,1
SBI90JVN4327537,82,23,17,6,1
SBI35LAM4759651,71,23,13,10,1
SBI83BHE7984739,95,25,13,12,1
SBI18POU8708853,64,28,23,5,1
SBI63CSN4991038,83,18,15,3,1
SBI26GAS9971587,25,28,23,5,1
SBI64ANV2726524,63,16,13,3,1
SBI35STO4079406,76,28,23,5,1
SBI46RGA5452178,87,22,13,9,1
SBI37WPW4124105,91,20,17,3,1
SBI88FIU1638415,78,23,20,3,1
SBI43YZQ7248625,91,28,17,11,1
SBI43XAB7592383,96,28,20,8,1
SBI68QHL4657010,81,21,12,9,1
SBI73DOP2296093,84,20,12,8,1
SBI09FXN2004799,86,24,14,10,1
SBI90VLQ8702713,93,23,15,8,1
SBI09FFF3705889,20,24,19,5,1
SBI62DNW4954028,62,23,18,5,1
SBI88MNH2961310,96,22,21,1,1
SBI13ZNJ1999007,79,19,13,6,1
SBI83FBY1246472,19,18,12,6,1
SBI57UNY6178463,86,25,15,10,1
SBI00SYO9468109,85,30,25,5,1
SBI32VUC3742654,73,23,16,7,1
SBI99XRV4326732,19,31,21,10,1
SBI60WFT6587515,77,25,14,11,1
SBI18IYV8156214,72,20,19,1,1
SBI32EFN7424484,89,28,25,3,1
SBI29VUK3597917,92,27,18,9,1
SBI30QKI6410158,90,20,14,6,1
SBI79QQU3440212,23,24,15,9,1
SBI37EYD8316001,64,17,10,7,1
SBI62HPU3777177,85,24,23,1,1
SBI30JPK6427629,75,34,28,6,1
SBI60VXO1924324,77,21,12,9,1
SBI68CIR9579244,65,21,13,8,1
SBI79GAL7056758,22,25,22,3,1
SBI66ZSV4044964,97,24,18,6,1
SBI02OKS4167177,77,19,15,4,1
SBI12AYV1268711,61,25,18,7,1
SBI00JID6113750,86,28,21,7,1
SBI35FWH3847010,22,26,14,12,1
SBI66ADE7717919,83,28,25,3,1
SBI24ZBE5426634,96,18,17,1,1
SBI24KMR8245838,76,19,11,8,1
SBI71YPH2332236,92,29,18,11,1
SBI93NUT2202657,98,33,25,8,1
SBI32AIU9940753,99,24,20,4,1
SBI35MEW5275581,64,30,21,9,1
SBI78QUH9830240,92,22,15,7,1
SBI64ATW8411856,19,24,17,7,1
SBI02ZER1722336,62,21,12,9,1
SBI02UTD2869981,98,28,23,5,1
SBI40PRW9906664,67,19,10,9,1
SBI04YXG0147268,79,33,30,3,1
SBI84JDJ8164944,25,33,32,1,1
SBI68LWE0426849,76,34,29,5,1
SBI36GCK0705065,87,29,16,13,1
SBI62TDZ4818445,84,27,22,5,1
SBI65WJS2634851,90,19,10,9,1
SBI92IUV0023467,64,31,18,13,1
SBI41ALP9527012,63,17,15,2,1
SBI30GXO3867794,92,17,10,7,1
SBI09PYM1028348,77,28,20,8,1
SBI69UQX4309184,91,23,22,1,1
SBI69ZMR3081494,68,28,23,5,1
SBI78KBB7886089,99,25,20,5,1
SBI48DVZ6958034,94,27,26,1,1
SBI65FZK9968964,77,28,18,10,1
SBI19THO0801513,97,31,22,9,1
SBI57VVZ7528254,89,18,11,7,1
SBI50GVI4346490,81,31,28,3,1
SBI99GQE1829802,94,24,18,6,1
SBI13MRR8003712,85,27,23,4,1
SBI76RWX4724868,23,22,12,10,1
SBI85BDD4870361,96,31,24,7,1
SBI03WUC3378611,70,33,18,15,1
SBI19QVJ4046397,24,21,13,8,1
SBI81YUH6871173,89,23,21,2,1
SBI04NAT8375810,88,33,17,16,1
SBI39CKM3916271,82,25,15,10,1
SBI93NVG5609381,25,28,17,11,1
SBI86FKZ9276450,78,25,14,11,1
SBI96XAB9884974,70,22,20,2,1
SBI15HBM8673325,79,25,19,6,1
SBI49ZJD0493137,19,31,16,15,1
SBI55ADO7457000,25,24,23,1,1
SBI91AZV1706435,87,24,23,1,1
SBI62YDU1080482,86,12,8,4,1
SBI46VLM7772962,65,28,22,6,1
SBI64ZRE0983804,75,16,9,7,1
SBI38CIA9456934,23,21,13,8,1
SBI02RRE2933173,88,37,26,11,1
SBI38DZL0531529,99,20,13,7,1
SBI69OSP9428248,19,31,24,7,1
SBI33EDN5541081,92,32,20,12,1
SBI38WNB7666739,70,26,14,12,1
SBI82HXO6244209,61,21,20,1,1
SBI29CHJ1549297,75,28,15,13,1
SBI32UDW0455718,19,25,20,5,1
SBI14GRQ1999483,97,24,16,8,1
SBI61ZDK2640414,89,26,18,8,1
SBI62GKW7021532,61,22,12,10,1
SBI31LXJ7427761,62,21,15,6,1
SBI26LEM3459542,97,25,22,3,1
SBI00LQU4104134,64,28,17,11,1
SBI00PXF5124094,86,25,14,11,1
SBI14JIP2818549,97,18,14,4,1
SBI70OMM7391941,22,17,12,5,1
SBI10WIQ0352301,67,24,16,8,1
SBI69ZXP2212118,19,26,19,7,1
SBI16SAU8579459,87,24,14,10,1
SBI19LYO0481038,87,18,15,3,1
SBI76VSQ0173728,92,27,24,3,1
SBI44SEL5074984,86,19,12,7,1
SBI29PKN3048796,71,25,21,4,1
SBI92TCO3737997,21,34,19,15,1
SBI56AEV5971601,86,32,25,7,1
SBI33OIJ8090858,89,33,20,13,1
SBI79ZGV3170174,78,33,31,2,1
SBI94HGP7589208,87,26,15,11,1
SBI24QNX2815788,90,26,15,11,1
SBI44VHH4358282,72,18,17,1,1
SBI82QKV7354701,67,29,16,13,1
SBI35ZFW1589404,84,34,23,11,1
SBI60URM3208645,92,19,10,9,1
SBI36QFE1718043,92,21,12,9,1
SBI74REK1510419,73,27,21,6,1
SBI70GHO5180385,97,23,17,6,1
SBI24JNH7901222,22,23,21,2,1
SBI07PCB8080660,67,25,22,3,1
SBI13PYY5183033,72,28,21,7,1
SBI72RKW0604892,76,23,19,4,1
SBI51HZX1884540,84,33,28,5,1
SBI82UFO3388764,76,23,17,6,1
SBI70ERU3337258,63,19,18,1,1
SBI85UUO4864201,95,26,21,5,1
SBI30TRA7882706,61,27,17,10,1
SBI23GDX6796399,72,25,22,3,1
SBI37ZTH1357120,62,31,28,3,1
SBI03NRY3958971,81,23,12,11,1
SBI18HIY2845449,69,31,21,10,1
SBI10STR2945836,72,19,12,7,1
SBI10FUQ6624397,61,24,22,2,1
SBI46IVE4895244,76,18,17,1,1
SBI44BRY6216339,18,27,22,5,1
SBI30TOD2021603,67,14,9,5,1
SBI97MBI4194825,18,18,16,2,1
SBI06FHE0387750,82,24,21,3,1
SBI94LUQ2701375,67,26,25,1,1
SBI23LTK8228254,87,28,18,10,1
SBI65EYX2272684,93,23,15,8,1
SBI04FLZ7600284,60,33,32,1,1
SBI16MGX1208440,82,42,30,12,1
SBI13SSB3963290,60,17,11,6,1
SBI42YCL4869572,97,19,10,9,1
SBI88NMQ3935319,23,31,22,9,1
SBI99UYC6386562,80,19,11,8,1
SBI38TCD0028099,75,30,16,14,1
SBI84SZB4121935,96,27,19,8,1
SBI52GWP5640277,60,20,16,4,1
SBI29IYQ0931158,20,25,19,6,1
SBI30JBQ4039338,70,30,20,10,1
SBI90OPD2224646,67,30,18,12,1
SBI93TUP3264012,82,24,13,11,1
SBI88HQM4514554,91,26,14,12,1
SBI79VDC3261448,19,21,14,7,1
SBI71ZOT1535812,95,23,17,6,1
SBI04KYW0714339,78,25,21,4,1
SBI06DDK5292885,19,32,18,14,1
SBI50TAH7601050,60,27,16,11,1
SBI88UQD7021284,64,23,17,6,1
SBI62XAG0838614,81,27,25,2,1
SBI50YJP0555329,61,20,14,6,1
SBI32COV0543151,65,29,17,12,1
SBI20PQF0201517,90,18,17,1,1
SBI05EIP1648059,99,23,14,9,1
SBI01MYQ9841242,81,31,22,9,1
SBI88SSF9435695,23,20,15,5,1
SBI82THD0584927,22,15,12,3,1
SBI51VJQ0398760,72,25,13,12,1
SBI72SAS9009110,68,23,15,8,1
SBI95JKA7535556,23,28,27,1,1
SBI21WIV4319318,90,19,12,7,1
SBI44RND6409989,80,18,17,1,1
SBI70JLY6897992,91,22,13,9,1
SBI43RGW2272769,25,26,23,3,1
SBI65UCR7611619,65,22,18,4,1
SBI00GCX7228933,20,23,18,5,1
SBI81YLG2726428,79,19,15,4,1
SBI23UWN0806647,84,26,20,6,1
SBI32DLC3103865,24,22,12,10,1
SBI78ORL1455373,91,30,29,1,1
SBI23NKG2935445,97,27,21,6,1
SBI93KDF8633794,80,19,11,8,1
SBI21WLC3669677,24,22,14,8,1
SBI23GYJ8891863,96,17,10,7,1
SBI45QQM5671002,89,23,19,4,1
SBI07YDM5563162,88,18,10,8,1
SBI40OXD6375438,81,29,18,11,1
SBI20NYK9263923,77,9,6,3,1
SBI94LKL0807705,88,35,21,14,1
SBI69MRH2256605,62,31,26,5,1
SBI08YPP5796411,97,15,8,7,1
SBI28KNZ6014937,60,29,15,14,1
SBI07TKX3758277,88,28,15,13,1
SBI98TXI8930485,69,23,18,5,1
SBI48KED1750688,70,20,11,9,1
SBI92PJZ1967050,72,18,10,8,1
SBI37YET6233092,75,23,14,9,1
SBI44DAZ5750347,64,37,34,3,1
SBI23CWZ8029237,68,20,19,1,1
SBI86OAC9742875,95,15,13,2,1
SBI63IVA6072502,96,29,19,10,1
SBI83IIN6913415,95,20,14,6,1
SBI60YAO0219721,85,20,14,6,1
SBI50GIT4468447,69,23,15,8,1
SBI12SIF2289784,85,17,11,6,1
SBI58TKW5101699,83,22,19,3,1
SBI40NAF9565566,63,30,19,11,1
SBI71INL5472410,94,23,22,1,1
SBI56MZK0412229,72,23,12,11,1
SBI44VYP4080666,86,22,18,4,1
SBI64ADV1882368,67,18,12,6,1
SBI87POW3465405,23,33,32,1,1
SBI03KSI4081002,85,22,17,5,1
SBI33VHG9810988,90,17,13,4,1
SBI05JHH1043120,80,23,21,2,1
SBI21YPO1693042,78,33,26,7,1
SBI70UZN0822870,81,26,20,6,1
SBI04CQL7473064,22,28,18,10,1
SBI67VLD2639367,67,28,23,5,1
SBI72GUR6515182,88,23,18,5,1
SBI80LMR6665869,92,28,26,2,1
SBI91TLM8606302,19,24,18,6,1
SBI05GDL2692775,88,34,25,9,1
SBI37TIM2616054,83,35,30,5,1
SBI39XUJ5897153,99,25,19,6,1
SBI36TUF1545842,63,29,27,2,1
SBI54JET7971474,88,28,27,1,1
SBI55GBC2492657,63,24,21,3,1
SBI49CAD8712752,65,24,13,11,1
SBI41QOM4801159,74,17,16,1,1
SBI86BMJ2820869,63,20,12,8,1
SBI65CPN3071442,77,25,15,10,1
SBI18LZA7643516,79,39,30,9,1
SBI19YXK1233623,61,29,25,4,1
SBI16TTR3908170,86,26,18,8,1
SBI67NGD6174484,66,27,26,1,1
SBI76OZJ6455629,97,32,28,4,1
SBI70NEE5400306,77,24,23,1,1
SBI15VXS8714412,91,37,21,16,1
SBI38PPR1324340,18,32,22,10,1
SBI58JPJ1647364,89,35,24,11,1
SBI08SXG8167825,77,24,14,10,1
SBI57ZHK6449715,61,27,26,1,1
SBI19JME0695356,97,25,23,2,1
SBI88FFQ6479915,81,26,20,6,1
SBI68BRJ1942582,79,27,16,11,1
SBI24LKJ1949936,87,25,17,8,1
SBI93XZW0997113,92,27,24,3,1
SBI31ZDF6339239,85,22,14,8,1
SBI97CUY5085954,19,27,20,7,1
SBI44IDB6978131,20,23,22,1,1
SBI29CVN5213579,69,33,19,14,1
SBI25FUJ1251103,88,22,20,2,1
SBI13WUX2295833,61,27,22,5,1
SBI02QFK3221325,98,19,14,5,1
SBI07ZEO7018951,86,20,11,9,1
SBI43FMN3880399,94,23,21,2,1
SBI85VPI1809391,22,32,18,14,1
SBI33DSG6608408,76,25,13,12,1
SBI90XSU7777600,77,9,7,2,1
SBI33PAF2136671,67,27,23,4,1
SBI54WSQ5262770,25,31,22,9,1
SBI27KQE5596395,86,26,17,9,1
SBI82FZN7342645,75,22,20,2,1
SBI06BBH1434293,22,18,10,8,1
SBI47VHV8913428,91,24,19,5,1
SBI40PEC0764189,88,14,10,4,1
SBI50HHZ0888961,63,14,10,4,1
SBI95GJV1327927,20,25,24,1,1
SBI82PYX6127122,97,20,12,8,1
SBI71NQP6664546,81,25,14,11,1
SBI36ZLK6782676,77,23,17,6,1
SBI21GYO5908702,84,25,13,12,1
SBI41ZFB0405141,22,19,18,1,1
SBI19FBQ4257947,70,22,15,7,1
SBI98JXT7189207,22,19,16,3,1
SBI05XKE5827510,90,21,12,9,1
SBI66KXN7169648,87,30,23,7,1
SBI92MBV2513754,98,24,19,5,1
SBI78DKV3781756,90,26,23,3,1
SBI14ZRU0546387,18,28,20,8,1
SBI03ZJC8709102,86,28,24,4,1
SBI75VJF8763080,87,25,18,7,1
SBI82UOX7532778,60,32,25,7,1
SBI05GNR7487587,18,26,21,5,1
SBI33WRT0246567,98,15,12,3,1
SBI14NWU6223768,25,28,16,12,1
SBI71AOZ5561902,78,22,14,8,1
SBI99NTH9103461,65,35,19,16,1
SBI51UNX1640468,18,32,17,15,1
SBI86HAV6448475,95,23,13,10,1
SBI66AMC9062053,78,29,25,4,1
SBI05XWZ3768819,75,21,19,2,1
SBI36REU4611673,20,36,27,9,1
SBI61XZU4128961,21,17,16,1,1
SBI65TFR4611787,74,26,16,10,1
SBI66KHV0206176,66,23,13,10,1
SBI66NLY4440738,96,23,22,1,1
SBI70GLM0335671,71,28,20,8,1
SBI66IXL3543307,72,18,10,8,1
SBI29DTY9685137,19,21,20,1,1
SBI75FRH6262220,74,30,22,8,1
SBI37PZK5244634,96,24,20,4,1
SBI31LEH5611543,91,31,23,8,1
SBI35IVF8720880,97,22,13,9,1
SBI46NQJ7871746,62,25,19,6,1
SBI31XFF0516192,93,31,18,13,1
SBI70YQD1763800,24,26,21,5,1
SBI39SRX3332642,80,27,16,11,1
SBI80DAR1728764,70,22,18,4,1
SBI30QHB3700989,92,21,14,7,1
SBI31VKW8198605,65,26,25,1,1
SBI75ETM7941357,77,37,28,9,1
SBI94SSA9370214,87,22,15,7,1
SBI74NAT6671565,88,25,15,10,1
SBI00ZEW0998741,86,23,14,9,1
SBI48RET1359611,92,26,19,7,1
SBI19BMA9225529,75,29,23,6,1
SBI14PRK8211905,22,20,13,7,1
SBI85BVU4686643,62,30,18,12,1
SBI05LUX9962018,22,29,27,2,1
SBI56AXG9287180,80,28,17,11,1
SBI95JYR0262201,61,37,22,15,1
SBI70XGA6993677,82,29,17,12,1
SBI19LIS3157312,61,31,16,15,1
SBI80BGB9409024,82,31,29,2,1
SBI08JVV1681024,77,27,16,11,1
SBI96ZSR0417375,91,17,16,1,1
SBI02FSM1560353,62,26,14,12,1
SBI61XGA1927516,18,32,29,3,1
SBI17DHV4330059,97,19,17,2,1
SBI56GNI6463271,92,21,14,7,1
SBI74RNP1329604,79,22,15,7,1
SBI51ACE7642484,76,20,14,6,1
SBI12YBJ9794904,19,25,23,2,1
SBI55NNG6649759,91,19,15,4,1
SBI90ETZ5914745,82,28,17,11,1
SBI74GWX3977482,70,22,19,3,1
SBI21NEG5901748,73,17,13,4,1
SBI32UXU0165379,74,21,19,2,1
SBI68STZ9788793,84,26,18,8,1
SBI49EKN1727554,67,25,24,1,1
SBI39ONC3207648,71,25,17,8,1
SBI08PAN1032779,90,29,23,6,1
SBI51VDI1251183,24,30,24,6,1
SBI32NXR3545996,89,20,14,6,1
SBI71VFX5377109,66,22,14,8,1
SBI64QZM7640650,23,27,18,9,1
SBI53IGQ3215046,91,19,16,3,1
SBI60ZLX5228684,89,29,25,4,1
SBI08MNM9490934,92,20,19,1,1
SBI75ZTB6700348,70,32,17,15,1
SBI42VIP5357897,18,25,20,5,1
SBI03ZGN0118194,20,29,27,2,1
SBI88GGY0814950,99,26,14,12,1
SBI06FQL2038495,93,19,10,9,1
SBI95JNZ2573920,74,18,17,1,1
SBI10PUM7876394,78,20,15,5,1
SBI55ZRI4336784,75,24,19,5,1
SBI35NKO9410848,96,18,14,4,1
SBI22LOW0526748,90,19,16,3,1
SBI00ELR6368851,84,23,16,7,1
SBI66DAX3495523,24,27,19,8,1
SBI83VHF3242526,64,27,23,4,1
SBI80CXV3457856,72,24,18,6,1
SBI89IEG5865103,75,27,14,13,1
SBI65XDO0252726,75,27,17,10,1
SBI85WII7290144,71,34,23,11,1
SBI16DEH7465944,70,24,14,10,1
SBI90TYN3172481,74,20,11,9,1
SBI72XTE1548703,99,19,17,2,1
SBI28JLH0110050,62,27,15,12,1
SBI05YAX7052620,87,23,19,4,1
SBI45DUU7560424,74,20,16,4,1
SBI22DIT3777835,69,19,13,6,1
SBI82PXX1951009,84,20,18,2,1
SBI03GDC7691658,70,15,13,2,1
SBI96GKT5814219,83,21,11,10,1
SBI58TUJ4159762,75,26,15,11,1
SBI82AAN7937862,82,24,15,9,1
SBI16INK4125050,79,23,22,1,1
SBI12RCE3705935,78,25,24,1,1
SBI47RCX0193668,96,30,19,11,1
SBI28EQY8337915,19,26,23,3,1
SBI68UVY6696209,22,21,17,4,1
SBI76LFP4066763,74,34,26,8,1
SBI19UPO6136706,97,35,28,7,1
SBI60KJV7693951,72,25,23,2,1
SBI55LIV4754488,99,31,24,7,1
SBI09TNP9184797,82,26,19,7,1
SBI40IMT9748720,76,22,16,6,1
SBI90EYT5604858,95,30,21,9,1
SBI46JQB7078861,78,31,16,15,1
SBI06XRY8787756,73,25,20,5,1
SBI08CPH9808943,91,26,14,12,1
SBI30THD4061352,78,28,25,3,1
SBI37SUH9712417,64,27,21,6,1
SBI62LRM3419235,85,19,11,8,1
SBI78KHO7506560,76,26,24,2,1
SBI74GPR9638478,97,28,23,5,1
SBI12NCB1812178,21,29,22,7,1
SBI98KKB3406339,22,27,15,12,1
SBI76MQS5686843,73,24,19,5,1
SBI49WZP0375006,88,26,20,6,1
SBI83NGL7235866,92,25,21,4,1
SBI06DQP4219457,89,22,17,5,1
SBI88BAV8063542,71,21,13,8,1
SBI06YQS2239360,62,30,27,3,1
SBI31SRC6202013,18,29,19,10,1
SBI52ONY8761309,70,27,20,7,1
SBI08GSZ4152349,92,24,17,7,1
SBI54KGQ6351207,83,24,16,8,1
SBI73TTA6086497,21,15,11,4,1
SBI27SIN8816437,83,35,21,14,1
SBI96ZPG7418278,98,25,19,6,1
SBI17SMW9819911,61,27,15,12,1
SBI68QJR6827634,69,19,13,6,1
SBI33LWV8507712,19,25,13,12,1
SBI06IKC4127232,25,20,18,2,1
SBI96NNL1299094,91,20,11,9,1
SBI56FKJ4859528,87,18,11,7,1
SBI56YCG8259535,62,22,15,7,1
SBI37YPV6887938,93,25,13,12,1
SBI86YAT4764778,68,32,25,7,1
SBI94VCI2298148,82,14,11,3,1
SBI47UYA4547904,88,18,10,8,1
SBI79NWA9826105,25,23,13,10,1
SBI74BEQ5828019,23,31,21,10,1
SBI18ZTS0649268,72,21,20,1,1
SBI44RZG2914420,18,26,15,11,1
SBI06YJF4264721,65,26,22,4,1
SBI82JQJ5325159,66,25,19,6,1
SBI52IPE9019280,21,28,21,7,1
SBI20WYO0883595,73,27,23,4,1
SBI61GKD2241902,64,16,10,6,1
SBI29LUR8224114,91,18,13,5,1
SBI93ROB4560735,78,15,10,5,1
SBI90NJS0068520,73,21,15,6,1
SBI75WDE4296213,63,26,14,12,1
SBI10WLV7574577,67,31,19,12,1
SBI33NMI1882005,78,27,15,12,1
SBI59SCT6713669,92,31,19,12,1
SBI88THT2616466,21,27,14,13,1
SBI63FMT1949277,86,25,13,12,1
SBI91SKC7513892,81,22,21,1,1
SBI82GFN7967943,22,35,29,6,1
SBI11VOP1857943,69,29,17,12,1
SBI98VWL4821300,22,22,15,7,1
SBI36VVB9000725,84,28,25,3,1
SBI36AFS0169239,66,29,23,6,1
SBI96KFK1636242,85,20,11,9,1
SBI22SDP9754794,96,33,23,10,1
SBI81WWR9981752,93,21,19,2,1
SBI47KMX1187272,25,21,11,10,1
SBI37RWC2582680,23,29,22,7,1
SBI06YXS9104698,76,23,19,4,1
SBI29HUS6455852,69,23,19,4,1
SBI63XMZ2146346,68,24,17,7,1
SBI42AVQ6621151,22,29,27,2,1
SBI17TCM8787158,77,27,23,4,1
SBI40CHR6444941,22,17,9,8,1
SBI45UBP8210657,99,15,8,7,1
SBI74AXV7962410,82,30,24,6,1
SBI20HXK9528609,99,21,13,8,1
SBI02MNU0719815,60,28,16,12,1
SBI07EUQ9615530,97,22,17,5,1
SBI05ADS2705225,73,19,15,4,1
SBI62LIB5613855,66,31,16,15,1
SBI78JOL5120156,78,25,19,6,1
SBI40SIZ4119849,71,22,19,3,1
SBI61MYK1298153,62,28,19,9,1
SBI92UJY1854439,81,20,16,4,1
SBI62STS8395559,85,16,12,4,1
SBI25MIU1687844,95,28,21,7,1
SBI42VHR9603778,92,28,23,5,1
SBI90TIS4617372,92,18,10,8,1
SBI59BOK8898669,89,27,15,12,1
SBI33KXU3200503,88,20,13,7,1
SBI25PHK6252807,70,20,13,7,1
SBI60GAQ9117739,83,23,17,6,1
SBI36TLR2559684,22,24,22,2,1
SBI26GFP5781240,93,17,15,2,1
SBI52GOR3873096,24,24,18,6,1
SBI14OQG2322774,90,22,15,7,1
SBI71DFB2288100,76,22,16,6,1
SBI48ISF4323933,88,16,11,5,1
SBI24ANE3938330,64,33,18,15,1
SBI96FDD3491428,19,20,18,2,1
SBI77XXB2937325,20,30,28,2,1
SBI85YBN7749590,70,27,19,8,1
SBI34LCV5731628,81,21,16,5,1
SBI41LUW1724878,63,24,21,3,1
SBI17WAK4380235,74,26,18,8,1
SBI47TMB8383173,22,23,20,3,1
SBI90YFK7468775,94,20,19,1,1
SBI71NIJ6472911,84,31,26,5,1
SBI03SBB6595376,95,16,14,2,1
SBI13TDT2020590,22,26,14,12,1
SBI60NSF8030122,25,27,26,1,1
SBI15KYG2644991,85,19,10,9,1
SBI53SHR5939614,63,29,23,6,1
SBI99IBW0701250,67,29,25,4,1
SBI64OCE7182916,21,27,24,3,1
SBI92ZTQ5646426,82,25,23,2,1
SBI32SPJ2907661,78,18,13,5,1
SBI28XET8250952,84,28,22,6,1
SBI45OMC9306856,74,21,14,7,1
SBI68DRG6487484,94,30,27,3,1
SBI46ELU0635120,18,18,13,5,1
SBI97HQS4175931,94,27,25,2,1
SBI25YVW4942869,84,18,10,8,1
SBI68QUD1499503,90,12,11,1,1
SBI29VHE5711193,85,34,31,3,1
SBI64VON8425985,69,31,16,15,1
SBI94ZRK0617140,74,27,14,13,1
SBI72UKW4178807,60,23,20,3,1
SBI53MHZ4125764,93,19,12,7,1
SBI67QSE2941928,92,33,17,16,1
SBI54VAZ9994718,83,20,11,9,1
SBI91YMS1186816,91,24,16,8,1
SBI13IKT0328090,65,15,8,7,1
SBI28VPD3521906,68,26,24,2,1
SBI08BIZ8359940,98,31,22,9,1
SBI39JER1812005,84,27,22,5,1
SBI72ZNP5282446,66,19,18,1,1
SBI95THN1118008,70,22,14,8,1
SBI99OVA3806604,20,28,22,6,1
SBI98PIZ6312355,71,27,21,6,1
SBI27AUC6589508,68,25,20,5,1
SBI64APP0072023,63,19,10,9,1
SBI46FCI5941951,72,21,16,5,1
SBI68TUJ2194018,75,21,20,1,1
SBI67UMX4846864,79,27,21,6,1
SBI06GLH7695982,91,33,31,2,1
SBI12VJU5902759,23,18,14,4,1
SBI37GWD2802303,63,26,20,6,1
SBI75AGZ4415761,88,25,22,3,1
SBI32PYM7323521,67,22,13,9,1
SBI30XFT0120330,76,23,13,10,1
SBI71UXT4454508,24,21,19,2,1
SBI12RDR5885745,65,28,25,3,1
SBI88FGS3969437,68,23,22,1,1
SBI03SRL7664095,90,33,30,3,1
SBI18KRT5269246,84,27,14,13,1
SBI31MXX9398710,23,24,21,3,1
SBI99XBK9319741,25,20,14,6,1
SBI69EOU1104226,87,23,21,2,1
SBI75KMR3953260,63,24,21,3,1
SBI47ZMX2366642,62,29,25,4,1
SBI45VAZ4699210,81,27,19,8,1
SBI20EHM4057252,70,32,28,4,1
SBI11CBA0052248,76,17,16,1,1
SBI03NOH8476542,98,25,21,4,1
SBI17RIY1405574,20,26,19,7,1
SBI94ORM1219697,64,30,28,2,1
SBI53LPN3923724,66,21,13,8,1
SBI80BME3638324,23,22,14,8,1
SBI99KQV7347205,67,22,19,3,1
SBI94FES1609269,92,21,14,7,1
SBI22SZK7852993,63,34,28,6,1
SBI59PQU5169435,93,23,22,1,1
SBI70KYQ9390079,66,28,17,11,1
SBI25BDQ6663084,78,29,18,11,1
SBI80NNP4480711,94,28,26,2,1
SBI26ZPR7446417,77,25,17,8,1
SBI12LXX1477695,95,27,21,6,1
SBI07GZA3150445,91,15,12,3,1
SBI76PPP3223968,90,19,13,6,1
SBI74FJX5738811,74,27,24,3,1
SBI78BAQ1214078,94,22,14,8,1
SBI42TSM3435395,19,27,25,2,1
SBI39PTM0503451,71,30,24,6,1
SBI77HZB6092354,72,17,14,3,1
SBI57BOO4255480,86,24,13,11,1
SBI17PAW0470788,63,26,16,10,1
SBI91NYC0631643,72,26,21,5,1
SBI16VIA2620250,92,21,18,3,1
SBI55YYS1708250,94,20,18,2,1
SBI15QAG4386770,95,27,26,1,1
SBI07FPT7165564,84,27,24,3,1
SBI95OUU1058990,95,22,13,9,1
SBI05MAO8623465,22,41,21,20,1
SBI29SLQ7283510,66,21,18,3,1
SBI28PHT5091630,22,25,19,6,1
SBI12KQL7088811,20,11,7,4,1
SBI32XRO6178787,75,20,18,2,1
SBI96VXI3790490,88,31,19,12,1
SBI47XWW8889433,74,25,18,7,1
SBI57NSQ5999243,84,20,16,4,1
SBI14VJR3661544,65,25,19,6,1
SBI55AMW7110988,22,25,14,11,1
SBI73NEL9686852,66,19,11,8,1
SBI31BAZ3821190,67,24,21,3,1
SBI24ENW6344178,92,27,17,10,1
SBI72JFG5309955,19,28,16,12,1
SBI90VND7105350,69,19,11,8,1
SBI30NNA5698293,95,20,17,3,1
SBI82JDJ7010068,81,24,17,7,1
SBI96KLT3706384,88,25,13,12,1
SBI00TQO2364681,73,20,19,1,1
SBI04CHZ5323141,87,23,13,10,1
SBI54HTT9933129,70,33,20,13,1
SBI71BFA3456973,64,30,26,4,1
SBI84OOG3285982,66,28,19,9,1
SBI32ICO6523123,98,26,21,5,1
SBI14KCJ5193969,63,16,12,4,1
SBI56UCH5965578,78,42,32,10,1
SBI84UPA7594980,21,22,17,5,1
SBI77YII4135984,66,17,9,8,1
SBI83PXF7735524,96,23,19,4,1
SBI76FEE0123768,69,21,15,6,1
SBI24XSW2998472,87,28,23,5,1
SBI69ZYQ2716847,97,24,21,3,1
SBI26GII5809455,18,23,19,4,1
SBI63ANT2096864,90,24,22,2,1
SBI72HCL9237414,70,31,18,13,1
SBI92ZBK4942744,99,22,13,9,1
SBI12NUB2255763,76,24,20,4,1
SBI46LVS0338186,21,14,10,4,1
SBI63HHS0285360,61,27,20,7,1
SBI46SPP7888195,71,27,17,10,1
SBI43IDS7631272,66,26,18,8,1
SBI96SVY9698142,86,23,17,6,1
SBI64WXM8770258,93,15,11,4,1
SBI53FKX4100578,91,26,21,5,1
SBI98XWA3683002,73,26,21,5,1
SBI81YXJ5726492,20,22,17,5,1
SBI12ZGW2396798,87,22,21,1,1
SBI99UDF9672351,74,22,20,2,1
SBI38BIF1857230,89,23,17,6,1
SBI56IMI4364713,67,25,14,11,1
SBI74PRB6554697,99,18,13,5,1
SBI35PBY1774094,92,21,18,3,1
SBI51XWK0374091,82,21,20,1,1
SBI01TFI3473969,89,23,14,9,1
SBI95ZJH3992596,68,35,34,1,1
SBI99DYI1323743,63,26,16,10,1
SBI22SWY2849151,76,31,18,13,1
SBI71SIY1681391,88,25,14,11,1
SBI88SXE7578550,63,25,23,2,1
SBI12CKO1307185,20,22,20,2,1
SBI78TCN2569973,85,26,16,10,1
SBI89PYJ7271256,98,32,27,5,1
SBI41WIX7320458,96,15,8,7,1
SBI20MEA6102899,89,19,11,8,1
SBI54QVA8728366,95,20,11,9,1
SBI64EWY4220815,82,16,13,3,1
SBI24ICQ8097700,82,28,24,4,1
SBI69SSU4194596,70,23,21,2,1
SBI39YJG1612733,77,27,14,13,1
SBI53QZC4586830,82,24,17,7,1
SBI16IRV6634104,72,18,15,3,1
SBI53CFN4287801,70,26,15,11,1
SBI88VPC2911185,60,33,28,5,1
SBI72KVJ7053574,64,24,16,8,1
SBI08GSQ6367333,76,14,8,6,1
SBI97SUR7563555,62,24,21,3,1
SBI80OGR7111901,83,25,20,5,1
SBI77NNX1756094,60,26,18,8,1
SBI83NOD0090109,69,29,20,9,1
SBI80TZM6056278,89,27,20,7,1
SBI53YEJ4239983,92,24,20,4,1
SBI67ZKE3679119,91,15,13,2,1
SBI39MVB6378384,60,29,16,13,1
SBI88QLA1795439,69,23,13,10,1
SBI79UYQ4382833,97,18,16,2,1
SBI91QJN7039863,82,34,20,14,1
SBI46OUZ8701002,71,31,17,14,1
SBI89STW3691698,63,20,12,8,1
SBI02APP3709019,66,31,28,3,1
SBI07VBA6990242,70,22,12,10,1
SBI88BZB6418979,88,25,24,1,1
SBI96AGC1804560,93,27,17,10,1
SBI39QBF2654684,74,21,14,7,1
SBI10IFP7160986,78,24,23,1,1
SBI54EBR9433417,88,29,20,9,1
SBI35ENG6665313,97,16,14,2,1
SBI88DAD7131298,64,24,20,4,1
SBI87XYQ5686682,86,27,18,9,1
SBI66LOE0294876,90,26,22,4,1
SBI42UBH0673223,62,32,28,4,1
SBI06JGQ8989240,21,26,19,7,1
SBI61LSQ1952735,83,25,22,3,1
SBI83PIF3454996,92,25,14,11,1
SBI52KQE0182784,72,23,12,11,1
SBI39IBU6388445,91,18,16,2,1
SBI57RRX7011470,76,23,16,7,1
SBI53HJI2737612,76,29,20,9,1
SBI99JLD8122655,81,27,23,4,1
SBI45WVD2124749,94,26,16,10,1
SBI81YQT0471135,69,24,19,5,1
SBI29UFH8138435,92,24,23,1,1
SBI39SWB7187792,20,24,23,1,1
SBI74EJF7942772,98,26,23,3,1
SBI52ZMT7916568,72,21,15,6,1
SBI82WBB9985088,95,27,15,12,1
SBI73VWD6816735,72,24,20,4,1
SBI65EJX7409022,62,27,23,4,1
SBI43YIT4594815,73,19,10,9,1
SBI55GIM5099437,79,17,14,3,1
SBI66TNS4777701,86,22,15,7,1
SBI45CIE6670754,75,31,30,1,1
SBI58EUH0765554,95,26,14,12,1
SBI89BBK9758863,76,24,15,9,1
SBI90BOY1117174,92,21,15,6,1
SBI87EHH8384963,77,22,20,2,1
SBI14FJQ0250437,69,24,16,8,1
SBI64PYK4851282,97,29,23,6,1
SBI30TVY4990505,90,15,8,7,1
SBI38PQA2666781,95,22,21,1,1
SBI37AOE4630649,83,26,22,4,1
SBI83CFR7769285,91,22,20,2,1
SBI92GII3639364,67,19,11,8,1
SBI23QNV6913393,73,26,25,1,1
SBI22UTG6201226,18,18,17,1,1
SBI97GAJ0935233,70,30,17,13,1
SBI69SRW0913450,24,24,19,5,1
SBI13JLI9770406,72,25,19,6,1
SBI00JLR7915600,73,17,14,3,1
SBI50KKT2932191,98,22,16,6,1
SBI30TBS4789059,68,26,25,1,1
SBI83WTN4738343,90,20,19,1,1
SBI41SDI0324030,99,25,19,6,1
SBI14GIE5907700,91,26,16,10,1
SBI42SAD6678931,65,30,16,14,1
SBI93TZZ1788740,20,25,13,12,1
SBI36PHN8777177,77,24,19,5,1
SBI18OWY6842097,91,16,13,3,1
SBI03MOF7660603,62,23,19,4,1
SBI47XAQ0897747,89,26,18,8,1
SBI16FNL7632675,82,31,21,10,1
SBI16SMZ2449203,19,21,12,9,1
SBI27JRR2740881,71,17,9,8,1
SBI50MRR5454167,18,24,22,2,1
SBI93ARB2028265,81,26,21,5,1
SBI64GKE3415387,83,18,16,2,1
SBI34TWJ3103169,24,23,12,11,1
SBI08PRP1771116,97,26,19,7,1
SBI87OJR8215278,95,21,19,2,1
SBI19PWW5352955,25,25,17,8,1
SBI04MSI3373836,90,26,19,7,1
SBI87ZCT9762192,88,31,18,13,1
SBI00EDK0090264,19,26,14,12,1
SBI36CQG4833035,96,18,12,6,1
SBI12CNA9058046,72,24,15,9,1
SBI50RYH8908514,85,21,13,8,1
SBI73BTP6618123,90,20,18,2,1
SBI24TRN9062153,25,24,17,7,1
SBI01HXG8986977,91,26,14,12,1
SBI35WQX5700441,75,22,19,3,1
SBI15IZD0390647,68,19,16,3,1
SBI49OWD1161795,85,27,23,4,1
SBI27AHH3914940,71,22,19,3,1
SBI18PKL1956137,72,29,18,11,1
SBI56JKN6968380,86,28,22,6,1
SBI09YKO7047237,64,24,16,8,1
SBI95AKE1184674,64,26,22,4,1
SBI77XWM4179336,76,23,13,10,1
SBI76KGV9437248,88,29,20,9,1
SBI13BGH1084814,25,13,7,6,1
SBI23DEN5090074,97,32,19,13,1
SBI69YKN1910797,66,16,14,2,1
SBI11QHT6718196,78,25,20,5,1
SBI93NNP0325590,91,32,26,6,1
SBI52LJA8826457,60,25,24,1,1
SBI77PDE1294054,97,32,23,9,1
SBI71FZG5466833,20,22,14,8,1
SBI98CPI7836510,80,27,16,11,1
SBI23HRL3733600,63,19,18,1,1
SBI02YTT1674769,98,35,27,8,1
SBI41GOS4851746,65,19,18,1,1
SBI36VGH0453319,24,27,19,8,1
SBI93GNW9499949,92,26,14,12,1
SBI15KMF4654197,86,26,23,3,1
SBI16YAK1085692,24,21,11,10,1
SBI51NJE6705700,73,25,14,11,1
SBI89WCK0028399,70,28,20,8,1
SBI23LAR0470536,66,17,10,7,1
SBI01MHH7868128,67,30,21,9,1
SBI63HBN1811146,70,24,17,7,1
SBI42YUC5110783,99,24,22,2,1
SBI61XJK2883320,68,21,12,9,1
SBI80PVB7945135,21,36,23,13,1
SBI44BJE1584480,18,18,15,3,1
SBI88UDM3359622,94,27,20,7,1
SBI75PJG0895209,88,18,17,1,1
SBI30QHO4057890,72,18,16,2,1
SBI75UHW1234573,66,18,16,2,1
SBI11CQK9173583,78,26,24,2,1
SBI90ABM1337537,87,22,21,1,1
SBI96FEB2271783,74,31,16,15,1
SBI95KOJ4878015,69,24,14,10,1
SBI70JOK4363532,78,18,11,7,1
SBI05EWG8465544,85,25,17,8,1
SBI55WJV1141992,25,15,13,2,1
SBI84RTK6091897,19,29,26,3,1
SBI91VWP4674811,85,27,17,10,1
SBI10UEU0245535,22,17,11,6,1
SBI35VSU1310667,25,14,12,2,1
SBI52PDN6509527,94,21,11,10,1
SBI67TAR1034230,73,32,23,9,1
SBI70NSR6495749,81,27,23,4,1
SBI02AWM1640527,84,33,17,16,1
SBI50FMD7040327,76,35,32,3,1
SBI80NGJ5015739,91,22,21,1,1
SBI21GFF5905608,95,31,23,8,1
SBI09RCI8291090,72,27,18,9,1
SBI61OQZ5740112,98,19,14,5,1
SBI51GPC2719011,79,27,17,10,1
SBI14BFQ8918627,98,32,21,11,1
SBI98ZGS5700511,79,22,14,8,1
SBI52QTF2796972,69,20,13,7,1
SBI15OME5334170,77,19,15,4,1
SBI12BHD5881507,82,23,14,9,1
SBI95JMB4956426,67,27,16,11,1
SBI90ZMF1283516,97,15,8,7,1
SBI25WHJ0822434,85,32,23,9,1
SBI39CRC8237154,23,26,25,1,1
SBI13ORQ4393056,68,26,21,5,1
SBI10DAL8299405,77,25,17,8,1
SBI50VND6149234,77,31,27,4,1
SBI14WIY1660501,97,27,19,8,1
SBI10EAE1746139,79,19,16,3,1
SBI39RUX0690389,66,23,14,9,1
SBI53MBX4614948,78,26,16,10,1
SBI38EBZ9859322,60,19,18,1,1
SBI39HRR2551467,87,29,16,13,1
SBI02LZR4410984,82,16,13,3,1
SBI45QCA3874342,93,22,19,3,1
SBI37MGH8986234,74,29,16,13,1
SBI27ASH4898260,61,28,20,8,1
SBI17SQC5931788,18,28,17,11,1
SBI13AJH0235694,62,29,16,13,1
SBI59RWC7535985,92,31,18,13,1
SBI32VOD4160157,72,25,23,2,1
SBI06JUJ9715931,60,21,16,5,1
SBI41YIG7761495,99,24,22,2,1
SBI78CKA0392574,95,30,16,14,1
SBI91KJS6718990,78,19,11,8,1
SBI22JOQ4690282,20,22,12,10,1
SBI42EYE2120238,78,23,16,7,1
SBI99INW6245741,25,25,14,11,1
SBI33ZZR0000132,88,20,15,5,1
SBI97OON1627627,66,22,19,3,1
SBI78WMA3559511,20,20,13,7,1
SBI69YEC2641434,83,19,16,3,1
SBI84ZIQ7736474,24,20,14,6,1
SBI53ZCW2673710,71,26,24,2,1
SBI12JFO8326418,20,25,14,11,1
SBI23ZBR9549581,25,21,20,1,1
SBI67PGS1530126,82,16,13,3,1
SBI17CER3900402,82,25,22,3,1
SBI61RHB0658510,72,29,15,14,1
SBI66VIO4876619,68,25,21,4,1
SBI98EOD1374793,66,29,26,3,1
SBI39VNK4022523,64,24,16,8,1
SBI82JKT8545775,88,34,33,1,1
SBI59CEW2463249,62,21,19,2,1
SBI78ROR1314214,85,26,19,7,1
SBI07FOK3517158,97,25,13,12,1
SBI50IDT4172791,73,16,12,4,1
SBI47IWC7796323,82,24,19,5,1
SBI54EPY8995833,81,21,15,6,1
SBI44TPJ4755816,69,31,17,14,1
SBI28VKB7319231,21,20,18,2,1
SBI99QSL1551153,25,31,21,10,1
SBI13ZZQ0223308,65,31,24,7,1
SBI08QKG8559099,64,27,15,12,1
SBI98WCX7638424,75,29,18,11,1
SBI09YQH9926861,21,18,10,8,1
SBI27TCM8897786,62,21,16,5,1
SBI09SEZ2953084,69,21,11,10,1
SBI95TNL7962457,83,30,18,12,1
SBI57RUY3545668,86,18,17,1,1
SBI73FPS4375869,86,24,15,9,1
SBI80EUX8383437,84,24,20,4,1
SBI68FXN5535235,98,19,14,5,1
SBI19EGS2196410,23,20,13,7,1
SBI43PQN3178956,89,18,12,6,1
SBI90GVG0920740,84,25,18,7,1
SBI49WSY0880730,72,20,12,8,1
SBI89JOM6915684,25,35,23,12,1
SBI16OUR1102107,18,24,19,5,1
SBI96XLZ9945680,95,18,14,4,1
SBI59HNF1299284,87,32,31,1,1
SBI08LWR2257913,80,23,20,3,1
SBI31UBZ7437784,65,27,14,13,1
SBI25XOB5627042,63,16,14,2,1
SBI13IQC0690427,95,29,28,1,1
SBI77WJT0440806,20,17,13,4,1
SBI48GPZ8674943,73,30,23,7,1
SBI72APC4168057,76,27,15,12,1
SBI08BCW0502648,25,20,17,3,1
SBI73BXD6555753,77,30,25,5,1
SBI98UVW3381285,87,26,24,2,1
SBI65VHO3552409,84,28,22,6,1
SBI87REU3136020,73,25,20,5,1
SBI44AKD7551290,87,23,22,1,1
SBI90STT6751935,25,21,20,1,1
SBI88CJL1095614,95,22,14,8,1
SBI93UDV0438019,69,30,27,3,1
SBI35GVJ5219835,98,27,18,9,1
SBI92XTJ4441984,88,27,22,5,1
SBI17WIV7481294,77,25,20,5,1
SBI49SOC1577219,98,29,16,13,1
SBI21NYQ3743874,95,19,18,1,1
SBI33BHJ2358528,94,21,18,3,1
SBI84JJJ9333805,89,29,16,13,1
SBI37TCX5443125,82,28,20,8,1
SBI57ECP6609300,92,18,12,6,1
SBI69SAQ5910935,18,43,33,10,1
SBI74KGP5327534,90,22,18,4,1
SBI18QTT2414230,94,24,18,6,1
SBI46SIP0484818,89,25,19,6,1
SBI13WVP2969039,61,19,10,9,1
SBI56AVE4804668,91,19,13,6,1
SBI01CUS3889050,71,28,26,2,1
SBI42CMQ5026033,67,29,17,12,1
SBI17TTX2123513,91,33,27,6,1
SBI56QJP9446807,67,35,30,5,1
SBI97QTP8224322,77,30,20,10,1
SBI79GDQ5154732,91,25,20,5,1
SBI93JVS0566739,18,28,21,7,1
SBI97VHP5619647,65,22,16,6,1
SBI10CCV7812919,80,27,20,7,1
SBI85UJY3855861,19,29,19,10,1
SBI28NCS8823099,90,27,21,6,1
SBI59ZAY6449313,21,17,13,4,1
SBI38WFY5594638,80,27,18,9,1
SBI85FEP3136594,70,21,19,2,1
SBI37JEO8791732,98,26,15,11,1
SBI99KGE1666728,82,24,19,5,1
SBI08WKY7297444,87,24,14,10,1
SBI66HMP6271184,68,21,18,3,1
SBI67COL1544364,72,18,11,7,1
SBI25QAB8271967,24,29,20,9,1
SBI05QVX0640782,78,22,19,3,1
SBI40NMY7650747,62,35,26,9,1
SBI82TNK1781236,63,28,17,11,1
SBI07QWM4177435,78,23,21,2,1
SBI70SLO0477869,19,24,17,7,1
SBI46ROZ5162099,96,22,12,10,1
SBI00QPS7772765,20,27,21,6,1
SBI58QSB7942674,61,29,19,10,1
SBI41USV3337225,73,21,19,2,1
SBI35ZYU5046867,25,27,18,9,1
SBI23LQB6729847,20,25,14,11,1
SBI23OVX8528325,97,27,21,6,1
SBI82ZWR5439573,85,32,17,15,1
SBI06PRH2129527,63,24,23,1,1
SBI52UHE2424717,83,28,23,5,1
SBI68VLT7778123,62,26,24,2,1
SBI08RUG5281865,74,23,13,10,1
SBI64TDA7163179,22,23,12,11,1
SBI92CTJ6514114,78,21,16,5,1
SBI03MVJ5290315,76,30,23,7,1
SBI21BLS3100517,60,24,13,11,1
SBI30YZE3984604,62,33,17,16,1
SBI64KIH6634775,77,19,10,9,1
SBI98AAB3067288,25,24,17,7,1
SBI82WNG2746211,70,26,22,4,1
SBI90HVV4843336,87,24,15,9,1
SBI96JOD3225539,62,29,26,3,1
SBI77XRJ8089728,25,30,25,5,1
SBI80TVX4797637,81,28,18,10,1
SBI76EIR2886081,81,22,13,9,1
SBI86QQI6433901,70,27,20,7,1
SBI36QUS6526360,72,28,16,12,1
SBI10UGA7064991,71,20,15,5,1
SBI78YRQ8055787,91,29,16,13,1
SBI84XFI7648264,87,24,15,9,1
SBI98DOI6842526,67,29,18,11,1
SBI28FRQ2226269,98,27,26,1,1
SBI73KYQ0874808,72,17,10,7,1
SBI57OAI0523434,62,23,16,7,1
SBI89XZZ7808854,72,23,19,4,1
SBI29ZXG9190626,61,24,20,4,1
SBI56CDZ1961081,22,24,13,11,1
SBI52VVH6911486,18,20,15,5,1
SBI67DWZ5584405,19,26,23,3,1
SBI45NIK5366262,20,26,16,10,1
SBI51QYF2658317,19,15,10,5,1
SBI90JWK2387182,22,27,16,11,1
SBI00SVF2502616,66,30,25,5,1
SBI32WWD3897499,63,34,33,1,1
SBI97NRV7747115,60,13,12,1,1
SBI08QGY7914264,61,21,19,2,1
SBI13RXB5785657,78,28,24,4,1
SBI41XTL6824329,25,31,18,13,1
SBI26XSF7461487,83,29,16,13,1
SBI39COU1688273,85,17,10,7,1
SBI33ONH3928502,88,22,18,4,1
SBI88ZXP0638810,63,26,15,11,1
SBI26PAU8736052,87,18,14,4,1
SBI93WDK2832395,66,18,17,1,1
SBI69WUB9234869,88,31,20,11,1
SBI85XKJ8966834,84,24,18,6,1
SBI15QWM2951433,67,18,14,4,1
SBI58KZV2512087,19,19,18,1,1
SBI59KPM2341783,25,20,17,3,1
SBI20JHJ8519782,90,27,20,7,1
SBI81WLI8389924,69,24,13,11,1
SBI74ZQC8748744,93,30,28,2,1
SBI27FKG8637381,87,26,17,9,1
SBI97WUH7569407,18,24,13,11,1
SBI37TMB7548956,21,18,10,8,1
SBI49DAY3395591,99,21,16,5,1
SBI71MEW6390978,83,26,21,5,1
SBI58ETJ2277270,83,32,22,10,1
SBI50SNO2426179,68,23,17,6,1
SBI59FMC6784524,77,12,11,1,1
SBI50FVM9963626,63,29,20,9,1
SBI99FME7005318,96,23,17,6,1
SBI38TOZ8966314,67,29,22,7,1
SBI46OIV2687766,74,26,24,2,1
SBI24NES9121863,18,28,20,8,1
SBI47RMO8127361,68,21,12,9,1
SBI18ZHX7236162,63,17,14,3,1
SBI40ANS0928506,63,15,13,2,1
SBI44GHM9986947,77,25,14,11,1
SBI70KXJ8873607,78,27,18,9,1
SBI80NGS3520181,98,21,20,1,1
SBI68OSF3409376,69,21,15,6,1
SBI83YNM5059341,23,33,23,10,1
SBI32GTX1124483,25,28,21,7,1
SBI56CTY3860711,96,26,16,10,1
SBI09XKF1308682,69,25,21,4,1
SBI71RGP5612883,91,24,20,4,1
SBI76ZOB3487816,67,26,16,10,1
SBI02RHK0934848,20,28,19,9,1
SBI74DVZ8332575,19,31,19,12,1
SBI28QWS4246272,95,29,25,4,1
SBI02ISE4321920,24,22,16,6,1
SBI06GXU5031812,98,26,25,1,1
SBI93FKQ9849152,94,20,16,4,1
SBI60ZUB7014206,84,30,21,9,1
SBI70DFM2528422,71,25,22,3,1
SBI87DGP0883978,76,29,27,2,1
SBI73MDT2521387,66,29,25,4,1
SBI33UDL9466367,90,27,24,3,1
SBI66PIM7339763,75,23,21,2,1
SBI02PPN8997101,97,29,23,6,1
SBI57YFR5161662,63,15,11,4,1
SBI27RLF7695256,94,35,34,1,1
SBI24PLM7937909,19,21,18,3,1
SBI79EPF0919026,79,32,27,5,1
SBI24VPS7080392,69,18,16,2,1
SBI62XRL3855474,80,21,11,10,1
SBI70PDA2079330,66,17,13,4,1
SBI43AKH3010098,87,23,13,10,1
SBI76GYD1899259,18,16,10,6,1
SBI11AZV0096008,21,25,17,8,1
SBI39EUC2404716,70,24,19,5,1
SBI24IWI5659790,19,27,17,10,1
SBI93YMV3283394,76,29,22,7,1
SBI98FNN0067043,90,22,21,1,1
SBI10BOS2673609,22,22,12,10,1
SBI27CYJ6482728,94,19,16,3,1
SBI81JNM5450799,23,25,21,4,1
SBI73WWF2381629,71,28,17,11,1
SBI79PJE8868719,79,13,11,2,1
SBI25NDM1709342,84,28,23,5,1
SBI40PWS9455089,18,28,18,10,1
SBI20ISL0094838,96,24,22,2,1
SBI34CUR5534688,76,22,13,9,1
SBI69EDN0184038,68,24,13,11,1
SBI32TAZ9023829,95,24,22,2,1
SBI46XWQ1649243,18,20,14,6,1
SBI44OLI1309590,87,19,14,5,1
SBI16XZJ4237175,91,24,19,5,1
SBI61SYO7378266,78,25,13,12,1
SBI59KFD9050621,94,25,21,4,1
SBI32CQK6740003,22,34,26,8,1
SBI72RLZ2124559,85,24,15,9,1
SBI81FOW8107155,70,23,18,5,1
SBI88UHG8404034,99,20,17,3,1
SBI61XXE2082672,74,20,18,2,1
SBI66PQC7546250,89,23,18,5,1
SBI52DSD0018432,72,26,21,5,1
SBI41TLD5989449,83,21,19,2,1
SBI62VNE6564804,21,21,14,7,1
SBI62RRG5608484,84,19,10,9,1
SBI63PKX5649600,96,28,17,11,1
SBI15IET2787031,72,28,16,12,1
SBI92YSB7907947,85,17,10,7,1
SBI74FER2412943,25,30,22,8,1
SBI61RJP0077246,25,25,24,1,1
SBI57LEG7915745,71,25,18,7,1
SBI31JUM0468478,67,27,26,1,1
SBI38VQT6721547,19,27,15,12,1
SBI47WCY9955383,64,24,14,10,1
SBI95RRP4395275,71,21,13,8,1
SBI83PGX8498002,73,22,13,9,1
SBI28TQQ8356779,90,27,17,10,1
SBI18NSP8657354,62,28,18,10,1
SBI03MTO8465956,25,21,18,3,1
SBI11UBL8530015,65,24,20,4,1
SBI31TBK7760714,80,22,20,2,1
SBI37LQI6399778,22,32,24,8,1
SBI46DUE1798651,85,19,16,3,1
SBI67PZB3023195,18,27,17,10,1
SBI95GOT3580918,73,22,15,7,1
SBI64CDT3386046,77,26,16,10,1
SBI03ZDE6620297,24,31,16,15,1
SBI38DCH0449207,23,24,19,5,1
SBI12VBC3058115,97,22,16,6,1
SBI21KMI4516806,73,33,21,12,1
SBI64NTT6165624,20,21,17,4,1
SBI79QKP8820247,69,23,22,1,1
SBI25NXM2529304,78,23,20,3,1
SBI47NIT2996981,67,30,23,7,1
SBI98KZQ6943407,98,32,25,7,1
SBI45UQW4265425,20,23,17,6,1
SBI85DRU7335496,71,30,22,8,1
SBI15WWE1896903,90,24,14,10,1
SBI93EGM6667954,65,18,11,7,1
SBI34JZI9646292,67,24,21,3,1
SBI92IFQ8767773,75,24,23,1,1
SBI43JRQ9174929,91,26,14,12,1
SBI12PWH0327726,71,31,25,6,1
SBI28IVM5856533,95,27,21,6,1
SBI42GQO7039955,62,16,14,2,1
SBI12LSB6152291,69,32,28,4,1
SBI42UVU8672199,78,24,14,10,1
SBI69OZF7295004,73,24,16,8,1
SBI04HKT6003006,86,22,19,3,1
SBI28FIC4823345,76,27,17,10,1
SBI48KWU2187440,79,20,18,2,1
SBI30GBR2070207,63,26,23,3,1
SBI28MQM1635068,85,29,22,7,1
SBI42PHO3943488,81,24,21,3,1
SBI22AIE3512098,61,23,14,9,1
SBI36NYY1326236,25,34,30,4,1
SBI91VJX7596215,69,25,15,10,1
SBI68LYJ6062329,87,22,16,6,1
SBI45YUE1367105,92,28,24,4,1
SBI19HZT9353911,70,24,13,11,1
SBI38YAN5306708,19,39,36,3,1
SBI83WPS5774949,86,18,14,4,1
SBI59UTB0947137,69,25,14,11,1
SBI78EBK4287918,85,27,15,12,1
SBI18LDY1614814,72,17,15,2,1
SBI73UMR1473135,98,30,23,7,1
SBI66YYE1353655,66,33,27,6,1
SBI36DTP5767954,23,20,15,5,1
SBI82HTG0315918,61,16,10,6,1
SBI44CPL2375651,99,20,13,7,1
SBI93HBF6029212,92,35,23,12,1
SBI81DNS9635243,19,19,14,5,1
SBI75VGF0120604,84,19,11,8,1
SBI50JXQ4299583,67,18,17,1,1
SBI03OQB2509629,80,23,22,1,1
SBI42JYE6077511,94,19,12,7,1
SBI59BWH5928611,60,25,19,6,1
SBI46HNS0238999,71,24,22,2,1
SBI86CCC6641340,62,22,14,8,1
SBI19DIZ7945712,81,21,13,8,1
SBI81LVL0786506,21,22,21,1,1
SBI78NLC0026536,99,28,25,3,1
SBI57HNJ2426379,79,32,28,4,1
SBI76VHE2570600,79,22,17,5,1
SBI67HRA0293358,74,27,16,11,1
SBI77TBT2252939,84,25,16,9,1
SBI44XQW6414298,77,27,26,1,1
SBI27CDR3363775,88,23,13,10,1
SBI37KJV1301560,98,26,19,7,1
SBI13JVU5910938,72,18,14,4,1
SBI32GMT7889543,79,17,10,7,1
SBI69MWF0467052,60,26,25,1,1
SBI00AST5586437,79,34,30,4,1
SBI84IPN9605607,65,27,23,4,1
SBI22HWP7648018,90,38,28,10,1
SBI46NIY9130800,22,22,21,1,1
SBI78IFY4358702,82,29,24,5,1
SBI09XFI5958214,79,29,22,7,1
SBI41GEY4205393,88,30,19,11,1
SBI75YUP1322781,96,16,15,1,1
SBI82EQC4574999,23,27,25,2,1
SBI49QEN5999227,65,20,18,2,1
SBI95REK9900595,84,31,22,9,1
SBI60KGG7335061,77,29,16,13,1
SBI47HXA1612345,74,23,13,10,1
SBI87SEI0456662,23,24,23,1,1
SBI04LVU9127485,80,17,11,6,1
SBI10XMF3860376,97,33,28,5,1
SBI61SZQ8217001,94,31,23,8,1
SBI21ZME9426376,85,20,13,7,1
SBI92IDY9217417,23,17,16,1,1
SBI76IXG3335222,68,23,19,4,1
SBI54ECP7111225,97,21,16,5,1
SBI81SAW4525386,75,26,20,6,1
SBI89KBH4588700,99,24,20,4,1
SBI02QTO3600474,63,32,28,4,1
SBI90UIK3280043,24,22,17,5,1
SBI52HZX5859481,79,24,17,7,1
SBI55VPD1547986,25,26,20,6,1
SBI70OHY6738994,23,24,22,2,1
SBI05HQE5841371,24,28,17,11,1
SBI24RXJ0373073,63,18,12,6,1
SBI54XLS1356830,75,30,17,13,1
SBI03BCL2347699,79,17,11,6,1
SBI38GTQ7583498,77,26,24,2,1
SBI81IQV5346362,96,30,16,14,1
SBI01JNJ3726023,70,26,25,1,1
SBI22FPY0093596,65,28,21,7,1
SBI62NKY1824207,95,25,24,1,1
SBI80CKD9816497,98,27,18,9,1
SBI05DFO2589739,71,31,17,14,1
SBI44NKP9034427,95,24,14,10,1
SBI27XMQ0947115,82,19,18,1,1
SBI69IWR2542484,82,20,16,4,1
SBI78KPV7737387,18,20,17,3,1
SBI70SEK2157796,24,23,19,4,1
SBI35QHF5766073,91,27,23,4,1
SBI87VKB8907257,91,22,12,10,1
SBI13QDT7119701,89,28,24,4,1
SBI40PUV3751660,25,21,12,9,1
SBI45JAR0847756,72,25,19,6,1
SBI68MHR4735570,96,25,20,5,1
SBI46QPC9851831,88,29,17,12,1
SBI14ITY1999901,69,22,17,5,1
SBI41ZWJ3426331,65,25,13,12,1
SBI32YOQ9518164,99,20,19,1,1
SBI92UGJ3972807,95,29,15,14,1
SBI09EUB3334889,67,23,21,2,1
SBI58YEL5179243,74,21,16,5,1
SBI83TMT5049405,78,25,14,11,1
SBI99EGS8580036,84,24,18,6,1
SBI07MPL7894160,74,28,19,9,1
SBI95YQW2734259,66,24,16,8,1
SBI05PBQ8065128,87,23,17,6,1
SBI74PUB3487964,92,23,20,3,1
SBI20SAM6539818,68,11,6,5,1
SBI18YLC9145799,82,22,13,9,1
SBI97ZJD0118145,25,15,8,7,1
SBI06IHR5037168,92,23,16,7,1
SBI47CPX7892337,95,24,15,9,1
SBI10JNH6911675,82,33,23,10,1
SBI69GYB2950418,68,21,16,5,1
SBI24AMJ3908263,19,26,18,8,1
SBI55IVQ4341723,69,27,15,12,1
SBI79GIW1986373,75,19,10,9,1
SBI42WAK1577019,74,30,18,12,1
SBI56NRH6728459,73,26,25,1,1
SBI29WQT0221919,81,21,14,7,1
SBI59MKF7612886,76,23,12,11,1
SBI12DBN3320182,91,27,18,9,1
SBI78FYJ4877474,62,20,14,6,1
SBI13VVC5066659,71,20,14,6,1
SBI13VPZ6899162,81,26,15,11,1
SBI57UXS1596434,95,25,14,11,1
SBI95TQM9882971,86,27,14,13,1
SBI28QEJ1016506,89,26,24,2,1
SBI68TQD9626357,87,15,13,2,1
SBI83TVM8151958,87,26,24,2,1
SBI25OHG0718265,91,25,18,7,1
SBI94MMZ2646458,61,24,17,7,1
SBI99NSA2658791,25,31,24,7,1
SBI67XEB3088536,22,28,17,11,1
SBI66MGR6272333,76,30,16,14,1
SBI51UNM7560464,82,26,19,7,1
SBI52FPH9901901,77,23,17,6,1
SBI81KFX1113121,60,16,9,7,1
SBI64VMD4518971,97,25,16,9,1
SBI61VAD8928418,62,25,16,9,1
SBI90RSA7507907,95,25,15,10,1
SBI85VPH3055254,95,23,22,1,1
SBI43SJZ3942339,74,29,26,3,1
SBI03FEJ4222634,81,21,15,6,1
SBI25NNW7326963,81,26,21,5,1
SBI57QBI6775108,73,25,17,8,1
SBI73VQV5612711,22,22,14,8,1
SBI96WNR7382908,80,27,17,10,1
SBI08PPM4581420,67,34,33,1,1
SBI93BJS5589459,77,25,21,4,1
SBI62IIJ6190450,62,27,19,8,1
SBI87BXK2225599,80,24,13,11,1
SBI80ANK6683580,63,32,21,11,1
SBI50DWA0542100,83,23,22,1,1
SBI51FAO9174890,75,28,15,13,1
SBI92QPZ2381335,65,23,18,5,1
SBI90TWZ3781282,90,20,11,9,1
SBI89GKP7295118,93,24,14,10,1
SBI74RSH9945322,67,29,20,9,1
SBI97KER9159879,64,26,17,9,1
SBI45WYE9451155,96,16,13,3,1
SBI21CMS1744599,75,30,16,14,1
SBI72HUC9814350,75,27,22,5,1
SBI25TLY8881501,92,30,18,12,1
SBI36ZIE9268497,25,20,11,9,1
SBI57PYW1389184,86,34,28,6,1
SBI03RUM3390513,90,14,8,6,1
SBI84GHX7325400,86,26,21,5,1
SBI94KDE2371440,96,30,28,2,1
SBI45VZU3322674,81,37,34,3,1
SBI25AMM9169425,20,30,17,13,1
SBI36PNW7945311,74,33,27,6,1
SBI58UNV6458063,86,28,25,3,1
SBI32IEZ5168366,83,27,21,6,1
SBI09HGY6122706,65,20,11,9,1
SBI35NFT7066844,84,12,7,5,1
SBI27FAW9419263,95,22,12,10,1
SBI25QBW0919325,73,24,15,9,1
SBI54HGX6648080,23,31,26,5,1
SBI62QHA7254004,19,29,27,2,1
SBI52SDJ5752262,86,28,27,1,1
SBI88OPL7649278,78,18,10,8,1
SBI43DGQ7247871,90,24,18,6,1
SBI33CJZ4649764,71,27,24,3,1
SBI96HFY2000643,61,23,17,6,1
SBI70XJM6681319,65,23,15,8,1
SBI79MCY9105388,76,19,12,7,1
SBI00UWU1095240,63,22,16,6,1
SBI00CZZ3269169,19,26,22,4,1
SBI27JHY6145332,82,27,24,3,1
SBI33TJT5543149,67,25,20,5,1
SBI60OJF0880928,20,19,11,8,1
SBI15DCN6340421,21,37,33,4,1
SBI41MZB8170623,96,24,16,8,1
SBI75SWZ1932459,18,20,12,8,1
SBI79ARN5850871,89,24,17,7,1
SBI48OMX5158642,90,23,12,11,1
SBI79ACG0132933,19,20,12,8,1
SBI74AZO4443511,85,23,19,4,1
SBI90XIK6073911,70,28,24,4,1
SBI42NRM7745628,93,31,29,2,1
SBI05ZBJ2040534,20,25,18,7,1
SBI22OTQ6820694,79,26,15,11,1
SBI14XUQ1510110,71,33,28,5,1
SBI72VXQ8300469,88,23,20,3,1
SBI67GAE2187145,82,31,18,13,1
SBI48HON4046806,69,25,20,5,1
SBI33SKP2643211,94,28,23,5,1
SBI90LNX0644644,63,27,23,4,1
SBI85SDT4600176,20,20,18,2,1
SBI15YJW8549238,96,32,26,6,1
SBI23XRJ9993494,77,19,10,9,1
SBI61KSU9875949,87,26,16,10,1
SBI63IXF0386771,97,27,19,8,1
SBI98FOC5871889,19,25,20,5,1
SBI50CTC0478909,95,27,25,2,1
SBI05OBQ6316643,99,15,13,2,1
SBI02TLE8617252,80,22,13,9,1
SBI60QGJ1585090,77,18,11,7,1
SBI53XSF5229442,86,25,18,7,1
SBI96OMX8813282,72,25,22,3,1
SBI08IRI5500166,18,24,17,7,1
SBI17GKW6343533,89,29,26,3,1
SBI39FWL8315030,91,17,16,1,1
SBI12TIC9063568,76,33,24,9,1
SBI83BVT4331172,69,20,19,1,1
SBI43RUM9268432,73,29,18,11,1
SBI77YWX0731585,86,32,18,14,1
SBI05ZFG0688071,84,21,15,6,1
SBI80QPS6926358,89,13,12,1,1
SBI24OFO5025503,91,27,26,1,1
SBI91BTX4826204,91,28,27,1,1
SBI96WJE0886916,18,24,22,2,1
SBI12VQK5011787,24,23,20,3,1
SBI75BJU1914072,75,19,15,4,1
SBI15MDZ3287218,96,22,21,1,1
SBI37NCF3123928,70,23,12,11,1
SBI39AQV4241828,22,30,27,3,1
SBI07JQM9524737,84,22,13,9,1
SBI23DWM6281657,94,16,15,1,1
SBI41BYE6713978,62,25,22,3,1
SBI11SQL2932618,20,22,16,6,1
SBI31LQF2291581,96,33,21,12,1
SBI54KBP7814319,65,25,19,6,1
SBI94RDP0023700,25,21,12,9,1
SBI69WLA5073821,70,25,13,12,1
SBI14THX4583594,66,29,25,4,1
SBI37LNK4738848,73,22,20,2,1
SBI37ZGF4250038,87,24,13,11,1
SBI19RXF5258666,94,23,17,6,1
SBI74QRD9974225,85,32,31,1,1
SBI02QZZ8520006,69,23,15,8,1
SBI09IAA2268145,64,20,17,3,1
SBI23LTT3956464,62,26,22,4,1
SBI56MBV9738594,92,25,19,6,1
SBI38LUH5718605,18,27,26,1,1
SBI56UCS8241319,69,33,17,16,1
SBI80WHK6547946,64,17,12,5,1
SBI02YOG1845202,78,30,24,6,1
SBI89IQW1795045,91,28,21,7,1
SBI18VPG2571606,90,19,17,2,1
SBI63PCL5399097,22,33,25,8,1
SBI92EXG5820439,67,17,14,3,1
SBI94GNH9141988,74,20,14,6,1
SBI37YIX7638222,65,16,11,5,1
SBI87UMI4366102,19,27,21,6,1
SBI42NDZ7975699,89,26,15,11,1
SBI58FXT6794852,91,22,14,8,1
SBI93GUY5449375,79,17,13,4,1
SBI61PHD2063181,83,28,25,3,1
SBI50ULL0598063,62,28,19,9,1
SBI63FHW6202946,97,27,24,3,1
SBI76PFY4358973,19,18,15,3,1
SBI72GGQ7454830,25,33,19,14,1
SBI67SSV8295308,79,25,17,8,1
SBI68EXP3649126,21,18,11,7,1
SBI54ADY8113102,66,29,20,9,1
SBI27ZXP0918093,20,21,18,3,1
SBI65PUI5252306,99,28,15,13,1
SBI91HZT4448217,83,24,21,3,1
SBI60UVQ1810366,66,27,14,13,1
SBI87EIH4924668,91,28,27,1,1
SBI47AHG2918071,88,22,16,6,1
SBI12YJB6521995,65,27,26,1,1
SBI02YMW1139007,87,25,21,4,1
SBI34KHQ1554713,62,26,15,11,1
SBI91XMQ3215562,19,20,11,9,1
SBI72MBY8147059,87,22,20,2,1
SBI30NOY7724179,92,26,15,11,1
SBI54MZN3053301,74,31,17,14,1
SBI10NNY8327522,88,23,15,8,1
SBI05NOF8641786,68,20,11,9,1
SBI68CKB5754048,97,28,16,12,1
SBI92HQY0319117,69,24,15,9,1
SBI09HRF0823890,19,23,18,5,1
SBI46DBV6836665,70,34,23,11,1
SBI56IXQ2965293,68,21,11,10,1
SBI38KWK8971820,68,19,14,5,1
SBI39BYV2237876,25,29,28,1,1
SBI11UPG0126262,70,27,21,6,1
SBI47GIS9799255,79,28,25,3,1
SBI09NOY7090940,82,16,14,2,1
SBI31JGJ8910170,91,29,22,7,1
SBI52UMB0457415,97,24,18,6,1
SBI91WEF2889960,23,32,24,8,1
SBI48WXF1775190,95,27,22,5,1
SBI31MXI5639519,68,24,20,4,1
SBI34TFD5306088,61,26,21,5,1
SBI94ULU4051339,87,33,18,15,1
SBI45PFZ2118295,75,20,16,4,1
SBI81ULU5435650,64,17,12,5,1
SBI33RGK3371002,93,28,22,6,1
SBI56HAC5970030,25,24,15,9,1
SBI92DVP3362656,90,27,15,12,1
SBI02RCM7206873,80,21,19,2,1
SBI79FUW4463471,64,19,14,5,1
SBI82WNV4661712,99,30,17,13,1
SBI01JZR5087646,21,29,21,8,1
SBI73SXW4628567,78,29,17,12,1
SBI73KXR8929696,82,22,12,10,1
SBI21WTH2211105,96,27,22,5,1
SBI98LWM3322689,84,25,13,12,1
SBI23BKT1213774,94,31,26,5,1
SBI82FMU4770734,84,28,27,1,1
SBI55FIB1782346,63,25,20,5,1
SBI76TJH3328599,83,18,17,1,1
SBI39JKI3588784,66,27,23,4,1
SBI67SUC8745132,91,36,29,7,1
SBI94NXG7558512,71,25,16,9,1
SBI06EUK6790386,92,17,9,8,1
SBI02ORQ8535209,20,20,13,7,1
SBI48UQH0032300,78,19,18,1,1
SBI11NLM0163997,87,14,8,6,1
SBI80EJF6873261,89,23,16,7,1
SBI83DQK3710137,82,22,13,9,1
SBI80SBV6939531,75,27,14,13,1
SBI72OQG5715292,25,24,15,9,1
SBI79QOV2108403,93,31,28,3,1
SBI53QQA0117038,96,20,18,2,1
SBI80IRK6082140,65,27,26,1,1
SBI44KBJ6447306,65,32,17,15,1
SBI93NZM7287419,85,21,11,10,1
SBI97LVJ5341599,98,21,12,9,1
SBI04KGM7440436,94,10,9,1,1
SBI60IWI4812656,81,35,23,12,1
SBI14RGB9790736,85,22,17,5,1
SBI09VVW1996142,73,21,20,1,1
SBI54PRF8646672,22,18,13,5,1
SBI83GBN1286017,72,23,12,11,1
SBI89BHX5258007,97,23,17,6,1
SBI27RZY5700849,85,27,14,13,1
SBI23VGG4436436,76,27,14,13,1
SBI88YFR1731648,79,22,12,10,1
SBI54XGN0715856,68,15,13,2,1
SBI98KPS8335128,74,27,16,11,1
SBI52YZP7390505,83,24,19,5,1
SBI49RHY4795719,21,23,15,8,1
SBI47OLX6265553,62,23,21,2,1
SBI04VOC5948866,98,20,17,3,1
SBI58CRB3538410,97,22,15,7,1
SBI08OZA6605782,25,33,21,12,1
SBI80SKC6001647,96,31,25,6,1
SBI05XVQ7579666,70,28,26,2,1
SBI79YWO6582035,91,23,19,4,1
SBI98OJQ4705549,72,27,23,4,1
SBI60WTL7225452,84,22,12,10,1
SBI10UKV2901268,96,21,16,5,1
SBI55ROK1899651,74,28,16,12,1
SBI99IVJ0416159,66,29,20,9,1
SBI10WVL6690953,19,26,17,9,1
SBI81UDQ7508115,80,27,16,11,1
SBI99SNK1732305,22,33,22,11,1
SBI99FRH7650131,93,30,26,4,1
SBI30FDF2930005,82,26,14,12,1
SBI24XCP5721538,87,29,23,6,1
SBI23CKL4758324,21,25,21,4,1
SBI75ERD3823500,76,16,15,1,1
SBI05VFG5484107,81,28,21,7,1
SBI37SPJ5158410,66,23,16,7,1
SBI72XHH7645309,20,31,27,4,1
SBI98ESN4256524,72,29,24,5,1
SBI69HUJ3836687,25,27,20,7,1
SBI39VNZ0246888,21,17,14,3,1
SBI96NZB3109680,94,29,18,11,1
SBI42ORP1264210,23,29,24,5,1
SBI10FPH8418153,75,18,13,5,1
SBI27PCZ3847663,75,28,16,12,1
SBI65DJD7859861,24,18,10,8,1
SBI30JME4672601,81,31,24,7,1
SBI74FIA3256694,20,21,19,2,1
SBI06YHP5726773,92,29,17,12,1
SBI41FIL3652004,89,26,19,7,1
SBI76IDR5567569,61,33,25,8,1
SBI40DQC4079990,87,15,9,6,1
SBI53MFC6571547,20,20,15,5,1
SBI54WTD1455324,88,24,19,5,1
SBI99BBN5821213,23,20,11,9,1
SBI19MGB2791940,91,32,26,6,1
SBI80CKI9241129,20,20,19,1,1
SBI48IVH8118162,64,19,11,8,1
SBI53HUG7118756,73,25,16,9,1
SBI43BXO4336554,83,25,19,6,1
SBI21RSB7865063,18,28,20,8,1
SBI09SXW1620729,71,27,14,13,1
SBI18EQB1349328,83,37,24,13,1
SBI44CFP6722769,86,18,16,2,1
SBI64DQO7224040,94,21,13,8,1
SBI44JAH6016038,68,22,12,10,1
SBI74WEV3293985,62,26,18,8,1
SBI84LKY1695834,70,24,18,6,1
SBI75ZFB9751219,65,28,25,3,1
SBI12FJJ4357392,65,34,32,2,1
SBI55NQR9671834,68,23,14,9,1
SBI28YHL5824826,93,24,20,4,1
SBI04AYY8887908,19,27,23,4,1
SBI65NIR9419325,18,26,21,5,1
SBI24KLF4157319,69,29,17,12,1
SBI40LDL7230820,87,13,10,3,1
SBI32KZD9893762,91,34,20,14,1
SBI94XSZ1012677,60,26,20,6,1
SBI79KWN6981507,62,19,16,3,1
SBI47WMH3156558,92,18,17,1,1
SBI05ZGB4798111,87,18,16,2,1
SBI56ZWD7525869,71,21,13,8,1
SBI14NMP6768345,78,23,17,6,1
SBI56CAN2626415,81,26,17,9,1
SBI12TCO2061449,79,19,18,1,1
SBI06VWW9301930,81,26,25,1,1
SBI26FZQ8844554,90,25,17,8,1
SBI18YFX7365526,97,32,24,8,1
SBI43GPT9777096,75,29,16,13,1
SBI65LPS8309515,90,13,7,6,1
SBI01TDH9442958,67,25,20,5,1
SBI50BHO1183571,86,30,22,8,1
SBI82WEL3262309,87,22,14,8,1
SBI29SMV0225583,60,24,13,11,1
SBI35XUS5740938,66,28,22,6,1
SBI98MMY2348817,76,36,33,3,1
SBI12WCE7344306,79,28,17,11,1
SBI50AGS5632292,79,23,16,7,1
SBI77JKN8689347,68,19,14,5,1
SBI47FPB9647429,93,28,23,5,1
SBI19BNR8738015,23,24,22,2,1
SBI79RGB0238329,76,26,17,9,1
SBI22SFT0085366,88,27,21,6,1
SBI72XBY0876725,20,22,16,6,1
SBI77UIS1020739,94,28,21,7,1
SBI16YTU4601634,68,25,21,4,1
SBI13LSJ0547851,87,22,19,3,1
SBI37KHW3131436,60,28,18,10,1
SBI25FBL8439233,82,34,21,13,1
SBI08UKI5973785,90,25,20,5,1
SBI67JYU7213840,70,22,16,6,1
SBI03HMB5883953,62,25,23,2,1
SBI21EDZ6499119,22,19,11,8,1
SBI10MQC5852520,82,28,16,12,1
SBI26JDE1073301,82,21,13,8,1
SBI29ASA7188739,21,28,19,9,1
SBI25YTY1485349,64,20,15,5,1
SBI09JDM9313625,20,19,11,8,1
SBI19NSW1221606,65,25,13,12,1
SBI72BIK6463922,80,21,20,1,1
SBI42OEH1830726,74,31,29,2,1
SBI71OCN9139309,73,24,20,4,1
SBI30CZV9370768,92,23,13,10,1
SBI94KKN0495841,64,30,18,12,1
SBI52IMM2800982,79,19,17,2,1
SBI50KMZ7165267,94,31,25,6,1
SBI00LGQ2641734,95,31,25,6,1
SBI23PLX6049979,64,26,20,6,1
SBI34PIB6922076,99,21,18,3,1
SBI39SBC5382567,23,29,17,12,1
SBI23SEX5749468,60,25,16,9,1
SBI58IVP3584443,78,17,14,3,1
SBI20ELQ6603909,24,23,15,8,1
SBI26POS4468808,96,16,9,7,1
SBI76YGN0216410,80,30,24,6,1
SBI92DGG9709359,75,28,20,8,1
SBI20MRA0345485,82,20,16,4,1
SBI94GJD4198040,81,18,13,5,1
SBI10WOA4723531,92,20,11,9,1
SBI98FAW4469573,80,34,24,10,1
SBI81SHX4745227,74,22,12,10,1
SBI68TDJ4699141,99,20,11,9,1
SBI91KHQ9782960,76,12,10,2,1
SBI10YPT8038417,73,23,21,2,1
SBI69FVG0775164,89,25,24,1,1
SBI67RZE0890537,98,12,9,3,1
SBI22ULN6772927,20,31,26,5,1
SBI74RKO8627576,91,27,25,2,1
SBI53PTJ5987087,97,15,9,6,1
SBI99VVQ1057855,84,25,23,2,1
SBI99ZWE8237610,85,26,19,7,1
SBI49BID5939541,23,11,10,1,1
SBI18BVS3947471,21,32,29,3,1
SBI73HZR2357948,64,26,14,12,1
SBI67SHP9323166,75,22,16,6,1
SBI23XZJ7835443,70,21,20,1,1
SBI11EYF0254905,74,19,14,5,1
SBI02ROF3828225,83,25,23,2,1
SBI56FAQ7153710,93,26,17,9,1
SBI47GBV9720986,93,21,14,7,1
SBI15AGE4126312,84,24,15,9,1
SBI05SHB2619070,88,23,17,6,1
SBI29JWG6386117,70,25,16,9,1
SBI90SNA7160528,61,25,14,11,1
SBI37LLP8291963,61,29,16,13,1
SBI67NHJ8786364,89,25,20,5,1
SBI02LFS2948344,19,28,20,8,1
SBI19ZGZ2959287,69,19,16,3,1
SBI33IUX8778274,91,18,16,2,1
SBI06SWK2702095,90,26,16,10,1
SBI37IVA8139286,67,28,22,6,1
SBI67KIO9295333,79,28,23,5,1
SBI45YHP9128184,89,25,13,12,1
SBI15CHI1890993,98,25,20,5,1
SBI64PGE2027291,61,27,15,12,1
SBI98YDP9223060,96,20,19,1,1
SBI71EFA9784801,86,21,14,7,1
SBI85GMJ0837606,93,30,23,7,1
SBI99YVS7483652,80,25,20,5,1
SBI55XNA4241036,87,30,28,2,1
SBI08XMN8641123,76,19,10,9,1
SBI64OPB5801100,86,28,18,10,1
SBI30EBZ2928718,61,24,14,10,1
SBI16JKX2275330,90,16,13,3,1
SBI76UBL1202307,91,26,21,5,1
SBI01BEC9406975,70,22,14,8,1
SBI23KOI8278163,88,31,18,13,1
SBI03RHW4432204,70,31,23,8,1
SBI72OMW6558177,97,22,12,10,1
SBI34BDQ8298729,61,26,25,1,1
SBI15KFL8777071,94,18,11,7,1
SBI53OPO4286429,79,28,25,3,1
SBI51MAD7059989,62,18,15,3,1
SBI59WPU4414220,91,21,11,10,1
SBI53HJV5827279,66,33,29,4,1
SBI61TTO8788507,90,22,12,10,1
SBI09INE3770785,94,15,12,3,1
SBI84DUL3693364,87,23,18,5,1
SBI45XUW2187398,82,22,14,8,1
SBI06CYQ3732639,19,25,15,10,1
SBI81BSQ0449181,76,23,19,4,1
SBI08HUJ0144203,66,24,23,1,1
SBI94KNZ5921262,92,20,16,4,1
SBI52FMF1524730,96,25,16,9,1
SBI66FGC7624507,84,25,24,1,1
SBI13VNQ4807218,73,34,18,16,1
SBI81SFK0234985,86,28,17,11,1
SBI52ZAX4864776,75,32,31,1,1
SBI67AML1200495,83,15,9,6,1
SBI23TGE1666383,23,12,10,2,1
SBI10VRQ2620605,78,33,27,6,1
SBI68UND3412678,25,23,14,9,1
SBI88NMP1133972,67,19,18,1,1
SBI00SDW9136378,81,27,21,6,1
SBI67WZO6038543,97,23,12,11,1
SBI48PPD3531707,66,26,23,3,1
SBI47EGC5376594,88,25,22,3,1
SBI96QHK5887646,24,20,17,3,1
SBI54XFZ5800431,88,21,18,3,1
SBI62EWV9911924,83,22,16,6,1
SBI34NFP6247578,77,27,15,12,1
SBI73SWS7661295,21,26,18,8,1
SBI81VTV8940774,81,22,17,5,1
SBI68STX4234024,96,24,20,4,1
SBI06LRG4454021,93,23,19,4,1
SBI52XAC3671397,74,16,14,2,1
SBI59CDC1951981,89,20,19,1,1
SBI49OMF3811386,89,21,11,10,1
SBI45ZNV3041701,87,21,18,3,1
SBI35NQU6861561,61,24,15,9,1
SBI31ETJ1836219,80,23,16,7,1
SBI27NHV2327675,18,27,21,6,1
SBI75MQP0980271,72,25,24,1,1
SBI33OAP9613391,83,27,16,11,1
SBI09GWH5538426,61,22,15,7,1
SBI85PSO0563577,86,28,16,12,1
SBI12SNK1836197,85,14,13,1,1
SBI19VOA1583688,72,24,15,9,1
SBI47OUQ6367011,76,29,20,9,1
SBI36VUC4849993,77,24,16,8,1
SBI47CHS6383298,23,22,17,5,1
SBI37VTH6987022,64,21,16,5,1
SBI28XZK4095071,66,21,19,2,1
SBI61GTD3326679,85,24,14,10,1
SBI18GMN7688688,93,22,13,9,1
SBI20FPR3435360,86,42,24,18,1
SBI79RTQ4779908,72,22,12,10,1
SBI95CKT9765672,76,21,14,7,1
SBI28DVN5935576,70,26,17,9,1
SBI87QWQ1374055,99,27,20,7,1
SBI88BPN1711802,85,24,17,7,1
SBI50IXH4805529,85,17,13,4,1
SBI85ABG7669878,94,24,20,4,1
SBI95UPZ7243979,23,27,15,12,1
SBI60CGC0673316,23,26,15,11,1
SBI65EJE0478771,23,25,20,5,1
SBI54QOK9802402,81,29,28,1,1
SBI57SYJ9846731,61,19,13,6,1
SBI53QHV9111216,90,28,22,6,1
SBI63UBF4492325,21,19,13,6,1
SBI50GZA5417520,75,35,32,3,1
SBI52WNM2944364,64,23,21,2,1
SBI71INV1251726,19,17,12,5,1
SBI69GHL0872272,64,24,22,2,1
SBI99MCU4318081,69,24,18,6,1
SBI56ZDD1571833,81,30,29,1,1
SBI32UWV5651215,88,29,16,13,1
SBI62DSS5963285,82,22,15,7,1
SBI60MLQ1225972,68,27,17,10,1
SBI96BHB3099401,73,26,18,8,1
SBI99UPY0256772,61,26,25,1,1
SBI98OSN6164556,84,26,22,4,1
SBI53HMM0999432,69,26,20,6,1
SBI27JED7036092,19,25,14,11,1
SBI01WXQ9189123,69,24,17,7,1
SBI28OEY0971930,88,23,18,5,1
SBI80AYR0330542,94,17,12,5,1
SBI07PZV4124034,68,24,14,10,1
SBI25AYS2778055,92,29,28,1,1
SBI96XXM0430163,61,18,12,6,1
SBI33VTE7266975,67,22,16,6,1
SBI51YUX3603881,71,14,9,5,1
SBI42GYO6474278,65,27,20,7,1
SBI41VLL9868053,75,28,16,12,1
SBI80CYD8441996,68,29,22,7,1
SBI38WCU7650499,80,29,24,5,1
SBI68VZU0139828,20,24,19,5,1
SBI43QYS2326560,77,24,15,9,1
SBI46CQA3657210,67,21,11,10,1
SBI85ZJF9001764,20,28,18,10,1
SBI96VBM3041793,24,29,21,8,1
SBI08ODN2596636,68,17,16,1,1
SBI58SAS0336913,22,20,18,2,1
SBI84OCJ8728367,64,28,15,13,1
SBI31VGB2355691,79,28,20,8,1
SBI44ZHB7676853,63,18,13,5,1
SBI08YMI3479852,82,26,22,4,1
SBI15QLJ7408323,69,28,24,4,1
SBI84YKD0604876,86,31,26,5,1
SBI04LNR6995123,84,24,18,6,1
SBI02BFD4638823,94,18,17,1,1
SBI32JQU1093309,60,27,14,13,1
SBI38ZXD6482951,89,31,26,5,1
SBI98VPV0104743,19,22,16,6,1
SBI00TIM4089026,93,37,23,14,1
SBI20LJI6467314,24,30,24,6,1
SBI88OYR1845217,20,18,17,1,1
SBI35FIL6323849,68,25,21,4,1
SBI06TEO4159870,19,25,24,1,1
SBI27BFE0961799,85,28,19,9,1
SBI87ZFG2204139,94,26,23,3,1
SBI01NSS6168269,77,28,21,7,1
SBI44RXS3053255,86,20,16,4,1
SBI75YIH3353949,89,26,22,4,1
SBI02ZTM2977444,91,28,22,6,1
SBI62ZBG8827871,69,27,17,10,1
SBI50SMO6097306,60,29,27,2,1
SBI93NGO0664982,63,27,21,6,1
SBI62NNX2784080,63,27,21,6,1
SBI23DNO7309959,19,17,16,1,1
SBI09QVO5141932,21,20,14,6,1
SBI31RFI9120285,62,29,28,1,1
SBI54EJD9247661,92,20,11,9,1
SBI87MDC1798548,87,20,16,4,1
SBI90WWP2690027,83,30,20,10,1
SBI09VGT5705074,68,22,12,10,1
SBI53KNX2198140,25,25,15,10,1
SBI36FYS4593915,21,29,22,7,1
SBI63BCR9345382,92,18,15,3,1
SBI30ODC4414805,22,20,19,1,1
SBI88VZP1854229,94,29,24,5,1
SBI76SKK5019148,23,35,24,11,1
SBI89VVG3647016,87,14,12,2,1
SBI61BGE2271758,76,23,14,9,1
SBI85LZS8191956,99,34,33,1,1
SBI97JCV7181697,23,28,17,11,1
SBI63CQM0522473,73,26,22,4,1
SBI25ZAD2120637,72,22,16,6,1
SBI58MQX9090383,60,24,14,10,1
SBI14WIO0158469,69,24,23,1,1
SBI59LFA7759760,21,25,15,10,1
SBI49XQN6022253,93,23,21,2,1
SBI99SGI5964276,73,23,13,10,1
SBI01WUO7884941,65,24,15,9,1
SBI91DEZ2845628,84,36,22,14,1
SBI98JCO0537666,98,27,15,12,1
SBI79INJ7148736,22,24,15,9,1
SBI52KHM1171556,64,31,16,15,1
SBI96TUO7045647,95,17,15,2,1
SBI42VVC4763779,78,30,24,6,1
SBI67TIB0540057,98,11,8,3,1
SBI54OXL8373359,73,25,21,4,1
SBI32DPJ8775661,19,21,14,7,1
SBI42QWM3914622,96,28,16,12,1
SBI31OQV6971956,94,29,24,5,1
SBI66JER7967356,60,21,19,2,1
SBI24CCB6896330,92,20,19,1,1
SBI85UVS8554288,98,25,17,8,1
SBI72VTH7991199,69,21,18,3,1
SBI82GSS7554821,76,28,18,10,1
SBI16LKN4730964,91,19,10,9,1
SBI01OQP4494339,68,35,30,5,1
SBI55NNN8278977,87,22,14,8,1
SBI24IQN8812639,62,19,14,5,1
SBI42KTT2724054,73,27,21,6,1
SBI60UJC4003795,60,20,17,3,1
SBI65RHI6265486,66,16,10,6,1
SBI44ZBZ8358467,76,33,18,15,1
SBI23ZXB2286415,81,18,17,1,1
SBI87LYL5827527,68,32,22,10,1
SBI32YCU6885506,99,29,21,8,1
SBI88HTJ5056144,69,15,14,1,1
SBI22OXT3268700,23,19,10,9,1
SBI93IPO8062076,21,28,21,7,1
SBI75YVK2986371,66,20,14,6,1
SBI89NMM9348832,70,35,24,11,1
SBI18ZPD9600942,23,27,18,9,1
SBI49DPM2315473,74,19,17,2,1
SBI57WWF5549418,62,29,26,3,1
SBI62VHK3594262,84,21,16,5,1
SBI48FMW3397043,98,28,18,10,1
SBI17LOK9110209,62,28,18,10,1
SBI91AZI0589198,66,36,23,13,1
SBI38ROP2337483,81,24,14,10,1
SBI46RAI8643927,21,18,13,5,1
SBI03BML0286167,76,20,12,8,1
SBI62QRX1971009,95,19,11,8,1
SBI78FBD0063106,72,30,24,6,1
SBI74EQO7344538,80,29,20,9,1
SBI92EDO6205201,73,34,30,4,1
SBI51GIC3414292,89,18,14,4,1
SBI57LBG9900400,90,21,18,3,1
SBI00IAB9911137,95,23,18,5,1
SBI88HUV1502576,92,28,15,13,1
SBI50HUK7826104,94,23,22,1,1
SBI18ZUY9716672,73,23,12,11,1
SBI66KLW6324315,24,16,14,2,1
SBI47ERV0957916,24,22,17,5,1
SBI57RDT8569738,85,26,15,11,1
SBI62TLU3756777,86,25,22,3,1
SBI08PYW6301584,66,20,13,7,1
SBI96FPR8009511,84,20,14,6,1
SBI63ZDK5355815,22,28,25,3,1
SBI36PQY5672263,90,30,25,5,1
SBI04KQR4733472,78,28,20,8,1
SBI60BBS0846858,96,31,26,5,1
SBI57SYA7758590,63,25,13,12,1
SBI73DWY1095759,88,21,16,5,1
SBI83NSM2799160,84,20,18,2,1
SBI29WWV7319632,64,20,12,8,1
SBI14EXP4307567,86,25,19,6,1
SBI66KUC4462325,21,31,24,7,1
SBI56UJC5621563,78,34,24,10,1
SBI38CWM9425471,94,39,28,11,1
SBI48WWT7578798,78,31,19,12,1
SBI31FIU2240735,75,23,12,11,1
SBI06JQI4729251,96,25,21,4,1
SBI87ZJN5301166,71,23,16,7,1
SBI89GPO6055054,18,26,23,3,1
SBI69CSG0531359,66,31,30,1,1
SBI73PQB4717088,75,13,9,4,1
SBI47DNP0208517,60,28,26,2,1
SBI14HAM1915107,79,24,15,9,1
SBI38KPQ9549117,87,23,12,11,1
SBI05QMP4463041,89,35,23,12,1
SBI83DFB9498913,19,21,11,10,1
SBI53WTT7192818,82,22,19,3,1
SBI94FBY5831398,96,23,14,9,1
SBI57RZB4561135,69,23,20,3,1
SBI51DFW6263347,23,23,19,4,1
SBI22ZEX7012005,60,25,14,11,1
SBI47MHX4224636,82,10,6,4,1
SBI13POK5786740,25,25,23,2,1
SBI38TOV4326962,81,27,16,11,1
SBI39QCQ2114616,94,19,14,5,1
SBI35SUJ6993964,81,31,19,12,1
SBI67BYY6786539,96,28,21,7,1
SBI55HPC2241159,98,24,13,11,1
SBI09HQA4803479,80,25,15,10,1
SBI67UQQ0897357,85,27,21,6,1
SBI80UKZ0983902,77,20,13,7,1
SBI29FXD6934959,80,30,23,7,1
SBI30UEC2658991,80,16,11,5,1
SBI33YSZ3778267,92,21,17,4,1
SBI53JYP8381208,65,24,20,4,1
SBI45BQN6899969,97,30,20,10,1
SBI65MOG1618464,85,26,19,7,1
SBI53JKY4409822,80,18,15,3,1
SBI77NLF9587321,85,18,12,6,1
SBI81OXO6702385,86,25,15,10,1
SBI13WTC0469799,69,27,14,13,1
SBI47LFF6937432,88,27,15,12,1
SBI70QVI2611340,77,25,13,12,1
SBI47NSP7671733,90,23,13,10,1
SBI62WWR2612335,96,15,14,1,1
SBI06VSZ7367681,63,23,13,10,1
SBI57VGQ9553505,84,28,26,2,1
SBI13AHK2208495,92,23,16,7,1
SBI66AYU4003085,23,20,12,8,1
SBI15KLI6562893,76,25,15,10,1
SBI39VXW3770870,21,21,15,6,1
SBI87KAF7508337,70,22,12,10,1
SBI67ASP1785749,94,25,16,9,1
SBI55TXC0681089,80,24,23,1,1
SBI97OYE6117117,71,27,23,4,1
SBI77VJI1571103,85,18,17,1,1
SBI54HIC4754939,99,35,18,17,1
SBI30PAJ3151225,25,26,20,6,1
SBI33KFZ6230112,74,19,17,2,1
SBI83MGP9726647,66,21,17,4,1
SBI05ZMU5036884,79,22,17,5,1
SBI72NZZ8653828,96,25,17,8,1
SBI90HEP7374365,81,24,21,3,1
SBI48HNL3371867,91,25,13,12,1
SBI06MVF3442284,97,23,22,1,1
SBI61RXO2068694,88,17,14,3,1
SBI89JYY7059487,80,32,17,15,1
SBI34XZW7293312,87,23,17,6,1
SBI43IXZ7418042,69,22,21,1,1
SBI37BFH2043925,67,22,18,4,1
SBI33JGP6641342,22,27,19,8,1
SBI49JHT0905208,18,24,20,4,1
SBI59UYA6983923,82,20,13,7,1
SBI85WFP6496812,75,22,14,8,1
SBI52IIT4731878,88,27,23,4,1
SBI93MIL0395592,68,22,19,3,1
SBI90UIC7252137,19,14,12,2,1
SBI47KJH3011169,93,22,17,5,1
SBI81TVK0934446,65,18,16,2,1
SBI02KMD8183529,66,27,25,2,1
SBI09HTP8560852,22,22,13,9,1
SBI88CJX3471042,66,23,12,11,1
SBI16AJK0742758,71,22,13,9,1
SBI65PXD5947156,92,23,22,1,1
SBI61GRQ8843703,65,25,20,5,1
SBI54BUC1936302,68,18,15,3,1
SBI32ZPB2794162,76,20,17,3,1
SBI45ACC7234221,82,24,20,4,1
SBI14JGY7123433,97,27,15,12,1
SBI72XSX7892110,81,33,32,1,1
SBI52FCK0835389,21,23,17,6,1
SBI71BHB8808138,77,22,17,5,1
SBI20VGJ0948129,75,22,17,5,1
SBI03HTD0064555,64,30,20,10,1
SBI54GIW7142978,98,24,17,7,1
SBI96XDZ5090256,97,23,14,9,1
SBI63RJI9947457,83,31,24,7,1
SBI31GMC9011170,62,18,16,2,1
SBI28QLU5289502,98,29,19,10,1
SBI58AYL6679194,22,30,17,13,1
SBI51HHK6936129,89,25,20,5,1
SBI31QLK9632763,74,22,14,8,1
SBI73RJO0194303,66,22,17,5,1
SBI61NGW4417663,95,34,26,8,1
SBI21KOJ0156168,68,16,10,6,1
SBI05TGP3060841,83,20,14,6,1
SBI38FMY2077680,75,29,19,10,1
SBI60SZN2679706,65,19,10,9,1
SBI98RKO5988676,68,23,13,10,1
SBI14YJJ3500981,80,23,17,6,1
SBI32ZHL9537410,78,18,14,4,1
SBI48VVQ8530166,68,24,14,10,1
SBI72OUP8813053,81,19,12,7,1
SBI35EOW9019523,68,26,14,12,1
SBI93GAA5025329,84,23,22,1,1
SBI96IRD0184348,97,18,13,5,1
SBI91NOL4436976,91,25,21,4,1
SBI61IAM0283240,69,22,20,2,1
SBI72CHG3382824,81,18,17,1,1
SBI07CVQ1291715,91,25,14,11,1
SBI76QQZ0159293,74,20,17,3,1
SBI90LDQ6157618,96,22,16,6,1
SBI73TKH6734344,68,18,13,5,1
SBI08NZD4424585,63,30,22,8,1
SBI10MFF1379444,95,23,16,7,1
SBI44FSF6295622,94,24,21,3,1
SBI98LQD5521605,91,31,25,6,1
SBI93XMP0905299,99,18,12,6,1
SBI17RGO6728178,95,22,15,7,1
SBI76HSI2807610,77,19,14,5,1
SBI77ZFK8351603,72,20,11,9,1
SBI26FAP1632433,89,21,15,6,1
SBI46BPD1175126,90,31,30,1,1
SBI48CHD6976378,65,32,31,1,1
SBI04JBE1937548,99,26,22,4,1
SBI98KCP3483797,85,17,9,8,1
SBI55SHG9864926,91,24,13,11,1
SBI35MXQ5134657,60,15,10,5,1
SBI28LJJ5124500,95,27,23,4,1
SBI32LUS2005276,20,31,24,7,1
SBI88SEJ6853838,74,35,23,12,1
SBI09TAQ0130511,82,35,34,1,1
SBI42YGS5962810,92,31,17,14,1
SBI48FVW6107180,95,29,15,14,1
SBI33YWO9519035,85,26,23,3,1
SBI05NBT3485402,19,16,10,6,1
SBI93JQH4488668,68,33,30,3,1
SBI57SYS9531284,76,27,23,4,1
SBI72EDI4723654,99,40,32,8,1
SBI00KUG8044261,67,32,26,6,1
SBI86NIH4390037,25,19,17,2,1
SBI97ZWZ8840939,76,24,23,1,1
SBI78PIY5485228,82,32,17,15,1
SBI31ZRO9468657,80,27,21,6,1
SBI75GVW3375053,98,39,29,10,1
SBI83ZCK2730577,23,21,11,10,1
SBI59UCJ0375415,74,30,18,12,1
SBI93VOO9028957,24,28,27,1,1
SBI00VYR5666258,89,27,14,13,1
SBI68CSI8289982,76,19,16,3,1
SBI17QLQ6739111,68,25,14,11,1
SBI55TRE3895200,67,20,15,5,1
SBI88KQK9705301,74,27,23,4,1
SBI27HHQ5059577,83,19,18,1,1
SBI18ZRT9766010,85,32,24,8,1
SBI54PEF2231219,79,38,23,15,1
SBI16OMI6209866,83,34,27,7,1
SBI89SJY0059818,74,23,20,3,1
SBI72ZJT2484333,97,21,14,7,1
SBI22CFA8806241,71,15,10,5,1
SBI07ONC7719767,64,19,13,6,1
SBI65VTY5104670,65,19,17,2,1
SBI07UML4680464,89,18,11,7,1
SBI63LKV4599917,94,26,22,4,1
SBI90NKW2833750,74,19,11,8,1
SBI70YHU2530886,97,25,24,1,1
SBI31JYT1114460,66,19,18,1,1
SBI71FQC5082103,76,24,21,3,1
SBI01GTZ2316727,60,22,19,3,1
SBI27AJG3227282,68,24,14,10,1
SBI71PVH9661071,82,19,14,5,1
SBI57FZA7257833,67,25,13,12,1
SBI49EWV2407478,23,19,16,3,1
SBI20XEZ9914479,21,23,16,7,1
SBI08SVF4324531,91,23,13,10,1
SBI88KHI2385134,88,31,17,14,1
SBI37KCY3937099,77,19,11,8,1
SBI67XZC6215840,69,28,27,1,1
SBI83WBD2511734,62,21,17,4,1
SBI94KHV0523966,81,26,25,1,1
SBI86HLV5623353,74,34,33,1,1
SBI63BFW6369662,94,21,14,7,1
SBI56TWE6203955,90,22,19,3,1
SBI43MUY6247531,87,24,15,9,1
SBI89IWJ3127999,68,22,14,8,1
SBI36ONX2112067,79,24,21,3,1
SBI00ISB4139685,79,23,17,6,1
SBI49MEV9709047,73,26,15,11,1
SBI75MUL0659652,77,29,27,2,1
SBI88MOB8923628,76,27,19,8,1
SBI46GUF4809137,87,23,16,7,1
SBI74MTN4107396,99,25,19,6,1
SBI11PMR4323261,91,23,16,7,1
SBI63CYD8704899,60,27,22,5,1
SBI58FBT8940529,20,16,11,5,1
SBI97HSP4035101,83,29,27,2,1
SBI31RQQ3813810,91,22,16,6,1
SBI79GRR0047863,74,31,29,2,1
SBI60HWO5082786,96,23,14,9,1
SBI17PIO7638459,65,34,18,16,1
SBI26WTW0338336,83,26,24,2,1
SBI05IGQ1813603,89,26,22,4,1
SBI79FQC7243731,66,20,11,9,1
SBI64TXL1587097,76,25,15,10,1
SBI80YQX1417213,19,19,13,6,1
SBI01UPJ4843860,24,20,17,3,1
SBI01XMY3723137,84,25,17,8,1
SBI51JQR9401708,76,26,20,6,1
SBI42AHL4701823,64,27,23,4,1
SBI32VAK8257187,74,26,23,3,1
SBI39PRN8877062,18,26,21,5,1
SBI36QLN1886842,71,28,17,11,1
SBI45XID2716120,85,31,24,7,1
SBI98GTB8720060,82,28,21,7,1
SBI19WDM5940466,65,31,17,14,1
SBI26KUT1546017,22,20,15,5,1
SBI24NEJ9860820,76,23,18,5,1
SBI53UKE9287462,99,25,23,2,1
SBI58IPL7698028,95,23,14,9,1
SBI49GBD8653641,84,30,29,1,1
SBI49ELV1768947,91,24,22,2,1
SBI03BXY4054500,83,17,14,3,1
SBI21XSS7229946,74,19,17,2,1
SBI48BBY0059765,68,27,20,7,1
SBI17YKP4755390,90,31,20,11,1
SBI11QEP1628627,68,24,21,3,1
SBI29GCF8467154,25,26,22,4,1
SBI78IIU4486521,82,30,25,5,1
SBI13VBA8558887,23,20,14,6,1
SBI39NJJ1321730,82,35,31,4,1
SBI84KAK4575181,62,14,13,1,1
SBI38RSW7794430,95,37,20,17,1
SBI34NRQ3581793,19,21,18,3,1
SBI82UBQ0439474,86,28,26,2,1
SBI82MEX3599047,64,28,21,7,1
SBI04ACS8048884,86,31,20,11,1
SBI61QZK6646652,83,16,10,6,1
SBI68VLF5455833,73,22,18,4,1
SBI26DTB3109986,22,22,16,6,1
SBI57EIK1904557,19,27,15,12,1
SBI18WXU2590884,73,19,16,3,1
SBI72WIT2094515,24,26,15,11,1
SBI32LJI1873496,88,25,15,10,1
SBI59TMY7162254,76,23,20,3,1
SBI31IYH6545942,79,16,13,3,1
SBI43ZHQ5918760,89,34,21,13,1
SBI52XUB5105633,23,26,25,1,1
SBI90ASJ5220451,25,23,17,6,1
SBI68YYZ1101470,67,11,10,1,1
SBI26ODU1158527,65,17,15,2,1
SBI83MXB3474462,72,13,10,3,1
SBI13MMX8289861,19,25,21,4,1
SBI81RKB9375716,20,25,21,4,1
SBI53EGV8996331,76,16,11,5,1
SBI01NJN7862346,94,27,23,4,1
SBI86NGI5899718,74,30,23,7,1
SBI38LIL0675016,81,19,14,5,1
SBI59UPK2973573,66,22,16,6,1
SBI19NUZ3714114,85,31,19,12,1
SBI02HLZ4141320,19,23,17,6,1
SBI66PKL9133824,87,26,23,3,1
SBI18WLQ5635747,83,21,16,5,1
SBI60LZK1662216,89,24,22,2,1
SBI75LRH3235663,98,18,17,1,1
SBI93UJQ3033632,18,21,20,1,1
SBI77UIM6960453,72,24,13,11,1
SBI63PMB4907432,24,18,12,6,1
SBI56MUW6976480,72,18,16,2,1
SBI44AMR4968136,98,24,13,11,1
SBI69XSW5873896,60,27,18,9,1
SBI35JNU0502764,94,29,19,10,1
SBI56BJL3197712,64,27,19,8,1
SBI71NLS6931532,75,30,26,4,1
SBI65XOM2835149,18,25,14,11,1
SBI57YXK1386080,80,27,20,7,1
SBI23UEQ9064094,97,20,14,6,1
SBI29EKS7921708,69,17,12,5,1
SBI44KZV8177345,21,33,29,4,1
SBI09INL1067931,62,23,18,5,1
SBI45IOP2992337,65,26,21,5,1
SBI95BTV2426366,71,21,14,7,1
SBI49HER9148792,62,20,15,5,1
SBI57FYR3236732,24,28,18,10,1
SBI00QKS3472636,87,35,32,3,1
SBI26OKC1059222,66,16,12,4,1
SBI93KJG7419671,20,22,15,7,1
SBI42HYA4930155,84,27,19,8,1
SBI76SZN2165662,24,24,23,1,1
SBI85HGJ6341262,86,23,16,7,1
SBI12JUV7141819,74,12,11,1,1
SBI59CSS3784321,62,32,25,7,1
SBI53BTM5377319,99,26,21,5,1
SBI27JCJ5207757,24,31,21,10,1
SBI43PXX8695826,63,26,16,10,1
SBI17XAY1748374,79,27,17,10,1
SBI72CHA3168068,75,31,20,11,1
SBI27FOQ6051655,84,24,20,4,1
SBI73KVY3284871,96,23,14,9,1
SBI45UUJ1867803,99,24,15,9,1
SBI61ULH0270032,79,27,23,4,1
SBI65PTU0601672,74,21,17,4,1
SBI81NDN2921208,81,28,20,8,1
SBI13TZP2337627,89,30,28,2,1
SBI83NTE8770192,65,22,15,7,1
SBI89PZA6324949,82,32,22,10,1
SBI66UKJ0396105,63,27,20,7,1
SBI29ORZ2931422,79,21,14,7,1
SBI42PHF7990909,90,21,12,9,1
SBI38ESV6541748,70,20,13,7,1
SBI36VNU3084644,91,23,20,3,1
SBI18KDF4787620,76,25,24,1,1
SBI17PZT2682841,97,26,23,3,1
SBI17LWK0071633,76,30,26,4,1
SBI36BIW1997062,18,26,14,12,1
SBI28BOW7284476,95,25,21,4,1
SBI92YLA1618825,96,21,14,7,1
SBI61PGB6776303,79,34,18,16,1
SBI74QXP8378343,65,26,17,9,1
SBI09YXG9552876,65,32,27,5,1
SBI06TRB4711961,94,35,26,9,1
SBI82BGM5836010,87,31,20,11,1
SBI19ELU7639358,69,28,18,10,1
SBI04ZSC1378591,63,23,13,10,1
SBI67FTH7579702,90,26,19,7,1
SBI54BZP7040048,96,27,18,9,1
SBI67BRZ0234063,73,21,11,10,1
SBI11KFX6592378,75,34,26,8,1
SBI76SZJ6898940,99,32,30,2,1
SBI96XUL9216147,88,29,26,3,1
SBI56SPJ1252353,19,15,12,3,1
SBI42UCH5797431,92,24,17,7,1
SBI75GSS9638428,64,27,23,4,1
SBI38PUS0663219,69,26,20,6,1
SBI32NSS1093058,84,20,12,8,1
SBI68MCM0763786,86,17,10,7,1
SBI91VTD4447425,94,30,21,9,1
SBI61OXH6508180,83,27,18,9,1
SBI02XHN6802165,20,32,26,6,1
SBI76ZSO4964454,84,28,18,10,1
SBI91JAH1553538,92,33,26,7,1
SBI04CEB7985813,87,21,15,6,1
SBI04HWK4230766,21,22,15,7,1
SBI11DUP8133363,64,17,15,2,1
SBI29LHH0993398,80,20,16,4,1
SBI00ATG7629904,78,20,17,3,1
SBI05QBT3772576,21,26,17,9,1
SBI41ZWV4047431,63,32,28,4,1
SBI48PKE3327729,81,28,26,2,1
SBI44XHW3325744,68,25,20,5,1
SBI68KUF2085568,90,34,24,10,1
SBI90VYF5013822,92,29,21,8,1
SBI37FIH4064172,20,26,24,2,1
SBI84AIE4640359,85,22,20,2,1
SBI65DGF6902414,74,20,13,7,1
SBI52ZPO7981639,67,24,23,1,1
SBI47CRS0101265,80,19,17,2,1
SBI96KOE9359117,23,19,15,4,1
SBI48ZED5203072,61,21,11,10,1
SBI50DRN8804840,85,21,11,10,1
SBI48XFY7899287,75,25,16,9,1
SBI18IJX3594283,75,39,20,19,1
SBI90SDN6643778,86,16,15,1,1
SBI55XOZ5175539,86,27,26,1,1
SBI25XWE6581994,67,19,16,3,1
SBI02KEL2079182,84,25,14,11,1
SBI40FAX0938303,68,19,13,6,1
SBI29IQD0291393,90,28,20,8,1
SBI19VJV7683247,97,32,18,14,1
SBI73WDU3314106,70,24,22,2,1
SBI33FEB9353057,93,31,26,5,1
SBI41BCF2118811,93,28,18,10,1
SBI91BPH3544036,77,29,26,3,1
SBI90WAG8935420,73,21,18,3,1
SBI13VAQ6056033,84,32,30,2,1
SBI65BXI2835786,79,21,15,6,1
SBI68UHH9323057,96,27,24,3,1
SBI62RPO6034142,99,21,20,1,1
SBI91TYI3291664,18,24,21,3,1
SBI88ETY0530217,60,14,10,4,1
SBI97QSY4737717,86,21,12,9,1
SBI29NVQ7099706,73,22,15,7,1
SBI63TOO7739148,64,28,19,9,1
SBI89PTV0127264,23,21,13,8,1
SBI68UKN2084800,89,24,18,6,1
SBI71YAK7884681,25,26,14,12,1
SBI80PVC6582940,96,24,18,6,1
SBI85WTV0532724,90,29,26,3,1
SBI99HGV4258022,74,26,16,10,1
SBI38PGU5385724,96,36,29,7,1
SBI68HGP5419351,68,22,14,8,1
SBI16TFI6770111,73,18,16,2,1
SBI84HYG3511003,77,19,18,1,1
SBI08FVF4111732,82,17,15,2,1
SBI49IUK2337169,61,22,15,7,1
SBI87UMD0951607,65,27,17,10,1
SBI20YZB3750385,78,20,13,7,1
SBI39HNG2185872,67,32,28,4,1
SBI03RQE4070628,62,29,16,13,1
SBI55BSZ7641070,73,32,19,13,1
SBI33RSF1277990,87,23,19,4,1
SBI52BHV3557674,71,24,16,8,1
SBI40FAJ5302109,61,26,19,7,1
SBI21GHZ2287116,82,23,12,11,1
SBI59PXY0723779,74,25,24,1,1
SBI82HTH1751569,72,24,19,5,1
SBI73SBM0339838,85,28,19,9,1
SBI95CKI6814916,20,19,12,7,1
SBI56NJD2811904,61,25,23,2,1
SBI67TON7168137,82,21,17,4,1
SBI52HXV8207883,94,29,27,2,1
SBI50MOT6666122,63,25,16,9,1
SBI43TMK7928853,79,24,22,2,1
SBI64HQR3889692,68,19,11,8,1
SBI82XUP2490507,23,26,16,10,1
SBI77SXW5526659,96,23,18,5,1
SBI93QAZ0310398,95,29,26,3,1
SBI69MEF6830550,18,17,14,3,1
SBI97DKI1357486,69,17,10,7,1
SBI09KVN9322430,63,17,15,2,1
SBI96LUP4955197,68,22,21,1,1
SBI16IZP5026005,63,31,20,11,1
SBI65LDI2712963,60,25,17,8,1
SBI32FKB5860010,90,23,15,8,1
SBI76KJR0827398,62,20,18,2,1
SBI10WOE5085502,70,26,19,7,1
SBI60DLI1532961,24,26,17,9,1
SBI55OLO6957701,97,24,14,10,1
SBI67SML5818878,88,22,17,5,1
SBI65WGA4992754,88,28,22,6,1
SBI06TVJ6908120,82,24,15,9,1
SBI55AFV3477952,85,16,11,5,1
SBI23CLC7569024,93,25,20,5,1
SBI52WJR1378924,69,22,14,8,1
SBI21IKL5377264,86,21,20,1,1
SBI70VSE5531875,86,22,12,10,1
SBI02CZB4185269,21,17,11,6,1
SBI05BON1288203,67,20,14,6,1
SBI70JFI5607907,61,22,12,10,1
SBI39OZL0788574,83,28,26,2,1
SBI83YPZ3620839,62,25,23,2,1
SBI87YLE0173826,68,23,16,7,1
SBI32GPQ9333172,79,26,25,1,1
SBI18QJN9014582,25,18,13,5,1
SBI11KLR0441551,60,22,20,2,1
SBI92LED6413339,67,10,7,3,1
SBI92OZD8267285,75,19,17,2,1
SBI12VQA1996287,61,23,20,3,1
SBI69NVZ2145899,81,25,16,9,1
SBI03JJK1789592,18,29,17,12,1
SBI77CLG7410397,66,24,21,3,1
SBI04WAX1121383,77,17,11,6,1
SBI99SWT6216495,64,19,17,2,1
SBI70ANO7902223,65,32,24,8,1
SBI13JLS1846543,20,23,15,8,1
SBI11MQR1316820,20,17,11,6,1
SBI98DPX0260631,25,20,13,7,1
SBI04WYY6370773,94,24,21,3,1
SBI59QBF9989507,88,29,18,11,1
SBI78UAP3641099,68,26,18,8,1
SBI97YIX5990177,22,15,10,5,1
SBI61LHD7240095,74,31,29,2,1
SBI93UDT5138843,68,20,18,2,1
SBI41KXV4587309,61,26,25,1,1
SBI10DOK4105278,19,21,17,4,1
SBI16NKA8484504,79,23,21,2,1
SBI01DBD9692987,71,28,26,2,1
SBI21BFG0570160,92,19,17,2,1
SBI61JFR2870204,61,26,17,9,1
SBI51OMG6426803,83,19,10,9,1
SBI54YYU2270523,85,28,21,7,1
SBI38HZQ1103095,85,17,9,8,1
SBI87XEG2522615,88,24,23,1,1
SBI85LKO1363759,93,14,12,2,1
SBI87BZN7722581,76,22,19,3,1
SBI25FEN2545010,67,21,15,6,1
SBI15STJ6392587,75,23,20,3,1
SBI49NBY1809295,74,31,16,15,1
SBI86PUH4146264,79,37,35,2,1
SBI25FEC0696223,94,29,22,7,1
SBI42ZWM9926576,60,21,19,2,1
SBI69RQP8215056,81,25,23,2,1
SBI67XBZ9643264,97,26,25,1,1
SBI84LOM5883851,68,29,23,6,1
SBI80ETE0185506,81,22,16,6,1
SBI59FKY4347331,85,19,16,3,1
SBI47ZQL3882997,70,18,16,2,1
SBI32PGQ3995375,74,28,17,11,1
SBI75IUK6787097,95,28,24,4,1
SBI67TDB8854997,64,16,14,2,1
SBI69KTZ8301484,76,29,21,8,1
SBI85PKW7434494,98,25,19,6,1
SBI84SDZ4979899,82,27,17,10,1
SBI09QYB3226711,22,29,28,1,1
SBI27XFM7562781,99,32,17,15,1
SBI26NSY4085314,81,23,22,1,1
SBI98ZNZ7484995,65,18,15,3,1
SBI60LQE9533841,83,25,19,6,1
SBI47HJB7942494,79,17,15,2,1
SBI48GNB2850152,85,27,19,8,1
SBI88TVW0137684,62,27,22,5,1
SBI62QER4271334,81,25,18,7,1
SBI80TDB7195762,80,18,14,4,1
SBI57XMX0773792,18,21,18,3,1
SBI21IIS8613569,91,23,14,9,1
SBI79UXH7165634,72,26,15,11,1
SBI06FFS6789906,25,22,16,6,1
SBI76RCZ8979198,62,24,13,11,1
SBI16HBM1823975,66,29,26,3,1
SBI92MQK3638759,99,26,24,2,1
SBI99DOX2674463,79,19,11,8,1
SBI99JXS6750877,98,17,11,6,1
SBI79XVK1648668,18,24,19,5,1
SBI69YUD4312327,81,27,18,9,1
SBI73ZVF8988361,87,35,23,12,1
SBI82UNE2462460,61,25,24,1,1
SBI88XPP1004845,18,25,24,1,1
SBI21RDV3023618,93,28,19,9,1
SBI68ENL4985073,91,20,17,3,1
SBI54LQX6421970,99,21,12,9,1
SBI43FJF4133746,91,25,21,4,1
SBI91USC5866731,60,19,13,6,1
SBI95JUE6551008,25,24,23,1,1
SBI06HKQ0620513,84,15,13,2,1
SBI16NPW9904009,19,21,11,10,1
SBI25PTV6736668,23,18,13,5,1
SBI74GFW5823392,78,24,17,7,1
SBI51WMW0376710,64,24,22,2,1
SBI36JFO1658505,83,29,22,7,1
SBI93WKY6270442,68,30,22,8,1
SBI76RCS1781285,90,27,15,12,1
SBI59UWN1296385,81,28,27,1,1
SBI16ZGU9684784,70,18,16,2,1
SBI98UIH9127512,63,18,12,6,1
SBI78IMM3322404,82,24,20,4,1
SBI07REW1766364,86,24,14,10,1
SBI71NHW7062863,94,24,14,10,1
SBI34PWI0408620,96,22,18,4,1
SBI97CAD1042617,92,29,16,13,1
SBI95AAT8554931,92,24,13,11,1
SBI37PZR5596273,22,28,27,1,1
SBI74WIO5260468,22,26,19,7,1
SBI94MFU0262880,21,17,15,2,1
SBI89NCY2291297,69,19,12,7,1
SBI25NUU9022023,25,23,15,8,1
SBI14TWI3976956,99,16,10,6,1
SBI10SKP7942389,23,36,25,11,1
SBI54KBF5173654,21,21,18,3,1
SBI65IWT3505829,90,29,26,3,1
SBI69CPI2900095,79,23,17,6,1
SBI73FRF1122602,68,29,21,8,1
SBI15PPG9928525,66,16,15,1,1
SBI17FVK9875820,19,31,29,2,1
SBI83WYO0802683,80,30,27,3,1
SBI56VGA4899848,18,22,18,4,1
SBI81IBD4706919,20,26,19,7,1
SBI35DMV4370115,95,31,24,7,1
SBI73QUC1185461,92,25,23,2,1
SBI97UDC9229279,67,18,14,4,1
SBI56UUO6028730,84,23,13,10,1
SBI61RBG6355664,74,12,11,1,1
SBI84PAX7228167,95,34,28,6,1
SBI19GDZ2963650,97,35,25,10,1
SBI93FJD4598267,65,22,18,4,1
SBI19DXX1144597,75,26,22,4,1
SBI72DWT9471590,71,21,15,6,1
SBI40NQE0613937,77,15,10,5,1
SBI94QML7939050,20,27,19,8,1
SBI73NZL7093053,65,23,21,2,1
SBI05EXE0184723,94,25,24,1,1
SBI37BHB9048188,19,21,18,3,1
SBI08TBC4038077,22,20,17,3,1
SBI89ASM8602847,77,26,17,9,1
SBI84OXN3906897,70,19,13,6,1
SBI06ZRZ3673515,68,35,33,2,1
SBI15MSM5281036,82,30,26,4,1
SBI85KFV6543888,96,23,15,8,1
SBI80DEX3322870,76,24,23,1,1
SBI67FXC9221495,99,27,14,13,1
SBI88OSP2582559,85,29,19,10,1
SBI46JVI4538316,61,29,15,14,1
SBI17UPO7242954,98,23,15,8,1
SBI58DKV6104115,25,21,15,6,1
SBI10BRV2273396,65,32,24,8,1
SBI33DFO3701738,66,27,17,10,1
SBI64YUT8418611,20,21,16,5,1
SBI06PVD9604817,72,27,21,6,1
SBI00XEK4003931,75,26,15,11,1
SBI67DCZ7596836,89,22,12,10,1
SBI19GMR3273155,88,30,28,2,1
SBI58NCM2550660,86,25,14,11,1
SBI57EHA4860374,70,24,15,9,1
SBI02MSJ3355784,99,27,20,7,1
SBI95JKQ8649921,25,20,17,3,1
SBI82AKK9828907,83,28,18,10,1
SBI67XNM6242299,83,29,16,13,1
SBI14XCM9203089,78,26,23,3,1
SBI16QBA9259683,61,26,19,7,1
SBI43LST1430958,75,27,21,6,1
SBI99QGH2332837,24,34,30,4,1
SBI62LOJ2336636,98,21,16,5,1
SBI36RBQ5026096,67,24,16,8,1
SBI68APJ0728418,79,25,15,10,1
SBI56GHL5574313,61,23,14,9,1
SBI39RMI4279351,99,22,21,1,1
SBI64SFZ2775935,85,32,17,15,1
SBI18FJN7666546,68,23,13,10,1
SBI66WCZ8922290,83,24,16,8,1
SBI50TWU1817727,90,31,21,10,1
SBI87ZIU6867586,61,24,17,7,1
SBI39VJN9545637,62,30,25,5,1
SBI95WOZ7352311,91,24,20,4,1
SBI06TGW1314472,82,26,17,9,1
SBI20EVE2842458,20,26,24,2,1
SBI93TWV1137422,63,26,24,2,1
SBI69MZN5139840,74,28,17,11,1
SBI22DPQ5432049,23,23,13,10,1
SBI89KUC3604466,69,25,23,2,1
SBI16CRL8203895,80,28,21,7,1
SBI70XNZ3870876,22,14,8,6,1
SBI18IEJ1204131,74,24,19,5,1
SBI66RDZ7721933,20,27,18,9,1
SBI66KTI6041754,88,26,22,4,1
SBI42EGJ6612910,68,23,17,6,1
SBI71RVK7790586,84,20,19,1,1
SBI56NMD4536825,82,29,16,13,1
SBI06JOS1464229,82,25,21,4,1
SBI78OXV3810509,74,17,15,2,1
SBI10BIM7192970,69,17,12,5,1
SBI93UTZ4592151,88,26,25,1,1
SBI27WUL9431802,66,29,20,9,1
SBI11FCS2217857,69,21,13,8,1
SBI33OJY8233495,22,18,14,4,1
SBI70GCV5033039,64,34,33,1,1
SBI36AOV5426067,93,21,17,4,1
SBI07JDM2300730,72,15,12,3,1
SBI65OSW6243887,74,22,14,8,1
SBI41TPL9140334,92,22,16,6,1
SBI59VZV8927543,64,31,29,2,1
SBI52FSL1923871,23,31,27,4,1
SBI11SKQ4671153,78,29,25,4,1
SBI71TOT4810446,62,19,15,4,1
SBI93TIO7301736,23,26,23,3,1
SBI73USS6141091,96,26,14,12,1
SBI62WAY7701324,74,29,17,12,1
SBI92EDZ6367161,70,17,9,8,1
SBI60FHQ7733489,72,28,26,2,1
SBI87MBD9389341,77,30,20,10,1
SBI20AGV9008551,96,27,19,8,1
SBI73GUG1149557,88,27,21,6,1
SBI85BMR2272498,63,23,22,1,1
SBI14BAA4901443,91,21,18,3,1
SBI16IDC9262021,69,22,15,7,1
SBI44RXG9444865,91,30,18,12,1
SBI67CQW8894423,65,33,28,5,1
SBI04TDQ4792937,98,27,19,8,1
SBI46PST0832763,21,33,22,11,1
SBI91HDG7079532,19,26,14,12,1
SBI98XWC2225204,83,25,13,12,1
SBI28IVD9192536,69,19,18,1,1
SBI29JTS5683630,69,27,25,2,1
SBI92IES7298297,81,26,18,8,1
SBI77PTX2227942,65,29,25,4,1
SBI77PWP8915660,84,23,19,4,1
SBI61HVQ7789799,67,29,26,3,1
SBI11INX2585794,92,26,25,1,1
SBI63DYQ1410792,89,26,14,12,1
SBI90DQY0823363,97,26,14,12,1
SBI53GQO4045211,77,20,11,9,1
SBI33GLA6144565,93,26,22,4,1
SBI59ZEU0672474,81,19,18,1,1
SBI02XQW9444465,98,30,16,14,1
SBI92QPB5253602,87,25,18,7,1
SBI37YXU0747745,99,22,21,1,1
SBI18UMG8042964,94,33,31,2,1
SBI69YEC7057343,74,30,17,13,1
SBI25KSE4071593,87,19,13,6,1
SBI21TCC2478207,61,25,24,1,1
SBI92RDN2863492,89,21,19,2,1
SBI09MWD2540404,83,20,15,5,1
SBI00AGS9166435,75,29,24,5,1
SBI81RSJ1545707,94,17,15,2,1
SBI38XDA0527898,74,29,22,7,1
SBI20UVY5648847,84,27,19,8,1
SBI19QXB2522832,61,26,17,9,1
SBI74ZUT3342352,85,31,19,12,1
SBI51VLS7497575,97,29,24,5,1
SBI91CRH8894139,60,15,9,6,1
SBI88GLZ7831634,24,21,14,7,1
SBI68VZL6765724,21,22,18,4,1
SBI05VFJ1679592,63,22,17,5,1
SBI57IIP5974148,18,29,18,11,1
SBI80PUN5295723,24,38,22,16,1
SBI27WSP1365707,78,29,20,9,1
SBI94LVC5584191,66,22,18,4,1
SBI25BGR6442807,91,26,14,12,1
SBI67WRT5072672,66,29,23,6,1
SBI66RKD8826415,61,26,23,3,1
SBI71LAN6576154,90,29,21,8,1
SBI00YSI9036561,91,24,16,8,1
SBI53NQX9975907,72,19,10,9,1
SBI60LSU4488459,76,24,18,6,1
SBI75DQP4024947,98,25,13,12,1
SBI94VBQ3618331,22,26,15,11,1
SBI45QFQ2799275,96,23,17,6,1
SBI14LSK7568535,99,15,13,2,1
SBI20CJN8803260,97,21,14,7,1
SBI50JRC5826028,88,20,15,5,1
SBI94SBI4743800,66,27,20,7,1
SBI23RNB4354611,95,17,14,3,1
SBI21HUF4212004,85,35,22,13,1
SBI41ZDU2927704,79,26,22,4,1
SBI14YKE0853660,77,25,13,12,1
SBI58ETE8514903,88,24,20,4,1
SBI50PLC3234195,89,27,21,6,1
SBI30DLX7789763,67,27,15,12,1
SBI48QVB9879516,65,20,13,7,1
SBI04CGA4953313,20,14,8,6,1
SBI68PGE0800749,91,27,23,4,1
SBI68JYT8625477,91,28,26,2,1
SBI85QFA5692296,18,21,19,2,1
SBI65IZG5636043,84,20,13,7,1
SBI25EFZ6436953,73,11,6,5,1
SBI12NOF6562473,99,20,19,1,1
SBI76VVC1502356,22,28,21,7,1
SBI86YKH6637436,62,17,9,8,1
SBI12PED2301533,76,23,16,7,1
SBI31VHF0353735,73,24,13,11,1
SBI18MQE9039485,83,16,14,2,1
SBI55ENF1867998,91,15,10,5,1
SBI51QAF5220012,67,27,20,7,1
SBI65BLQ4259345,97,20,14,6,1
SBI73RAH9334111,79,28,20,8,1
SBI31UOS2076125,24,26,14,12,1
SBI55BUH3634343,67,23,13,10,1
SBI39FQZ0685241,21,31,29,2,1
SBI13VUX0659229,65,24,15,9,1
SBI54DGZ9084329,73,30,23,7,1
SBI81FJJ9323664,98,31,18,13,1
SBI24YTV9440654,61,27,19,8,1
SBI14VNL4060054,76,27,25,2,1
SBI24MEK0675186,98,18,17,1,1
SBI15CEP4516335,84,19,16,3,1
SBI20NXI6013554,74,31,28,3,1
SBI76NRQ2627772,83,31,28,3,1
SBI05EGH7771504,99,33,24,9,1
SBI61GEC4509513,90,30,27,3,1
SBI58HUR6710797,70,21,15,6,1
SBI10VBX2533691,65,15,13,2,1
SBI21VCE1637173,61,25,20,5,1
SBI32LHA8394123,69,28,26,2,1
SBI05DGU1807123,65,24,14,10,1
SBI38FBS5398714,67,21,18,3,1
SBI87NKO2194475,77,24,19,5,1
SBI42HLB9346770,88,25,19,6,1
SBI29MUU5233122,67,27,21,6,1
SBI06PQA3717757,68,30,28,2,1
SBI24AEX5493464,97,24,18,6,1
SBI21CWF8382033,93,24,23,1,1
SBI28LKJ8544247,60,32,24,8,1
SBI14URN2234573,77,20,13,7,1
SBI17EBY7310780,96,30,25,5,1
SBI78WZY1079181,71,26,14,12,1
SBI75ZSH4249873,85,29,22,7,1
SBI36VYC3992948,60,27,22,5,1
SBI75ZKF6433286,19,25,15,10,1
SBI94ESV3600947,95,24,20,4,1
SBI38UYX1008078,19,22,14,8,1
SBI55DGA0916746,66,21,17,4,1
SBI47WYR1865326,97,25,20,5,1
SBI27GES4765456,94,23,14,9,1
SBI71ODU7365452,78,19,14,5,1
SBI63VGV9974028,65,24,18,6,1
SBI66HLP1512368,92,23,17,6,1
SBI45OFW8545461,89,21,16,5,1
SBI11SYD3006761,25,30,16,14,1
SBI10SFY7196215,88,22,18,4,1
SBI07CUZ9796677,83,36,29,7,1
SBI99DXK8369278,97,27,19,8,1
SBI12VDE1682712,85,25,17,8,1
SBI09XCV4300702,64,32,18,14,1
SBI29WAP7094397,75,25,21,4,1
SBI06JIE5314221,89,18,16,2,1
SBI44STR2695695,85,26,21,5,1
SBI16HWY7732704,60,29,21,8,1
SBI49DPU6425671,84,21,18,3,1
SBI33MEP7448885,94,25,19,6,1
SBI88DIE7340842,78,19,13,6,1
SBI42NXZ5963187,86,35,19,16,1
SBI62LSS4301281,74,25,20,5,1
SBI74DYR0864846,65,16,9,7,1
SBI43KCG1066878,78,26,22,4,1
SBI47FAQ2756404,94,25,14,11,1
SBI57KRQ4189133,97,18,11,7,1
SBI98HPU1046587,96,28,27,1,1
SBI80LWT3767489,98,33,28,5,1
SBI03YJH6458598,98,22,18,4,1
SBI07HIE1687756,79,34,33,1,1
SBI04OEP4996326,91,21,17,4,1
SBI16NHQ6049050,79,31,23,8,1
SBI63UHC0573185,74,17,16,1,1
SBI64KQU7511609,93,32,22,10,1
SBI84MHI1114803,69,25,21,4,1
SBI70OAM5661644,89,30,20,10,1
SBI31TCT6060492,69,21,19,2,1
SBI75VZY4193588,75,24,23,1,1
SBI78FWA1659630,76,31,17,14,1
SBI55HXN7117285,23,13,11,2,1
SBI25AMH9148163,80,28,23,5,1
SBI63ZFH8888904,99,23,17,6,1
SBI81CBA8309312,25,24,15,9,1
SBI50JLS2235479,62,21,18,3,1
SBI83EVN1427277,95,26,24,2,1
SBI74QZL0563043,97,24,16,8,1
SBI29ELC2102430,80,22,14,8,1
SBI82EKJ2998650,99,35,22,13,1
SBI53JPR6619347,68,18,10,8,1
SBI97VJS1188039,85,23,18,5,1
SBI15HWW5330481,69,31,20,11,1
SBI90HVL6438153,89,27,15,12,1
SBI79EZX4264504,85,40,36,4,1
SBI19ZVV7035580,94,31,29,2,1
SBI22MSO9903739,65,27,23,4,1
SBI55HZK7323724,70,28,20,8,1
SBI42PMP5973246,67,30,28,2,1
SBI82ICF6915734,85,26,17,9,1
SBI89TCN2090353,83,33,22,11,1
SBI30XOQ2008800,86,28,27,1,1
SBI06KLH4024805,70,23,18,5,1
SBI65LAT3335664,81,14,10,4,1
SBI78XXV5117051,88,28,27,1,1
SBI57EOC6225938,93,23,20,3,1
SBI44ZKU9088856,85,21,11,10,1
SBI42VOQ7798227,81,19,16,3,1
SBI70SAU3904884,88,23,22,1,1
SBI26DAA6989816,76,27,18,9,1
SBI43RGR9235448,91,16,14,2,1
SBI89KIF7709689,89,25,15,10,1
SBI19GGN5520498,79,20,12,8,1
SBI71CFY1107612,74,26,23,3,1
SBI29THQ6584957,97,24,14,10,1
SBI70YCQ2137921,80,26,16,10,1
SBI71MTO2004969,84,27,15,12,1
SBI02KRS6150603,20,28,24,4,1
SBI41FIW3214927,77,30,24,6,1
SBI70GCI3001289,73,31,30,1,1
SBI90DZV4905207,75,17,16,1,1
SBI60PMC2935434,20,23,13,10,1
SBI81HCS9796441,97,26,16,10,1
SBI05PNY3790106,68,27,19,8,1
SBI10EJO1183104,96,19,10,9,1
SBI60UTH9784286,69,26,14,12,1
SBI23GEI9918927,94,20,18,2,1
SBI49ZHA3534315,95,23,20,3,1
SBI57YWU8976310,73,16,13,3,1
SBI82ZLH1199681,79,22,13,9,1
SBI28LEY4864400,70,23,21,2,1
SBI15QWW6960416,86,25,24,1,1
SBI70QQG4708233,65,35,27,8,1
SBI03YOQ7837776,77,21,16,5,1
SBI05MWF5369536,94,24,14,10,1
SBI22TEM3532373,81,28,26,2,1
SBI38KGS6993143,24,28,27,1,1
SBI63WHN9606782,94,26,21,5,1
SBI47HSL9975749,92,29,23,6,1
SBI61AWM6006139,82,35,32,3,1
SBI70DZA8547541,96,19,12,7,1
SBI81IXQ3025573,89,20,12,8,1
SBI76JWS0175599,60,20,12,8,1
SBI93MBF9119247,80,15,13,2,1
SBI80NNO6219995,84,31,24,7,1
SBI95KFP3123413,62,20,16,4,1
SBI37LFA4792464,72,30,25,5,1
SBI17EYY9546412,25,24,17,7,1
SBI21EGY6161279,63,32,31,1,1
SBI69CBH5326552,81,23,19,4,1
SBI19VKT4081438,62,25,19,6,1
SBI39WWE7150567,93,31,28,3,1
SBI51KTX2700083,21,18,17,1,1
SBI59WHO1748127,85,23,21,2,1
SBI10ONU7587115,64,26,15,11,1
SBI93RCH6414784,62,23,16,7,1
SBI64GHW9004809,81,17,10,7,1
SBI41MNX4226225,92,25,20,5,1
SBI15YRC4391385,60,18,17,1,1
SBI85EEI6070703,61,26,19,7,1
SBI95CCO9226706,24,28,18,10,1
SBI77FBC7408557,92,26,23,3,1
SBI52BMC3236149,81,27,16,11,1
SBI89MCA0970809,93,15,9,6,1
SBI69VXY0900957,74,19,17,2,1
SBI98QHQ0207022,91,26,17,9,1
SBI05ECY7791017,81,24,13,11,1
SBI61FLJ3689535,61,13,12,1,1
SBI65YDF1183666,69,27,20,7,1
SBI56MXX8725545,70,32,25,7,1
SBI39CAI9158717,84,19,14,5,1
SBI03NWR4242950,75,21,15,6,1
SBI27ZOU6660495,62,27,26,1,1
SBI16VQP2813119,62,23,22,1,1
SBI94FFG8589564,81,16,15,1,1
SBI52EFA8303360,91,35,21,14,1
SBI43WRP7806243,68,24,23,1,1
SBI27YQB8051460,75,16,13,3,1
SBI00MBM9068792,62,27,19,8,1
SBI82WCY0175892,91,18,15,3,1
SBI94RLK5397484,91,21,13,8,1
SBI41IKZ8253331,85,24,19,5,1
SBI86EAM6748262,95,21,12,9,1
SBI54CKE0913566,70,30,29,1,1
SBI29MCI7935914,70,21,11,10,1
SBI03KRU4411983,70,17,9,8,1
SBI60KMF7937763,72,34,22,12,1
SBI76ZPP5274599,80,20,14,6,1
SBI25LDL5070238,61,23,12,11,1
SBI58RGO3337959,98,28,25,3,1
SBI37XYY4576464,22,32,29,3,1
SBI28FCF5578082,80,23,14,9,1
SBI94UKK9075629,61,29,27,2,1
SBI72KYY1680433,63,27,14,13,1
SBI98MEK8972258,90,37,34,3,1
SBI69IBY8093819,64,31,28,3,1
SBI97RCF4777752,91,26,15,11,1
SBI39GUX6495516,71,21,17,4,1
SBI25ZUH8313728,84,25,15,10,1
SBI49OBC6365076,88,27,19,8,1
SBI74YGO8503012,21,30,29,1,1
SBI83VOF5579080,92,26,23,3,1
SBI56EYZ9904703,71,31,23,8,1
SBI85OCW3935633,71,12,7,5,1
SBI95ONZ4339631,25,22,15,7,1
SBI53FLD2382247,87,27,19,8,1
SBI02MLY1097730,96,20,13,7,1
SBI85OIZ0609249,71,26,22,4,1
SBI17AQQ4761211,63,35,22,13,1
SBI42HUE8399749,63,18,10,8,1
SBI19FCF3810340,66,20,13,7,1
SBI34JMR8692253,68,22,19,3,1
SBI73PRO3786440,65,35,20,15,1
SBI76NFA3665951,78,18,17,1,1
SBI06OVF2197672,80,22,21,1,1
SBI58CRZ1394141,73,22,16,6,1
SBI80NEW9068687,86,25,17,8,1
SBI39MHV5839423,19,20,18,2,1
SBI12NER6815003,98,23,15,8,1
SBI56VXO3748376,79,20,12,8,1
SBI94MCI0271629,97,27,14,13,1
SBI72ZIN2788249,98,29,27,2,1
SBI41JIZ3824490,73,17,11,6,1
SBI54NSX9556794,18,28,26,2,1
SBI99NEK8406489,88,20,13,7,1
SBI04ZXF9519749,78,29,20,9,1
SBI61RYT2913088,67,15,10,5,1
SBI84IAJ7119120,69,23,18,5,1
SBI45UGB7159264,69,20,17,3,1
SBI27NSW7861900,19,15,13,2,1
SBI28SZF8178610,64,26,23,3,1
SBI78AFE7151338,62,29,24,5,1
SBI54XAH5294038,94,21,13,8,1
SBI69BCS5506967,99,22,16,6,1
SBI36BBN6012530,87,19,10,9,1
SBI28ONX2229897,70,28,20,8,1
SBI07FAK0095255,95,23,18,5,1
SBI79NHX3840058,90,28,18,10,1
SBI60LDC3944551,72,20,19,1,1
SBI55WML4941497,74,31,30,1,1
SBI55BQV1863241,99,20,15,5,1
SBI28NAT3124295,67,13,10,3,1
SBI48TCF1234616,72,20,18,2,1
SBI29MFT1025597,18,26,16,10,1
SBI65AFA8270835,61,26,16,10,1
SBI61VKW5297699,93,23,15,8,1
SBI97QLD1154350,70,18,12,6,1
SBI98OUV6021141,61,26,19,7,1
SBI80ELQ1995217,87,36,32,4,1
SBI95AIO6428513,90,24,16,8,1
SBI64WAB3005939,66,27,15,12,1
SBI09QUA0606211,88,28,19,9,1
SBI28ELL6076120,81,23,12,11,1
SBI75VDX3106091,18,28,19,9,1
SBI44BEU2825277,25,28,21,7,1
SBI53HYP4696500,72,27,21,6,1
SBI94LHL1535971,82,22,21,1,1
SBI12TEU8436785,94,24,15,9,1
SBI70JJM0631768,63,22,14,8,1
SBI55MDN0022100,89,19,13,6,1
SBI46MMQ9456168,90,29,18,11,1
SBI64WRT2286820,63,14,10,4,1
SBI56TKR1376421,18,26,25,1,1
SBI67IXY2994546,21,30,19,11,1
SBI00DWD1587891,18,22,21,1,1
SBI51KGJ2884277,89,26,23,3,1
SBI39OJI3355962,23,31,20,11,1
SBI85IXN0531629,97,28,15,13,1
SBI28IJN2493153,60,19,12,7,1
SBI70ZIN1685800,24,25,18,7,1
SBI79SIV9709497,81,21,12,9,1
SBI94WQT1652217,95,28,15,13,1
SBI67KKA3628129,99,26,16,10,1
SBI53WNN6064523,95,34,23,11,1
SBI02QTS4666059,88,21,11,10,1
SBI09ZCM7224278,21,23,13,10,1
SBI56VJB5958537,79,26,21,5,1
SBI37QTE6635907,98,19,18,1,1
SBI51UBK0627422,61,21,20,1,1
SBI82HYL4350248,76,24,15,9,1
SBI88QJI4210437,85,21,19,2,1
SBI27DLF5573877,66,26,18,8,1
SBI53QDS6039434,84,26,23,3,1
SBI53QUJ4617142,65,25,17,8,1
SBI18NQZ1212175,81,25,23,2,1
SBI75DPE3481709,85,30,29,1,1
SBI13YBO0756353,22,19,16,3,1
SBI58KUP8525894,78,18,15,3,1
SBI58UWP1728602,84,25,15,10,1
SBI19UIE2435989,19,25,19,6,1
SBI22UBU2297261,90,19,13,6,1
SBI71MEZ4025530,93,24,23,1,1
SBI03MLR6848602,64,16,14,2,1
SBI83ING8734349,21,17,9,8,1
SBI75BSS8294479,69,33,19,14,1
SBI33QHQ2206957,65,21,11,10,1
SBI75WKB8514973,86,17,11,6,1
SBI08JBP7629589,99,23,16,7,1
SBI20COV8110799,70,25,20,5,1
SBI36XUB9673072,64,27,19,8,1
SBI63HBG1637544,21,18,11,7,1
SBI41FVC5008667,78,28,22,6,1
SBI43NQJ4719160,66,20,12,8,1
SBI60FYR9511061,75,20,17,3,1
SBI50AHO9936543,99,24,20,4,1
SBI48DVU3571171,93,20,15,5,1
SBI09HZA2065474,70,26,21,5,1
SBI83IHT8462894,78,20,12,8,1
SBI53QNZ1009578,92,23,14,9,1
SBI47HEX7157116,99,21,11,10,1
SBI83PTC1077981,85,27,14,13,1
SBI69NFP0315089,81,29,19,10,1
SBI46CEL9052508,24,22,21,1,1
SBI28HAE3664390,86,14,8,6,1
SBI67WFU4730402,80,24,13,11,1
SBI94FPK3657566,90,29,22,7,1
SBI74ONG3700631,20,20,18,2,1
SBI17EEF8284134,79,19,15,4,1
SBI23EJB3070443,77,18,14,4,1
SBI51AYD4324019,92,21,16,5,1
SBI51UOX5577746,66,22,21,1,1
SBI00JKP5063837,89,24,20,4,1
SBI48CWX7648480,68,26,16,10,1
SBI05WCG2652994,62,19,15,4,1
SBI64AYE7972189,64,30,29,1,1
SBI09EUI0039072,74,21,13,8,1
SBI81FAG0339634,83,30,25,5,1
SBI78KOU0518550,21,26,24,2,1
SBI69PUE9226288,92,21,13,8,1
SBI42LTK6206272,81,25,21,4,1
SBI04PTX7530159,97,29,24,5,1
SBI32JKW5541886,62,25,22,3,1
SBI67ICG9346856,61,21,14,7,1
SBI76KYT6184216,77,27,23,4,1
SBI30VDK6576319,92,19,17,2,1
SBI23MLH2651838,93,26,16,10,1
SBI00KGV3572192,78,19,15,4,1
SBI53UNJ1254798,81,16,9,7,1
SBI20DID3610382,75,21,14,7,1
SBI48WKN5128231,20,15,13,2,1
SBI87RFE8176960,97,18,16,2,1
SBI90VCR0289750,93,17,14,3,1
SBI04AKM2065345,86,20,12,8,1
SBI30LAX7902306,73,30,22,8,1
SBI63MPH1809238,78,20,19,1,1
SBI22XMV5615062,73,26,14,12,1
SBI51RFS5515699,83,15,9,6,1
SBI23XSU0065471,68,22,17,5,1
SBI64BKG7219929,68,25,14,11,1
SBI72QYT9421598,63,24,13,11,1
SBI76PNR0417792,74,26,22,4,1
SBI63ESV8021417,97,21,15,6,1
SBI62ILH1319328,72,34,23,11,1
SBI46OKX4437426,92,30,16,14,1
SBI19OLJ2758083,82,16,13,3,1
SBI06MLI7623319,73,27,20,7,1
SBI59NDZ4924138,71,17,9,8,1
SBI39XIM6071088,99,24,17,7,1
SBI19EUD1346375,96,23,13,10,1
SBI96DSA4018421,84,17,10,7,1
SBI03TRD3046237,83,30,18,12,1
SBI51JXC8345607,84,27,15,12,1
SBI49HVU3084717,88,25,16,9,1
SBI28BNF5409718,95,24,18,6,1
SBI43QWK1051860,87,16,12,4,1
SBI96PVF3788138,99,17,16,1,1
SBI51VFN3958431,92,22,19,3,1
SBI63ULB0618341,67,28,26,2,1
SBI45WQU9446056,86,28,27,1,1
SBI58NSM2782314,72,28,15,13,1
SBI41QHC7463725,84,17,15,2,1
SBI03FWJ4350083,73,20,15,5,1
SBI23NRM3648651,78,22,12,10,1
SBI49QWN3730585,99,25,16,9,1
SBI92WMN0510970,65,22,20,2,1
SBI36NPO8134350,73,26,22,4,1
SBI12TSQ8251392,98,32,22,10,1
SBI27OMV2001340,71,26,20,6,1
SBI33TOB7306256,72,20,16,4,1
SBI21VXC1209462,71,27,26,1,1
SBI79HQM4780805,95,20,18,2,1
SBI83NCS4752871,96,21,13,8,1
SBI43QYZ4595787,66,27,25,2,1
SBI27CZZ2212677,60,30,16,14,1
SBI37AMU9819074,63,20,11,9,1
SBI68BWF9568079,98,20,17,3,1
SBI47OHP7304261,91,31,28,3,1
SBI59XEC8606727,92,19,10,9,1
SBI61ETR3205317,99,29,24,5,1
SBI63QHB5618530,72,25,14,11,1
SBI52USM1923514,69,26,20,6,1
SBI70VPV2807663,64,18,17,1,1
SBI22XQG4312355,24,28,23,5,1
SBI59HHY5283245,95,22,16,6,1
SBI88BQH7358687,91,21,13,8,1
SBI90KKN9171218,91,32,30,2,1
SBI09AYC3983347,97,27,22,5,1
SBI35OFH1509832,86,19,10,9,1
SBI35VBT1178531,25,27,26,1,1
SBI72NHM2581842,94,24,14,10,1
SBI03MGK0233200,90,31,17,14,1
SBI79OVR5187929,89,26,18,8,1
SBI45JJY0104200,84,26,20,6,1
SBI44ZLE6934289,72,20,11,9,1
SBI45NRO6019452,22,22,14,8,1
SBI56CEK4311910,91,17,13,4,1
SBI20ESD0523277,82,21,17,4,1
SBI37ARK9271069,77,33,31,2,1
SBI28ODW1431895,74,20,19,1,1
SBI75THI6115963,69,30,25,5,1
SBI52NOR0984186,72,19,17,2,1
SBI90DRP5406703,93,23,14,9,1
SBI50IVH1200325,19,21,18,3,1
SBI56AEK6382880,85,24,14,10,1
SBI53DSE3678428,77,25,17,8,1
SBI25RTO0189498,96,21,18,3,1
SBI73UXW0371864,23,30,20,10,1
SBI63EMC3788823,95,23,22,1,1
SBI60AKP4783735,76,22,15,7,1
SBI40FMF4731135,88,35,24,11,1
SBI37YUP5620233,98,22,18,4,1
SBI10HAQ7191424,95,19,12,7,1
SBI97HSB4070891,87,32,26,6,1
SBI23ZBJ0129530,65,26,14,12,1
SBI29UJQ9135217,71,18,14,4,1
SBI23YUG8856259,64,19,15,4,1
SBI07EGP6312652,25,24,21,3,1
SBI20HCW8006208,87,32,24,8,1
SBI30RLJ2461694,90,23,22,1,1
SBI45VQI8203879,78,22,13,9,1
SBI15DMH6888726,89,17,16,1,1
SBI36AHS8258138,80,19,11,8,1
SBI10NRJ6242348,89,23,16,7,1
SBI78GMP8414175,72,30,26,4,1
SBI79SBH2331116,79,25,15,10,1
SBI14TPJ9447862,85,16,12,4,1
SBI14VGH4865350,71,20,14,6,1
SBI64UTD7893487,79,26,23,3,1
SBI44EIP4013839,74,28,21,7,1
SBI88BWY2490381,84,27,14,13,1
SBI26TAU8379702,79,29,27,2,1
SBI84IVA0367303,89,22,21,1,1
SBI99OKQ6459282,93,25,20,5,1
SBI74DMO6447680,75,28,19,9,1
SBI61FFK2724457,67,20,19,1,1
SBI70ASE7781526,70,24,16,8,1
SBI00BIG0036542,91,33,22,11,1
SBI72FLW3227585,89,21,15,6,1
SBI83KHL0198817,94,22,15,7,1
SBI95IFT3430316,61,16,15,1,1
SBI53AJW7119769,83,24,23,1,1
SBI49BOG1998461,20,23,14,9,1
SBI86ANF6903731,83,19,11,8,1
SBI90PIF6108707,65,32,25,7,1
SBI07KIO4671627,86,25,19,6,1
SBI59VBS9822589,82,27,15,12,1
SBI32VNI1980235,71,29,20,9,1
SBI20GUE5480827,77,26,16,10,1
SBI48QMQ8644844,19,16,11,5,1
SBI69XAO8498940,24,19,14,5,1
SBI52SCP2288565,97,21,14,7,1
SBI59UFH7913689,98,15,13,2,1
SBI96UHC8299664,80,28,25,3,1
SBI73YAQ9976891,18,25,17,8,1
SBI09XGK1089056,63,14,10,4,1
SBI97PHG7051820,99,33,17,16,1
SBI79SYX0135578,20,27,15,12,1
SBI42ZUF9084600,81,21,13,8,1
SBI59XEX8948079,91,32,18,14,1
SBI61CUJ5130062,23,27,19,8,1
SBI77XZE4027187,20,17,11,6,1
SBI23WGA5467290,92,27,21,6,1
SBI73TFF3754115,87,30,18,12,1
SBI47VTR1627504,23,24,17,7,1
SBI31FTB0025028,60,20,19,1,1
SBI41YVM4763335,73,28,27,1,1
SBI60WUL0772544,22,18,15,3,1
SBI53JHJ3304400,63,35,32,3,1
SBI08PBI1481343,25,24,22,2,1
SBI86CHY1656378,20,31,19,12,1
SBI16JTZ4136966,95,26,14,12,1
SBI60BSL8648624,68,27,23,4,1
SBI28QMS2983485,79,25,15,10,1
SBI71UDQ1810991,96,22,15,7,1
SBI79ACS9938720,91,19,15,4,1
SBI20DWZ8564280,67,27,18,9,1
SBI84TLA4183956,82,28,21,7,1
SBI18RHW6254238,20,20,16,4,1
SBI09LNT2300366,25,33,21,12,1
SBI34PLZ7158857,83,24,19,5,1
SBI59BPE1313911,25,20,15,5,1
SBI98WBV0925607,23,32,26,6,1
SBI64CKA2154680,19,28,23,5,1
SBI08MSY6471724,77,27,16,11,1
SBI02UEF6488709,76,21,19,2,1
SBI35OUT0399596,79,18,14,4,1
SBI45NXZ6456385,64,27,14,13,1
SBI04HHL5651534,65,34,24,10,1
SBI96BUF2595038,86,27,18,9,1
SBI43RZZ5196144,21,34,19,15,1
SBI16DUZ2109307,63,18,14,4,1
SBI70FMC2172185,93,30,22,8,1
SBI59ZAP1494694,19,32,25,7,1
SBI20RKP0422916,73,24,15,9,1
SBI94YCD8985816,96,28,24,4,1
SBI93UUU3117616,71,26,22,4,1
SBI34MLF5377262,86,25,16,9,1
SBI55JON0112458,98,23,18,5,1
SBI37NPD8710330,18,26,18,8,1
SBI85ZRZ7300102,97,19,17,2,1
SBI24WFY6736043,72,32,27,5,1
SBI38IAA0070042,73,16,9,7,1
SBI30HLX2993097,91,22,12,10,1
SBI98SNE3706662,96,27,15,12,1
SBI70KEP4457486,24,30,24,6,1
SBI49FDN3129370,90,28,27,1,1
SBI56JEV4584011,20,22,14,8,1
SBI98SAS0105057,71,25,15,10,1
SBI34NQO4692150,92,30,18,12,1
SBI74JGY5855262,67,26,15,11,1
SBI39PEH1968468,88,34,18,16,1
SBI85XBG5156091,74,26,14,12,1
SBI51ZKH3066835,91,26,16,10,1
SBI64PCF7765407,84,25,20,5,1
SBI54KTW3397263,97,26,23,3,1
SBI73JHQ1917288,82,27,25,2,1
SBI68EHJ4215057,99,24,18,6,1
SBI54XAK8461412,68,18,17,1,1
SBI13TOQ3336632,69,19,11,8,1
SBI59LWZ8279832,97,21,11,10,1
SBI37MUK5140880,91,30,16,14,1
SBI28AEC9131106,89,26,25,1,1
SBI03NTQ7021331,88,28,18,10,1
SBI16KEE3083789,21,23,16,7,1
SBI76ISG2173432,67,32,31,1,1
SBI08IRW8490784,74,21,20,1,1
SBI79ROU5202262,63,18,12,6,1
SBI72HFX4325761,66,26,25,1,1
SBI88ISC5748261,89,24,20,4,1
SBI56UQF2006098,63,21,11,10,1
SBI48YLT1776794,93,25,22,3,1
SBI51UKE3248283,88,27,17,10,1
SBI38LCO8527743,80,27,19,8,1
SBI42PUT6082657,66,20,15,5,1
SBI03XDV7046255,98,21,19,2,1
SBI22TWB9870630,89,26,23,3,1
SBI99HFB6063629,60,20,18,2,1
SBI85LJT9226138,78,32,26,6,1
SBI78RLQ1715212,64,18,11,7,1
SBI13LAR6921665,82,31,23,8,1
SBI50BYF2122815,88,28,15,13,1
SBI32YOV1192202,92,22,19,3,1
SBI50OMU0084094,78,33,23,10,1
SBI05QBG9125560,95,20,17,3,1
SBI84JJN7113050,82,20,11,9,1
SBI23HAW0780021,96,29,17,12,1
SBI23RJJ2458296,19,30,20,10,1
SBI79XOY6978655,65,25,13,12,1
SBI42ICV8618590,84,22,12,10,1
SBI22GLN0575561,20,26,17,9,1
SBI09MZK7788356,71,31,21,10,1
SBI46WRZ1328109,23,28,23,5,1
SBI24YLY8982695,74,30,23,7,1
SBI31JWD9143130,23,30,25,5,1
SBI88GZD2245127,69,17,10,7,1
SBI69QKU0218301,23,23,19,4,1
SBI81BGK8871880,83,19,11,8,1
SBI56ZQS4226270,21,10,7,3,1
SBI83GSD3403841,23,33,28,5,1
SBI99OMC1202907,86,29,28,1,1
SBI84OLW2702841,60,29,23,6,1
SBI87GBP3916795,95,19,16,3,1
SBI17QEW6210928,72,25,20,5,1
SBI57FSU3371304,20,31,29,2,1
SBI91KFV7385500,83,26,15,11,1
SBI18AGX4592963,70,27,26,1,1
SBI36CPV3937046,74,29,28,1,1
SBI46TCR9921072,89,20,12,8,1
SBI16KGN4641967,97,19,17,2,1
SBI05HVS2584650,91,35,25,10,1
SBI70GQC4028978,68,17,11,6,1
SBI21TVJ3713460,66,24,18,6,1
SBI24WNL6908145,91,26,19,7,1
SBI91YRZ7836903,97,29,21,8,1
SBI06UIO7866616,80,30,22,8,1
SBI55CDB9562038,90,27,20,7,1
SBI12XUO9880685,60,29,24,5,1
SBI25BVG2581564,87,29,28,1,1
SBI60XZD2255607,86,16,11,5,1
SBI47FXL5050710,82,29,25,4,1
SBI14NIC5153625,62,20,14,6,1
SBI04TBW3831480,82,31,26,5,1
SBI27KHZ2667164,87,23,18,5,1
SBI47SYY3855500,60,19,11,8,1
SBI21IEO4055134,63,30,28,2,1
SBI69CCP5674799,18,29,17,12,1
SBI29SKN8143432,81,31,19,12,1
SBI48BIP7440054,91,21,16,5,1
SBI12HHK4379523,18,34,28,6,1
SBI28GJF6342706,98,26,25,1,1
SBI83YVO6176608,69,27,19,8,1
SBI37BLQ3629108,67,21,19,2,1
SBI09SQL6217427,79,29,22,7,1
SBI79WKD1812538,64,30,16,14,1
SBI64UPV1167189,23,24,19,5,1
SBI28LUN8718657,91,26,25,1,1
SBI14NEV5665035,62,28,26,2,1
SBI92LEH3892097,94,20,18,2,1
SBI91WUX5367473,97,32,28,4,1
SBI75FQJ1152376,98,20,16,4,1
SBI17AQJ7312698,81,26,18,8,1
SBI26BZR6274518,96,29,21,8,1
SBI39MFL8659657,86,26,16,10,1
SBI96SFR5763289,80,25,18,7,1
SBI72TTT2946052,73,26,16,10,1
SBI14GGP4853210,75,22,18,4,1
SBI67WMP3746744,20,26,17,9,1
SBI53NPX5407923,23,31,22,9,1
SBI42JKX7825337,24,27,17,10,1
SBI80ITR2270922,99,26,20,6,1
SBI25ABD2079293,74,14,9,5,1
SBI01IBN8402038,71,17,13,4,1
SBI42BPC7913398,23,24,19,5,1
SBI04BDV7972910,97,30,19,11,1
SBI28RFK6745191,95,28,26,2,1
SBI03KOA6444528,65,22,15,7,1
SBI98CUS6434039,67,23,21,2,1
SBI77HWA4401284,18,24,19,5,1
SBI10UPM2608353,80,30,17,13,1
SBI73FXZ1996253,21,22,21,1,1
SBI20MIS5699293,90,33,23,10,1
SBI79AFJ7764948,86,20,15,5,1
SBI92GXJ3589611,67,25,22,3,1
SBI28LKN9825545,71,25,18,7,1
SBI69FET1896768,97,26,24,2,1
SBI31RXR1493343,61,24,20,4,1
SBI11KBF8461608,20,18,10,8,1
SBI91LSU8195897,95,23,15,8,1
SBI48UUC8582948,87,25,15,10,1
SBI28IAI5656976,61,23,16,7,1
SBI90DDK5475414,65,32,28,4,1
SBI84GGD3238035,68,25,19,6,1
SBI45EWG6416817,76,24,18,6,1
SBI13PJW8991896,64,21,16,5,1
SBI45SMS5687483,70,25,24,1,1
SBI55XGE6405775,97,24,15,9,1
SBI76EQL3946375,81,27,19,8,1
SBI48HDC1328474,94,37,29,8,1
SBI36YHA9899624,86,31,17,14,1
SBI15WYD8127517,75,24,20,4,1
SBI82UEF9260262,85,30,26,4,1
SBI25MTV6719952,71,21,15,6,1
SBI85OTY7379479,97,25,15,10,1
SBI11KUG8714565,94,23,16,7,1
SBI05COB9648888,61,18,14,4,1
SBI40KZL5377542,96,19,11,8,1
SBI88XTI8729662,77,23,15,8,1
SBI69EZD4538112,71,15,8,7,1
SBI13YFV5918468,63,23,22,1,1
SBI90PMU0349378,18,24,22,2,1
SBI34FEQ8495675,75,25,20,5,1
SBI17XEC6396781,67,26,20,6,1
SBI38OKX4252816,24,29,27,2,1
SBI28GVQ2055861,85,14,13,1,1
SBI50CYG3927617,75,27,20,7,1
SBI66UYF2123388,95,25,24,1,1
SBI73CZC5757721,25,24,14,10,1
SBI57BWK4992812,86,25,19,6,1
SBI73PUX5968028,21,23,21,2,1
SBI91QBW0224518,23,21,13,8,1
SBI98JMQ2232807,76,21,14,7,1
SBI84QEW6957938,63,24,18,6,1
SBI95QJM9257958,90,28,21,7,1
SBI64BJT5618659,91,29,23,6,1
SBI83EEG7688101,88,24,19,5,1
SBI29HHT1085971,25,19,10,9,1
SBI21VVG5613668,86,30,17,13,1
SBI81WJX0617508,84,20,19,1,1
SBI32KXL4317587,24,26,18,8,1
SBI15LIY0850068,25,27,19,8,1
SBI63PFJ1011723,96,27,20,7,1
SBI82MLZ3648925,89,26,21,5,1
SBI60JBR6558125,63,24,17,7,1
SBI99APE2024999,19,26,24,2,1
SBI57XDC3686605,70,17,16,1,1
SBI83TPW6143543,22,27,19,8,1
SBI62IOU0061942,98,20,16,4,1
SBI17IHF9914618,25,30,29,1,1
SBI55QXW4191872,91,29,20,9,1
SBI83JKV1889708,71,22,20,2,1
SBI87YDN1631028,73,17,15,2,1
SBI35GKB2569352,74,24,13,11,1
SBI89XRE5032317,67,25,17,8,1
SBI08QOO5900177,72,21,11,10,1
SBI33ZUI5548914,75,34,20,14,1
SBI09XBG2355175,84,20,12,8,1
SBI15SGD2500330,73,17,15,2,1
SBI60INR3751615,80,19,14,5,1
SBI42DIA3503688,99,21,19,2,1
SBI29NAY2743298,83,18,11,7,1
SBI63XSW6082694,96,25,22,3,1
SBI62CBN3735561,75,11,10,1,1
SBI94XNU9066414,61,31,23,8,1
SBI30FIC0715846,67,20,13,7,1
SBI21FFX9815223,83,32,23,9,1
SBI62QGG5612233,85,21,11,10,1
SBI72FTR5281053,80,24,23,1,1
SBI26AUM9953267,99,21,15,6,1
SBI80IEL6088545,68,28,26,2,1
SBI40NXD9257487,22,16,14,2,1
SBI53FCD0718750,98,24,21,3,1
SBI92VQY4711141,65,23,18,5,1
SBI83BNQ4130040,60,12,9,3,1
SBI71FVD8678557,70,21,19,2,1
SBI28UWY8327403,84,24,15,9,1
SBI62IXC6123320,62,17,15,2,1
SBI58SQU0081129,84,15,10,5,1
SBI12PSN3224584,87,23,18,5,1
SBI35APX1370887,60,29,26,3,1
SBI48EPU7111650,20,24,13,11,1
SBI83CNW4276999,91,27,22,5,1
SBI46GDI4455695,89,17,16,1,1
SBI65BUE7494205,68,20,12,8,1
SBI44IRA9396091,69,21,15,6,1
SBI73EQJ7830461,70,31,19,12,1
SBI28NLH5974382,60,19,16,3,1
SBI49WFW5644174,70,11,10,1,1
SBI03QCE1080219,83,21,12,9,1
SBI11KHY1788227,70,28,16,12,1
SBI40SHW0987950,70,29,22,7,1
SBI17YXK7433177,74,21,18,3,1
SBI64WGA8282574,92,18,10,8,1
SBI65TGV0569824,22,24,14,10,1
SBI61OWT0264769,97,24,13,11,1
SBI76CWC9179085,19,19,11,8,1
SBI99SEJ1981777,92,15,14,1,1
SBI51GCG2143020,74,23,16,7,1
SBI99BYB5104563,69,20,16,4,1
SBI73NSV6089068,91,29,16,13,1
SBI00SMD4995017,85,29,27,2,1
SBI26HVH8140581,94,26,25,1,1
SBI20DFV3837697,77,19,11,8,1
SBI60CDN9254620,68,18,13,5,1
SBI42OIO8494855,91,29,27,2,1
SBI72ZTZ1705061,92,17,14,3,1
SBI81JNW0884735,21,23,18,5,1
SBI55RRB3332227,72,36,30,6,1
SBI37BVJ6713852,66,26,19,7,1
SBI08UBD0030619,79,22,20,2,1
SBI69VXR8660637,24,15,14,1,1
SBI89UNX2871988,88,23,14,9,1
SBI06ENR4935557,65,33,27,6,1
SBI30CKN3953130,18,27,25,2,1
SBI41OSF8354871,98,25,24,1,1
SBI59MPR7545085,73,33,17,16,1
SBI28XFS2154342,90,29,24,5,1
SBI97ULD6017251,70,22,15,7,1
SBI17EUL6282485,65,17,12,5,1
SBI73KUU3980502,95,20,11,9,1
SBI77URC8725646,87,35,29,6,1
SBI63OBQ3235112,86,19,17,2,1
SBI20LDK4893047,65,28,24,4,1
SBI50XAV4023635,24,25,19,6,1
SBI81RPF6899854,71,22,13,9,1
SBI99LUM8003898,94,29,24,5,1
SBI46ONY4646203,96,24,15,9,1
SBI06XBH6397369,74,21,12,9,1
SBI54FUN1898020,94,24,17,7,1
SBI00CTA7638847,89,20,17,3,1
SBI43GRV7625434,79,30,27,3,1
SBI27VQH5449943,76,29,22,7,1
SBI24ZCR2930678,18,23,21,2,1
SBI94OMZ1390307,24,27,16,11,1
SBI42TDU0424933,23,23,12,11,1
SBI81MFU5997448,22,36,24,12,1
SBI09GSD8314954,70,23,20,3,1
SBI43SXB1895252,98,24,14,10,1
SBI75QPN7288716,23,28,23,5,1
SBI33YSA3274537,67,26,24,2,1
SBI14OVM8405822,24,16,14,2,1
SBI53FOW2913363,23,38,29,9,1
SBI16WUE3395796,21,24,21,3,1
SBI88LDX4061255,90,28,26,2,1
SBI49GVW8488491,94,28,17,11,1
SBI96ACZ9042174,76,27,19,8,1
SBI50XTT7328926,89,24,22,2,1
SBI00XSG4282140,95,16,13,3,1
SBI30PGD4940805,69,22,19,3,1
SBI37NUB2338268,73,20,13,7,1
SBI22ZNO2759228,60,16,12,4,1
SBI30SBN7856687,25,26,21,5,1
SBI52QML5140440,77,25,15,10,1
SBI64STF9256059,20,25,24,1,1
SBI59KYW0048942,22,13,12,1,1
SBI20LHJ9050909,76,37,33,4,1
SBI51UZQ8550143,78,26,20,6,1
SBI22SSR5939998,18,29,26,3,1
SBI80TYK9596091,94,30,16,14,1
SBI40EUN9501806,21,29,26,3,1
SBI00CKP4666761,24,20,11,9,1
SBI87SQU7492965,72,31,26,5,1
SBI27YUN7350630,83,15,14,1,1
SBI66CBW1048630,68,23,14,9,1
SBI38BXV3826455,85,31,28,3,1
SBI11WMX7981005,60,28,27,1,1
SBI12OTE6089421,61,22,15,7,1
SBI92PTC4302874,89,25,22,3,1
SBI66JAS3146881,62,18,12,6,1
SBI79CUR5253923,75,29,27,2,1
SBI88ULZ6261479,73,19,11,8,1
SBI78NLS8856654,67,16,9,7,1
SBI64RTW1900686,88,29,26,3,1
SBI13BEL9446752,64,17,16,1,1
SBI35EQZ2263430,87,31,20,11,1
SBI98RTM3333853,97,31,30,1,1
SBI97LQZ1394693,82,28,25,3,1
SBI71DAR3395904,95,26,14,12,1
SBI81LTT5280280,88,23,16,7,1
SBI68RSE5322301,74,36,35,1,1
SBI12XKD1288397,83,21,17,4,1
SBI95GNP9317516,92,22,18,4,1
SBI07HWP3659661,21,30,25,5,1
SBI00FGS6777180,92,36,25,11,1
SBI57DNE8889832,81,18,11,7,1
SBI73SMC1320235,70,21,15,6,1
SBI88EXN7867108,66,25,21,4,1
SBI58MFS5274072,75,18,14,4,1
SBI83PSB4903537,88,30,16,14,1
SBI29GOV5780947,79,12,10,2,1
SBI84KSN5029974,88,27,14,13,1
SBI52HBX9518846,95,30,17,13,1
SBI58JGQ6982009,77,26,16,10,1
SBI97DWY4113127,67,14,11,3,1
SBI42DYJ1380908,93,16,9,7,1
SBI35ONS7238174,99,22,17,5,1
SBI58OJE6770950,72,23,15,8,1
SBI53JQD9780496,92,20,19,1,1
SBI23UQU1028694,69,32,20,12,1
SBI76HTJ3097092,99,15,8,7,1
SBI10HET1268604,66,35,18,17,1
SBI95BFF3010948,72,28,15,13,1
SBI81CND9658381,65,29,25,4,1
SBI23TNI4442451,79,17,15,2,1
SBI71TGT0094230,79,29,16,13,1
SBI76WYH5483312,74,28,21,7,1
SBI71FNB2552783,81,24,17,7,1
SBI37XTA4411522,79,11,9,2,1
SBI18LGZ8528304,87,26,21,5,1
SBI34BED2973959,95,25,16,9,1
SBI43LYH1651884,77,17,12,5,1
SBI18QID8875655,85,26,17,9,1
SBI37LRO1957667,82,24,13,11,1
SBI43OCI2334902,83,23,22,1,1
SBI43MZS4547715,64,25,16,9,1
SBI50RVY8433961,74,28,16,12,1
SBI73VEA6983926,64,25,23,2,1
SBI30JOE7940206,83,18,14,4,1
SBI86KKN4581941,93,27,18,9,1
SBI78DFK2252618,23,24,21,3,1
SBI57WLU0009697,85,21,18,3,1
SBI33YBZ4043088,78,27,26,1,1
SBI67DLS7191404,93,22,20,2,1
SBI36WSI8367754,82,28,26,2,1
SBI47YFU1225738,71,23,12,11,1
SBI43EQC9852670,90,16,11,5,1
SBI70LZM7730219,23,14,12,2,1
SBI58AXL0512616,23,29,25,4,1
SBI73HGY6736447,68,28,16,12,1
SBI19CZZ8130780,95,22,13,9,1
SBI26JZK5878380,88,18,13,5,1
SBI79WXF8998058,24,26,18,8,1
SBI15SGY8385665,18,30,28,2,1
SBI79NHC9846425,68,25,18,7,1
SBI70RPD2125525,66,21,12,9,1
SBI96RLL5553665,68,26,16,10,1
SBI87DQI8171070,62,29,27,2,1
SBI81JHI6178618,18,17,12,5,1
SBI32AZX1032033,23,21,18,3,1
SBI87SIM9513264,68,27,14,13,1
SBI75EAW7403969,19,17,11,6,1
SBI68LIR5174831,89,24,22,2,1
SBI00IIK5657819,22,23,15,8,1
SBI70WOT5664643,86,26,23,3,1
SBI32QRH8472614,82,34,31,3,1
SBI06VAS5842642,20,19,10,9,1
SBI83MDL9768020,82,20,17,3,1
SBI09RJK6633497,77,35,28,7,1
SBI24XNO5502536,81,21,18,3,1
SBI30IJL1144813,85,23,22,1,1
SBI74DNX6682025,82,28,15,13,1
SBI35CEE9174341,91,23,16,7,1
SBI63HSS2347502,80,23,21,2,1
SBI29AVA0119019,82,23,21,2,1
SBI97WAV8340892,63,25,22,3,1
SBI02CKE4235105,20,29,16,13,1
SBI76CPY1178795,98,28,20,8,1
SBI30BKV5176507,66,23,20,3,1
SBI15HLK9725910,92,19,18,1,1
SBI53IUO2671676,73,36,20,16,1
SBI21GET4038722,89,23,17,6,1
SBI59NHB1958978,92,24,17,7,1
SBI54KSD2191641,66,19,15,4,1
SBI30AAF1485175,94,19,10,9,1
SBI24ZZH5009873,64,15,9,6,1
SBI33FDY8007546,74,25,14,11,1
SBI13HFF1488536,19,10,6,4,1
SBI19PQL7120764,90,25,23,2,1
SBI43RQD7750834,24,25,20,5,1
SBI50YNP2112817,99,20,16,4,1
SBI20UMG5169976,60,26,23,3,1
SBI01UMO2000518,83,25,13,12,1
SBI44WAL5439744,94,23,20,3,1
SBI14TRK5737120,81,23,13,10,1
SBI42XTB1298889,77,28,17,11,1
SBI98TVH9368367,64,18,11,7,1
SBI64BYE6254733,70,23,15,8,1
SBI37UPQ0407667,62,25,23,2,1
SBI39LBE1290009,76,22,18,4,1
SBI12SCS6348309,78,22,20,2,1
SBI90SIP5675817,86,18,12,6,1
SBI89EHO8247039,94,22,14,8,1
SBI53TBC3763084,62,29,28,1,1
SBI67RFE5020803,94,24,16,8,1
SBI12ORV6048583,20,20,19,1,1
SBI94BFA8007091,86,36,27,9,1
SBI93ENP3574908,80,22,14,8,1
SBI33IPB6876754,85,24,13,11,1
SBI94OPH9097547,22,31,16,15,1
SBI68OBP4534922,89,26,24,2,1
SBI04XBN5528742,77,28,17,11,1
SBI91JRU2577229,22,25,21,4,1
SBI12HLM0442430,83,28,18,10,1
SBI50TUV9725016,85,24,14,10,1
SBI01ZSI0857534,91,27,26,1,1
SBI78XJF2290387,72,23,18,5,1
SBI66JNY8115976,67,24,14,10,1
SBI38JKC7208931,76,21,14,7,1
SBI35UQV6040979,96,29,20,9,1
SBI13SLC5201023,71,19,12,7,1
SBI09HHF0493986,64,23,13,10,1
SBI91KGI8564676,68,21,17,4,1
SBI11IGV8260150,76,29,21,8,1
SBI43VSX6321019,82,25,21,4,1
SBI91ONC4780654,99,27,15,12,1
SBI18ENU2759519,87,28,23,5,1
SBI90GXN7305723,93,26,25,1,1
SBI06GXH1083713,23,24,22,2,1
SBI82CJG5754651,92,23,22,1,1
SBI16PEW9446799,72,30,20,10,1
SBI67PPN5061667,64,22,20,2,1
SBI15URC7769692,74,24,16,8,1
SBI74GEZ8073616,78,23,16,7,1
SBI34GQQ8952745,18,24,17,7,1
SBI05HBM6553846,23,22,16,6,1
SBI52DZR1575479,83,24,16,8,1
SBI50OOV7951274,19,29,25,4,1
SBI52MYI6879692,97,32,19,13,1
SBI51KXK6023330,69,27,15,12,1
SBI23NGJ0572062,86,30,29,1,1
SBI00IHU6623054,64,32,18,14,1
SBI94LNF6538528,81,33,25,8,1
SBI66PDI9344146,19,31,18,13,1
SBI50MVV6043808,85,22,17,5,1
SBI63YIQ8657973,61,21,18,3,1
SBI50RAZ6833086,67,24,23,1,1
SBI60UGS9369776,76,21,13,8,1
SBI60NVD0797621,75,21,15,6,1
SBI83MAP1873726,61,23,17,6,1
SBI85ENO7328996,69,24,15,9,1
SBI67OSE7329208,96,26,24,2,1
SBI92VTI9471253,21,16,10,6,1
SBI06ONZ2395212,19,35,26,9,1
SBI60JQV4283360,62,24,13,11,1
SBI51EFO4726359,93,27,21,6,1
SBI64QBP8265221,21,23,20,3,1
SBI34ILZ7762449,66,29,16,13,1
SBI17ICE3469441,79,31,23,8,1
SBI97ITQ5166318,25,32,19,13,1
SBI62MLB8114319,88,21,20,1,1
SBI63ZMQ3005431,82,26,14,12,1
SBI82EPC9087592,83,22,17,5,1
SBI27YYQ0977811,65,24,13,11,1
SBI12HEC0498860,23,33,17,16,1
SBI35TSK0806289,19,27,26,1,1
SBI37IQW2930296,79,29,20,9,1
SBI65BZA7601712,79,28,22,6,1
SBI84IAR0634200,87,28,26,2,1
SBI18YDG3065972,85,16,13,3,1
SBI04PYT5573449,84,25,17,8,1
SBI41IOO1547605,69,23,18,5,1
SBI66IQJ6837091,24,25,16,9,1
SBI91AMW2227454,85,24,14,10,1
SBI89ZMT4289330,19,31,29,2,1
SBI54KUX9855882,72,29,18,11,1
SBI47LMF3352664,76,25,15,10,1
SBI04FHA1850411,19,27,14,13,1
SBI67QPG6816058,69,22,13,9,1
SBI26ZDT4859770,61,29,28,1,1
SBI39PSY2005590,83,25,23,2,1
SBI73SWA2013800,99,21,20,1,1
SBI96DBU2402006,84,31,17,14,1
SBI74UEG9489929,95,28,18,10,1
SBI94CRH1864165,80,26,17,9,1
SBI35KNQ0327307,91,15,10,5,1
SBI83FRT0487811,89,37,36,1,1
SBI20CDA4982205,83,23,15,8,1
SBI48WFQ8722956,77,19,12,7,1
SBI72UKG3785423,71,20,12,8,1
SBI90NYG1349478,67,28,20,8,1
SBI45DZM2745237,90,17,10,7,1
SBI58GJX0819095,98,27,20,7,1
SBI56VDF3028822,93,19,15,4,1
SBI55XYJ2056151,19,30,23,7,1
SBI05ADQ4811960,65,24,23,1,1
SBI63VVA7185352,94,26,15,11,1
SBI96AZN5117480,66,32,26,6,1
SBI55VIF8768197,19,22,16,6,1
SBI41CLT9286776,89,21,12,9,1
SBI87KTP5354417,20,27,20,7,1
SBI94VPQ6560049,72,21,13,8,1
SBI43TBK6055672,18,29,18,11,1
SBI42EUA4348734,21,24,23,1,1
SBI57GUG8530241,77,20,12,8,1
SBI21ZXF0493881,20,17,12,5,1
SBI81IUF8906212,83,27,18,9,1
SBI13EAD9362356,90,22,20,2,1
SBI31HYX9999639,95,23,13,10,1
SBI27LMC1150103,84,19,15,4,1
SBI95VJP4338706,22,19,16,3,1
SBI42YAF0998819,80,21,20,1,1
SBI45RVZ9894811,70,23,18,5,1
SBI35GYI3312501,95,32,20,12,1
SBI12JMG7215080,61,31,26,5,1
SBI63EXB3638413,89,24,17,7,1
SBI82PIP0105169,86,29,16,13,1
SBI55GQJ1025216,93,23,18,5,1
SBI48VLT4521520,66,21,19,2,1
SBI32XVX6399946,61,25,19,6,1
SBI66KWH7681457,60,29,15,14,1
SBI48UQP3527792,99,28,17,11,1
SBI78HUF6151481,86,22,19,3,1
SBI10ELH9934068,99,30,27,3,1
SBI57KID8535915,93,21,14,7,1
SBI49SGL5642378,68,26,21,5,1
SBI92DEF9558759,89,25,16,9,1
SBI07WOW9752883,82,28,20,8,1
SBI77TBG1712556,98,28,24,4,1
SBI92WBB1908558,60,29,22,7,1
SBI08LNG8984672,98,21,14,7,1
SBI50ZRS6417794,25,28,21,7,1
SBI34XFR2934067,84,30,17,13,1
SBI74JOF4155067,66,26,18,8,1
SBI19AXN3467854,78,26,20,6,1
SBI75MRA2222906,67,16,9,7,1
SBI86TTE0965951,75,21,13,8,1
SBI20FMF6446427,65,25,22,3,1
SBI52OSZ6735458,19,26,23,3,1
SBI99SBA5995332,63,20,13,7,1
SBI46LLF5040789,69,28,25,3,1
SBI28GZZ5367061,77,24,23,1,1
SBI78WIU3908903,89,21,12,9,1
SBI05ZBZ1464610,79,20,17,3,1
SBI55YIM8659621,99,27,16,11,1
SBI27NSO8047437,99,18,13,5,1
SBI18DAE4736176,67,18,15,3,1
SBI08SYK2507623,89,30,29,1,1
SBI70ZZG1267705,76,19,11,8,1
SBI87ZXE0206926,91,15,12,3,1
SBI50RWE2285828,20,23,21,2,1
SBI71EUD5879544,25,22,19,3,1
SBI33DNP4736157,70,21,20,1,1
SBI03OIR8248189,80,21,14,7,1
SBI73YCZ5293253,69,16,9,7,1
SBI41GSN8116864,19,31,16,15,1
SBI71YDE5130113,78,33,28,5,1
SBI81JRE3202549,22,26,15,11,1
SBI66ICS3269141,86,28,26,2,1
SBI87THT1848378,78,16,9,7,1
SBI06BST4059872,77,29,17,12,1
SBI02NUZ0066372,88,20,16,4,1
SBI96HKM9459713,91,23,13,10,1
SBI01NDN5939996,68,26,18,8,1
SBI11VSV8831259,69,19,10,9,1
SBI88JBO0017115,73,27,24,3,1
SBI35SEW4547581,75,37,34,3,1
SBI89EMU3065546,68,25,21,4,1
SBI71RGK1006719,66,28,18,10,1
SBI57IIY0203650,25,18,16,2,1
SBI59XSI5431517,64,24,17,7,1
SBI75SWE2740098,78,22,19,3,1
SBI98VRM6397357,66,26,22,4,1
SBI92MUX7790358,65,23,16,7,1
SBI33BCD3360386,77,22,16,6,1
SBI25GIT7938287,72,30,25,5,1
SBI94MIQ9470841,98,31,28,3,1
SBI39BGP8306199,95,34,28,6,1
SBI32CHE0856839,94,19,11,8,1
SBI53VCA8549830,71,21,17,4,1
SBI82ZFC1625966,74,19,16,3,1
SBI50HST5370769,86,21,11,10,1
SBI08OBN1540770,82,19,16,3,1
SBI91MLX2251020,95,30,29,1,1
SBI48ZQX4636987,93,15,13,2,1
SBI67GDP8637383,22,28,24,4,1
SBI92BCA8332250,91,25,21,4,1
SBI70JJY2709648,98,19,10,9,1
SBI74TUJ4069068,66,22,14,8,1
SBI72SVF4346303,74,31,30,1,1
SBI51HUS6509324,81,35,19,16,1
SBI04MGU3378544,96,19,18,1,1
SBI98GVF6445061,61,21,11,10,1
SBI95MZO0975027,69,24,13,11,1
SBI23EPO4199224,76,12,8,4,1
SBI65FBE9964891,91,28,23,5,1
SBI95CLB3622201,62,22,18,4,1
SBI53HCI9990741,20,30,27,3,1
SBI63IWQ1681976,90,26,24,2,1
SBI12XHR8481511,82,34,23,11,1
SBI64LDL7659761,21,36,30,6,1
SBI37ZMP8914029,87,26,24,2,1
SBI19RQG6033194,60,20,16,4,1
SBI22TTP6875577,62,24,17,7,1
SBI98UZQ2487089,67,27,21,6,1
SBI60QUT7970387,66,36,28,8,1
SBI73VMA7868745,81,24,14,10,1
SBI63IQO9945158,72,26,18,8,1
SBI26IMW4114931,19,28,21,7,1
SBI11FGE9044904,82,27,21,6,1
SBI42KBM2573504,92,16,9,7,1
SBI14YWD1222333,72,24,16,8,1
SBI99CIN6883872,84,13,8,5,1
SBI92RYN3568057,65,30,22,8,1
SBI07WXJ1800301,76,25,13,12,1
SBI85XMR6488467,93,21,18,3,1
SBI56TJK0073263,21,25,22,3,1
SBI31LLL2129518,81,14,8,6,1
SBI94TQY3275990,77,28,20,8,1
SBI13FKF3408553,71,21,18,3,1
SBI22CWC3473455,75,16,15,1,1
SBI87DSA6347053,22,26,21,5,1
SBI47TWD9738409,80,21,19,2,1
SBI88GYB2599116,93,24,17,7,1
SBI41DHB4382263,95,27,25,2,1
SBI67GZT5402915,18,22,18,4,1
SBI08LWB4742911,86,20,17,3,1
SBI52GZK0087286,66,33,22,11,1
SBI80GAI0026196,77,25,15,10,1
SBI65VXY3139473,60,22,13,9,1
SBI06VZC7032107,71,30,27,3,1
SBI70NYP3404387,74,23,14,9,1
SBI60KBQ1822576,65,24,23,1,1
SBI51TFQ8805099,64,16,13,3,1
SBI09GIR7779932,90,20,12,8,1
SBI78IGU9013563,82,28,24,4,1
SBI38EES7967729,81,25,20,5,1
SBI13SSZ1535221,74,25,14,11,1
SBI63XFB0293626,81,21,14,7,1
SBI13ZWX6292342,83,20,14,6,1
SBI86BOR5689770,65,23,14,9,1
SBI63YWW4160564,97,38,20,18,1
SBI19CDM6128934,63,26,20,6,1
SBI59MEY0943650,24,21,16,5,1
SBI69LTD9595691,60,26,16,10,1
SBI24IBX7394627,85,20,15,5,1
SBI24RRY0022887,61,31,17,14,1
SBI87XJE1275154,95,33,24,9,1
SBI78YTW2475832,66,22,20,2,1
SBI53KQT1473417,82,28,18,10,1
SBI91VCV2837779,77,27,17,10,1
SBI93THN1731261,60,25,14,11,1
SBI98OZL5638524,72,24,23,1,1
SBI03JVT6748197,65,17,12,5,1
SBI40SRQ7118886,70,24,14,10,1
SBI10SZO3089210,83,25,18,7,1
SBI28RVN5985396,92,28,16,12,1
SBI48HKS3700522,20,29,15,14,1
SBI90VTQ9539175,64,28,21,7,1
SBI20OSS2820458,80,21,18,3,1
SBI03GTR1123015,61,23,17,6,1
SBI68VQH2414290,88,29,28,1,1
SBI86IOO6365534,69,21,13,8,1
SBI16MJF8646871,64,32,23,9,1
SBI91PHB8360134,90,37,22,15,1
SBI70UIZ4016686,74,22,20,2,1
SBI31JNQ6011741,99,21,18,3,1
SBI59TLC5639890,91,24,14,10,1
SBI55PDN2215353,78,24,18,6,1
SBI29TAL4188015,66,17,16,1,1
SBI48WQU5992104,77,28,24,4,1
SBI73DAB2310989,77,23,13,10,1
SBI42FLY7714965,62,17,16,1,1
SBI23NQX0025339,18,19,10,9,1
SBI17DLC7254154,84,26,17,9,1
SBI65WAI0021391,72,23,16,7,1
SBI33YJJ0063201,78,25,21,4,1
SBI26FVZ0022963,73,21,18,3,1
SBI91ZKU3324950,78,31,30,1,1
SBI61GJS0115460,78,24,21,3,1
SBI88JVS9984904,62,28,23,5,1
SBI18BCG8269851,83,29,22,7,1
SBI70GTF3583377,62,23,12,11,1
SBI71BNX0976661,66,26,15,11,1
SBI22ZPN0099063,66,26,18,8,1
SBI19ZLH7627084,92,30,26,4,1
SBI61QXG4618524,65,21,19,2,1
SBI06SSH6603262,62,29,22,7,1
SBI17RYM2096997,70,22,19,3,1
SBI09TCB1408356,67,30,28,2,1
SBI29HZM0495206,92,20,12,8,1
SBI29EDU3925943,72,21,14,7,1
SBI21EWL5708304,91,23,22,1,1
SBI90NZY3638639,92,24,15,9,1
SBI04DRP3733226,76,22,17,5,1
SBI69TCW2449934,61,21,18,3,1
SBI05KEP3377353,98,24,17,7,1
SBI69CRP8736679,64,22,12,10,1
SBI66LWB8930512,19,20,13,7,1
SBI73KKL1872050,89,26,23,3,1
SBI30OLE7703123,73,29,21,8,1
SBI16UIK2517032,20,15,13,2,1
SBI75UOL9129651,67,28,20,8,1
SBI27TAC8240347,22,20,18,2,1
SBI77ZOX0530886,77,30,29,1,1
SBI16RMY6351527,90,26,24,2,1
SBI19XLF6653429,92,27,23,4,1
SBI57YWX7827756,85,27,25,2,1
SBI61HUR4493818,23,21,19,2,1
SBI25NOW4296219,64,27,26,1,1
SBI52ZVD6243822,63,24,17,7,1
SBI56HYL6143433,24,25,15,10,1
SBI99FDY2915530,67,17,9,8,1
SBI04XUX1164609,18,31,21,10,1
SBI53SFE2723018,66,19,14,5,1
SBI82OCC1519806,83,36,30,6,1
SBI76LPZ6431212,69,16,11,5,1
SBI76QQY6632843,78,20,15,5,1
SBI70QGT5405205,79,25,16,9,1
SBI19YJX1067217,74,23,20,3,1
SBI44JZQ0230381,93,32,17,15,1
SBI67MWZ9004705,18,28,15,13,1
SBI91GJE3578215,62,17,11,6,1
SBI55LUT7936714,95,23,22,1,1
SBI38NPO8484656,20,28,24,4,1
SBI38NMG6896033,19,27,20,7,1
SBI65XAZ8620940,71,27,19,8,1
SBI96BFZ8595088,90,24,20,4,1
SBI13PFI6588806,75,25,14,11,1
SBI11NQX5294117,66,28,18,10,1
SBI23APR8100929,78,17,13,4,1
SBI30LFK0090922,23,17,14,3,1
SBI09NEU6135720,89,28,21,7,1
SBI83EGA0756147,64,25,14,11,1
SBI12LXK3215753,23,27,26,1,1
SBI15YWC2802620,63,25,20,5,1
SBI61LUQ4037363,20,18,15,3,1
SBI58OZO1759608,21,32,19,13,1
SBI41GPA8336860,75,26,19,7,1
SBI49RLX7588398,98,29,15,14,1
SBI49ZGQ7049298,65,27,23,4,1
SBI35XPE6163809,90,23,12,11,1
SBI48MKF1124740,65,26,15,11,1
SBI80QOZ4500900,76,20,11,9,1
SBI53OKG4386369,62,20,14,6,1
SBI16GEP6345186,99,29,26,3,1
SBI69LAH6032679,92,25,14,11,1
SBI27XQB0780790,87,24,13,11,1
SBI47IPI9751559,24,23,14,9,1
SBI35DQG0052836,93,38,30,8,1
SBI40MZT6832167,69,24,23,1,1
SBI97MLS4242036,19,28,19,9,1
SBI95RPP1808379,20,27,22,5,1
SBI06NBU8514376,77,16,10,6,1
SBI12IQI9343376,18,26,24,2,1
SBI29XGX6378880,81,35,19,16,1
SBI42BHW1317901,91,19,14,5,1
SBI52BVJ2343341,73,33,25,8,1
SBI63PVR4474650,93,26,21,5,1
SBI08FRW5693330,74,30,22,8,1
SBI55EQR0643197,62,23,12,11,1
SBI04PTN9427315,25,30,17,13,1
SBI37UXR6130352,96,27,17,10,1
SBI88ZZT2712563,63,19,14,5,1
SBI90KRR4043073,61,22,14,8,1
SBI43PNW0832498,99,27,17,10,1
SBI42DSL9990347,68,26,20,6,1
SBI84VUZ0444120,73,32,24,8,1
SBI49TVF3796973,98,25,19,6,1
SBI58NZO6854801,25,27,17,10,1
SBI03FQT7050129,60,23,15,8,1
SBI74APR9359148,82,19,13,6,1
SBI02JZW7080143,76,27,23,4,1
SBI65PMN5897494,21,22,14,8,1
SBI68XSI6516510,21,24,23,1,1
SBI65EOR8734041,71,12,7,5,1
SBI40SFO5230968,22,22,15,7,1
SBI25DLX6508617,62,28,15,13,1
SBI11OOT1630683,73,26,21,5,1
SBI68RMO8071610,60,20,16,4,1
SBI59BDC7399039,91,23,14,9,1
SBI29CCQ6480243,77,31,23,8,1
SBI24YYR5613549,89,29,21,8,1
SBI60CQI5598252,94,28,20,8,1
SBI47DAW6410372,63,31,29,2,1
SBI74VUA7659177,67,20,12,8,1
SBI54SSH6469658,99,25,13,12,1
SBI80KIR5868535,76,28,22,6,1
SBI01ZHD4738554,66,24,15,9,1
SBI57BPG5865840,97,27,18,9,1
SBI82GUN4077799,78,25,21,4,1
SBI92DKR3607309,82,38,34,4,1
SBI19SFU5273541,64,32,17,15,1
SBI78YXC0633447,64,28,17,11,1
SBI03XZQ0904691,82,19,16,3,1
SBI24ZMZ0003422,97,23,20,3,1
SBI30YVT9128155,86,28,16,12,1
SBI06FLZ3640831,81,22,21,1,1
SBI75OTV2332660,65,19,15,4,1
SBI93JGZ4897038,81,30,25,5,1
SBI42XYU5938112,68,28,26,2,1
SBI15DOO4422948,86,10,6,4,1
SBI44RTN1137429,95,21,14,7,1
SBI20YDQ5271337,73,41,26,15,1
SBI11GJU3090426,74,15,12,3,1
SBI53VOG9661166,92,31,23,8,1
SBI85AEU6953872,22,30,28,2,1
SBI62CAQ7833307,98,26,22,4,1
SBI11DQN6079998,65,27,18,9,1
SBI26IMJ2241407,98,18,13,5,1
SBI07NXP0366781,71,22,18,4,1
SBI07IKM8042951,72,27,14,13,1
SBI27BQD6295973,75,27,15,12,1
SBI61JQN8384265,98,16,12,4,1
SBI00XEG4516293,75,26,21,5,1
SBI43YAV4737987,90,32,28,4,1
SBI29SCP7359511,85,24,18,6,1
SBI32YKA8163591,94,29,16,13,1
SBI73KVS1825297,66,22,13,9,1
SBI07SHX5929237,25,36,22,14,1
SBI03UEN7454739,90,25,22,3,1
SBI51CDD6599391,79,14,10,4,1
SBI93LNR9750536,66,32,24,8,1
SBI72HAJ9856336,68,24,19,5,1
SBI63TMN2640450,76,26,16,10,1
SBI12OKP3452703,91,30,22,8,1
SBI40LFE5134084,89,19,17,2,1
SBI27NUF7012479,72,25,23,2,1
SBI79CPK9422081,99,32,26,6,1
SBI63VAG0054340,20,24,17,7,1
SBI11UPZ4925214,97,31,29,2,1
SBI48YFP6267942,61,17,10,7,1
SBI13SXO5115995,67,24,23,1,1
SBI64VSX7435762,87,35,29,6,1
SBI88ZNI1257124,81,31,24,7,1
SBI73IUM4599822,94,23,15,8,1
SBI37KCB4479823,96,28,22,6,1
SBI79WLU3341177,75,24,18,6,1
SBI14RXI4142533,81,27,23,4,1
SBI75SNF0421062,96,31,17,14,1
SBI81KXU6104346,79,17,14,3,1
SBI30AHD9789407,99,27,15,12,1
SBI31QLD0241123,76,18,10,8,1
SBI29DSS1398415,74,21,12,9,1
SBI89DYE2877130,23,22,19,3,1
SBI02LKM6993513,85,26,19,7,1
SBI51OJV8475121,99,32,23,9,1
SBI05TAB2470531,97,25,21,4,1
SBI56YZX7244901,77,21,14,7,1
SBI44RLD9818124,74,25,23,2,1
SBI94ZDE6813836,92,32,22,10,1
SBI01CMV0716867,67,23,12,11,1
SBI04QZO2891524,81,28,15,13,1
SBI83LVD8453644,93,27,25,2,1
SBI20TXD9427380,87,19,17,2,1
SBI30MLX7604057,68,22,16,6,1
SBI98JUL1705076,62,27,21,6,1
SBI77FSU6888580,94,19,18,1,1
SBI62EYS9587381,85,20,19,1,1
SBI74VLR7601007,94,27,19,8,1
SBI96BBJ4586969,96,22,14,8,1
SBI45PQV5851295,89,23,19,4,1
SBI24SRM4144286,99,18,13,5,1
SBI16PJR4377199,19,25,18,7,1
SBI76SEL8901587,82,27,17,10,1
SBI67VOE7741807,77,19,15,4,1
SBI25TXS3764891,23,23,20,3,1
SBI12TMA3114246,68,20,17,3,1
SBI96ABK4553994,67,21,14,7,1
SBI18PBP2350967,73,21,14,7,1
SBI66VMR6347788,24,27,20,7,1
SBI04MHT2382779,67,21,19,2,1
SBI48NIZ4282794,19,31,17,14,1
SBI96QZW2436521,98,22,18,4,1
SBI01LCO1471796,87,23,14,9,1
SBI87LDZ1453582,24,21,14,7,1
SBI15JIP0409186,98,26,20,6,1
SBI14VGW1022625,91,31,27,4,1
SBI32ZJE8800484,67,27,14,13,1
SBI98RJC8239351,98,36,19,17,1
SBI00DKM8159502,95,14,11,3,1
SBI37KUR2690912,75,25,21,4,1
SBI15TOJ2920403,62,23,15,8,1
SBI49GVZ4576665,85,18,16,2,1
SBI17KFC2670228,65,35,20,15,1
SBI74YXA1212851,92,24,17,7,1
SBI29GVL0141711,89,19,14,5,1
SBI22YUD3151307,21,25,21,4,1
SBI88FDY2217970,71,16,11,5,1
SBI46DLL4564052,98,27,24,3,1
SBI29GHT0505198,84,17,15,2,1
SBI95JOV2317250,98,28,22,6,1
SBI50BSA4924566,99,31,17,14,1
SBI48ABD6968184,68,20,18,2,1
SBI64SYD7420423,71,21,20,1,1
SBI01KCK1490886,66,15,8,7,1
SBI30ZLE5027135,69,27,21,6,1
SBI06REO3588452,60,26,16,10,1
SBI91BTF5496076,77,22,16,6,1
SBI21PPC6334469,91,27,15,12,1
SBI08ASI8069332,68,32,28,4,1
SBI44GFX2746647,85,20,11,9,1
SBI06LHN9744067,83,24,15,9,1
SBI29WLK1483137,86,32,30,2,1
SBI56HSU3353937,82,36,23,13,1
SBI33UWV1810346,73,23,21,2,1
SBI85CBW0831438,61,30,29,1,1
SBI13QNQ4048203,97,23,14,9,1
SBI44ZOT3939775,90,29,15,14,1
SBI88PVH8535009,83,17,9,8,1
SBI87SAA9223814,92,42,41,1,1
SBI34NRA5806825,92,21,17,4,1
SBI89VKS9731784,25,22,20,2,1
SBI16RBZ7974377,66,19,15,4,1
SBI93TUC5563335,98,29,26,3,1
SBI05XHZ7125993,88,21,17,4,1
SBI93SOX9001649,99,17,9,8,1
SBI35DUY8837215,67,38,23,15,1
SBI77UQZ2633884,87,19,13,6,1
SBI82YHN4674806,75,33,24,9,1
SBI66VTK3940168,65,20,19,1,1
SBI96LOP2161420,72,17,10,7,1
SBI15GMZ7790498,81,27,21,6,1
SBI49OCX9077045,20,24,17,7,1
SBI84RPK9826535,93,22,21,1,1
SBI16CWB7303229,60,22,19,3,1
SBI67AJK1755464,78,30,25,5,1
SBI82ETE4981136,97,15,8,7,1
SBI39ZFW2599910,93,21,16,5,1
SBI11MTQ4729650,88,24,14,10,1
SBI84RCX1344344,66,17,10,7,1
SBI46OEO2871221,77,27,16,11,1
SBI12FIA2842590,93,18,14,4,1
SBI66QZL8045363,85,20,18,2,1
SBI72MYF1821986,74,30,20,10,1
SBI80SKR1939399,20,26,16,10,1
SBI87EAF0144950,81,23,13,10,1
SBI07YCW6857028,84,19,14,5,1
SBI36GWL2844421,84,23,15,8,1
SBI43WPM1263834,65,13,7,6,1
SBI29JXW0933913,63,23,12,11,1
SBI30DYU3333514,97,31,20,11,1
SBI98MNG5200186,85,23,13,10,1
SBI09UZW6306244,22,20,19,1,1
SBI14POT5665455,82,29,18,11,1
SBI69XRF9582756,61,27,21,6,1
SBI66CJK2819462,63,25,22,3,1
SBI67KZY8062955,65,20,17,3,1
SBI04HFH5700395,99,36,22,14,1
SBI21GCU5717943,77,22,12,10,1
SBI95YEN8058062,65,22,12,10,1
SBI46GAB8653316,92,25,20,5,1
SBI90GFF1129642,84,20,17,3,1
SBI40GHA9589027,93,27,19,8,1
SBI39BWH7186281,71,19,17,2,1
SBI77ZOY1376697,69,18,17,1,1
SBI03RSO7157753,73,26,20,6,1
SBI79JMV9198805,20,32,28,4,1
SBI00SIA9737786,86,24,13,11,1
SBI79ZHX3520943,23,21,13,8,1
SBI55BGJ1995403,72,18,16,2,1
SBI98BWW4416894,93,26,23,3,1
SBI27CVH6048915,89,22,13,9,1
SBI03NRU0504270,83,27,17,10,1
SBI98JQN9843376,25,28,21,7,1
SBI66PHU0355017,85,28,19,9,1
SBI16OAJ0096925,89,23,19,4,1
SBI04QHU2820193,19,29,18,11,1
SBI52QXR0054322,73,25,23,2,1
SBI05BUK3204414,71,32,17,15,1
SBI24TFD9948380,79,28,24,4,1
SBI68NJV8293587,75,20,16,4,1
SBI60PLB7546324,84,19,15,4,1
SBI39CDT9922568,81,22,14,8,1
SBI79JXN3902494,71,19,18,1,1
SBI54MSQ0043561,94,20,18,2,1
SBI02EJH0662952,98,23,17,6,1
SBI84VDH6394868,90,24,18,6,1
SBI73AXO0717791,23,22,13,9,1
SBI68KOM2185675,75,24,16,8,1
SBI28LLX7692656,18,26,20,6,1
SBI48CIH1039198,63,34,33,1,1
SBI02PRR3798034,92,28,22,6,1
SBI59DJQ6051387,71,24,15,9,1
SBI31SJC0053375,97,22,14,8,1
SBI70YVN5025370,68,31,22,9,1
SBI81OOY2373617,96,33,21,12,1
SBI48MUA9154849,23,20,11,9,1
SBI92IWK0038745,97,26,14,12,1
SBI37SCT0692188,23,23,18,5,1
SBI69ZLM3098158,68,18,14,4,1
SBI31RCO7416755,64,28,20,8,1
SBI82WQI1312947,83,25,24,1,1
SBI09CCG3023152,83,26,21,5,1
SBI89TMY9906723,76,24,22,2,1
SBI97BHE3087253,88,24,19,5,1
SBI11ART8261347,71,26,16,10,1
SBI49HAF0717197,81,31,27,4,1
SBI12QCL9563488,98,20,11,9,1
SBI04EAQ3365744,97,20,13,7,1
SBI21XIL7718727,92,28,18,10,1
SBI95OPD9895529,93,20,18,2,1
SBI58XWO2340687,92,23,17,6,1
SBI71IML1795395,25,35,26,9,1
SBI13GUF2173243,18,27,24,3,1
SBI64ICJ9853144,70,20,16,4,1
SBI54TUY8220811,82,27,24,3,1
SBI28JAD9554617,67,14,13,1,1
SBI70UMG2646527,96,28,16,12,1
SBI74SZW6509541,88,17,9,8,1
SBI74VCZ6177253,22,30,28,2,1
SBI68WLQ5208730,71,18,12,6,1
SBI71GBU8693541,98,28,18,10,1
SBI80WAK4407497,68,27,16,11,1
SBI20XFE4640125,72,23,18,5,1
SBI32AIC3022705,97,26,25,1,1
SBI51SFY4184175,72,19,11,8,1
SBI31WZW7376912,21,29,22,7,1
SBI43FFS2870654,61,21,12,9,1
SBI38SNG6547604,24,26,17,9,1
SBI33BDM9495743,82,22,13,9,1
SBI24VFF1066953,22,34,31,3,1
SBI40TRR2542299,75,39,30,9,1
SBI56GBO2165296,76,31,23,8,1
SBI30TCP7474909,91,29,15,14,1
SBI98TIU5651026,64,25,23,2,1
SBI21DYV3077105,94,23,17,6,1
SBI27KPZ7476363,84,27,26,1,1
SBI31EJU6826829,82,12,8,4,1
SBI29WQS9419878,86,29,16,13,1
SBI35BYP8169879,81,31,19,12,1
SBI74MVP4542767,71,24,15,9,1
SBI19IGL5289139,60,20,15,5,1
SBI93NXT9626098,93,21,20,1,1
SBI01HQQ3557015,73,26,15,11,1
SBI65PAH5453054,68,30,26,4,1
SBI07FMT0692784,86,26,14,12,1
SBI08ROK6333002,81,19,13,6,1
SBI56CIF4561501,86,22,19,3,1
SBI46BNG3170387,92,28,27,1,1
SBI39VNO2346703,90,33,32,1,1
SBI57EZL7049437,69,15,9,6,1
SBI41RIC8618244,88,24,16,8,1
SBI37KRU1217052,86,32,17,15,1
SBI40ACS1124242,95,26,18,8,1
SBI13EZC9835175,95,28,19,9,1
SBI70JOU3156716,81,21,18,3,1
SBI35CUE0871660,64,17,10,7,1
SBI37XJL3530778,21,27,25,2,1
SBI70SRY0652985,83,24,15,9,1
SBI81BCC9268493,64,22,14,8,1
SBI26ITT7939728,73,19,18,1,1
SBI50ZJP2164342,97,22,16,6,1
SBI67CFX0012122,86,31,21,10,1
SBI60KQE9558779,25,20,11,9,1
SBI86SSP6386353,62,26,21,5,1
SBI37VYO9626666,81,33,25,8,1
SBI55YNY1834903,99,28,15,13,1
SBI59XEQ7356563,93,16,13,3,1
SBI64GZH5191278,18,20,17,3,1
SBI95MLY4879514,91,22,13,9,1
SBI63WXU2365127,21,21,14,7,1
SBI11YXJ9373561,95,31,24,7,1
SBI97ASE8051946,85,34,18,16,1
SBI23IVV4668299,75,17,10,7,1
SBI32DCT1442815,67,28,20,8,1
SBI01AVR9065337,85,23,20,3,1
SBI97TXB9278412,90,26,24,2,1
SBI46LIH9258613,95,25,20,5,1
SBI40RND0252784,60,17,10,7,1
SBI80OUT1562463,81,22,19,3,1
SBI84JXL4280145,70,23,13,10,1
SBI93PRM7940066,68,28,16,12,1
SBI56SRF1826430,88,31,22,9,1
SBI90GRB7519582,70,20,16,4,1
SBI02UJY4545953,98,21,11,10,1
SBI39NSN2058948,81,24,20,4,1
SBI03MMR4391875,60,23,16,7,1
SBI28WXP9077957,86,24,23,1,1
SBI65UAN6532415,62,28,21,7,1
SBI44OTJ7331046,18,28,27,1,1
SBI18UDL9241025,73,32,18,14,1
SBI45VBN5890219,87,17,16,1,1
SBI56JVF7972947,93,27,25,2,1
SBI68ZBX3401012,66,21,13,8,1
SBI61QJK6336191,95,21,14,7,1
SBI12YTT5790479,84,30,29,1,1
SBI95JXF9192130,95,15,12,3,1
SBI29VYS8778257,93,24,21,3,1
SBI10SVF4602518,93,24,15,9,1
SBI09APG4301732,91,16,10,6,1
SBI89KSF9387604,63,30,21,9,1
SBI77TZF5687247,72,28,16,12,1
SBI43GKJ0239964,72,27,25,2,1
SBI85FPE2392791,61,28,19,9,1
SBI06KQB2338294,84,21,19,2,1
SBI02NGY9418966,83,33,19,14,1
SBI63UOS3798518,61,25,14,11,1
SBI28XTC8638373,66,30,23,7,1
SBI36WLP9308330,68,22,19,3,1
SBI01PVV7208598,71,25,15,10,1
SBI46WFO0079256,92,32,21,11,1
SBI43YUA5144580,81,23,18,5,1
SBI14VPV2217438,24,24,21,3,1
SBI03AAG9035273,24,24,13,11,1
SBI87RQX2284775,62,26,25,1,1
SBI38PHU3927236,69,11,6,5,1
SBI63FJV2477653,70,20,16,4,1
SBI22EHT5605063,74,20,19,1,1
SBI67EDL5171936,25,33,22,11,1
SBI33QCF3740399,91,20,14,6,1
SBI31ZET2544791,66,23,20,3,1
SBI54WAF4939121,63,23,12,11,1
SBI23RSC1336894,69,29,28,1,1
SBI17SQC1504938,64,22,15,7,1
SBI05LPH7790090,64,26,21,5,1
SBI36CLV7899335,24,25,17,8,1
SBI54WFY9663690,22,21,20,1,1
SBI17RSN7836063,98,25,21,4,1
SBI42UYS7336880,23,27,24,3,1
SBI46PAL7926770,72,27,19,8,1
SBI36JIK5290015,88,35,21,14,1
SBI17ZTW1222983,24,15,8,7,1
SBI66AHC9346407,77,26,25,1,1
SBI33RKM5512596,65,31,28,3,1
SBI93EHF9385947,77,28,17,11,1
SBI55WIK2068795,73,36,19,17,1
SBI94FFW3525613,65,20,17,3,1
SBI83ELA0261796,62,38,20,18,1
SBI81EDO0461648,69,31,29,2,1
SBI38VVF8285545,80,20,18,2,1
SBI71SMY4882692,98,28,20,8,1
SBI05YIR3542616,90,26,17,9,1
SBI56YWW2746990,79,34,29,5,1
SBI77TTH5824286,18,21,17,4,1
SBI47VMC3105496,77,20,19,1,1
SBI73JVQ6690766,68,29,20,9,1
SBI98NSI4558310,18,24,13,11,1
SBI74MGS5346987,73,25,14,11,1
SBI47WPN6062092,63,26,24,2,1
SBI23KPL6679331,60,18,11,7,1
SBI03XZM3343408,94,22,16,6,1
SBI81EZW0440338,24,13,10,3,1
SBI80FTM4042023,86,26,20,6,1
SBI88MDU7501006,88,11,7,4,1
SBI76WFQ8342312,19,30,27,3,1
SBI24UCE6471644,64,21,16,5,1
SBI18AXI1960922,89,24,17,7,1
SBI54NDS0976803,21,23,19,4,1
SBI15RCW0072091,69,29,21,8,1
SBI33JHX1678113,91,25,19,6,1
SBI65FFF3881082,87,19,14,5,1
SBI35UQU5438581,65,12,9,3,1
SBI18ULX8157143,84,22,15,7,1
SBI53AIH8733542,75,23,17,6,1
SBI80YUA8597560,21,39,28,11,1
SBI81SIY9979344,86,14,12,2,1
SBI16ADD3786818,66,20,15,5,1
SBI25JAS0682290,25,30,29,1,1
SBI26XSU6466904,65,25,20,5,1
SBI78VRR1012573,92,20,11,9,1
SBI84HPE3469544,22,22,18,4,1
SBI94RFN5415019,64,32,23,9,1
SBI49WHI2662591,63,18,16,2,1
SBI11WOY7614286,94,28,17,11,1
SBI26FWB9243576,23,31,21,10,1
SBI14OKX5260135,70,22,21,1,1
SBI07THC5438665,87,29,19,10,1
SBI57CRS4405512,91,33,25,8,1
SBI08TZY3407015,73,24,15,9,1
SBI05GFC7020879,19,32,22,10,1
SBI67BOZ0740552,82,28,18,10,1
SBI26FWG3834341,88,31,22,9,1
SBI22AMD4586539,86,16,11,5,1
SBI75BMG0821833,68,33,21,12,1
SBI94TKZ8970181,19,23,18,5,1
SBI53NUZ2245264,64,24,14,10,1
SBI38XWN7096293,64,25,21,4,1
SBI60RUN1162330,94,27,20,7,1
SBI36OHN2656668,94,28,15,13,1
SBI11JTX1532046,97,30,19,11,1
SBI28IKZ2471300,78,16,15,1,1
SBI19MTL1191665,96,20,19,1,1
SBI41UXU9894803,93,25,22,3,1
SBI29IWU0370521,18,29,18,11,1
SBI65QTE8568907,78,22,14,8,1
SBI79OYW3571494,82,20,19,1,1
SBI89QRR6423073,19,19,15,4,1
SBI80DQR6161699,72,21,16,5,1
SBI56FPT0993847,66,21,14,7,1
SBI75FEQ4130355,75,29,26,3,1
SBI02JTV9122983,74,26,15,11,1
SBI82EDT8756547,81,29,19,10,1
SBI81ORE0084868,94,22,13,9,1
SBI01BCA3702905,79,23,13,10,1
SBI67CSR3389156,85,32,23,9,1
SBI86JIE9948942,67,19,15,4,1
SBI42XVH7426177,98,21,19,2,1
SBI23KNW1874854,77,22,15,7,1
SBI61CMQ9085525,93,11,9,2,1
SBI98LGO8348824,92,29,21,8,1
SBI97FYG3505998,99,19,15,4,1
SBI30XOM2116637,94,25,24,1,1
SBI59ULX2769560,61,29,26,3,1
SBI70SBH0874118,84,23,22,1,1
SBI30SRP5180480,22,23,14,9,1
SBI95HRM3219122,92,22,17,5,1
SBI55AYI6871204,96,18,16,2,1
SBI40FPB1374504,76,31,17,14,1
SBI04PSM0736173,74,23,14,9,1
SBI00NIX3851454,63,27,26,1,1
SBI96DNO4507009,75,26,16,10,1
SBI46ZKZ1685614,82,25,19,6,1
SBI72RYO2602222,75,34,29,5,1
SBI70RMI5963878,24,25,23,2,1
SBI43XCA1410783,72,20,19,1,1
SBI31MVL8786837,19,32,18,14,1
SBI70YYD4578735,85,26,19,7,1
SBI55LHF8251322,79,26,19,7,1
SBI28BZI1831636,74,24,16,8,1
SBI19COW0235550,24,26,20,6,1
SBI01VQC1850710,89,34,20,14,1
SBI70ZRX6165386,92,27,19,8,1
SBI83EYL2879597,60,27,18,9,1
SBI91PMG3601217,77,23,14,9,1
SBI90KMR0928081,65,24,20,4,1
SBI88TKT1974981,75,24,23,1,1
SBI33JYW5302008,67,32,28,4,1
SBI74UJE0801650,69,26,17,9,1
SBI35SDN8057283,98,23,20,3,1
SBI22TAV5669977,85,22,18,4,1
SBI13KXK4219524,82,27,23,4,1
SBI41OMJ0451069,24,21,17,4,1
SBI07ZZR5156767,87,25,19,6,1
SBI53NVE1084424,24,26,15,11,1
SBI71NUU8370927,60,17,16,1,1
SBI13SSP0766147,84,30,28,2,1
SBI80KKA0268498,76,25,13,12,1
SBI21POK0055436,24,22,21,1,1
SBI17WMK8086559,97,30,26,4,1
SBI06ONT2287869,68,26,20,6,1
SBI95ASO3868199,62,24,17,7,1
SBI01CAV0274395,89,25,22,3,1
SBI16UOE5493542,90,30,24,6,1
SBI35YMI1133354,76,30,29,1,1
SBI62PIE5416121,86,17,11,6,1
SBI99VKO9122392,72,26,21,5,1
SBI65RYE0500434,18,22,19,3,1
SBI00HXZ6593720,94,21,12,9,1
SBI37GUS6804521,94,35,31,4,1
SBI74UCW5103899,72,28,22,6,1
SBI50CCD4011835,92,27,19,8,1
SBI54RUW2322516,62,24,19,5,1
SBI32TDA1226519,97,35,22,13,1
SBI27NGD3384290,61,26,15,11,1
SBI76QNQ1357990,66,23,22,1,1
SBI77YZJ1280648,71,28,21,7,1
SBI44WYO4728857,81,29,22,7,1
SBI79YSV5615368,69,12,8,4,1
SBI45DVV4910406,79,26,18,8,1
SBI69SPK4353842,94,32,24,8,1
SBI52JSJ5240328,61,22,16,6,1
SBI61ZCO7111761,94,17,10,7,1
SBI64MEH1918123,78,23,21,2,1
SBI95WAN5560802,66,24,22,2,1
SBI87YRB2944730,25,25,19,6,1
SBI80WTP8095965,74,27,18,9,1
SBI08MIN6277180,20,19,11,8,1
SBI44JXJ9224445,68,30,19,11,1
SBI69JYU0374981,72,27,16,11,1
SBI92EBZ1286364,23,25,23,2,1
SBI75BXN9929156,60,27,23,4,1
SBI98OGX4589938,20,31,25,6,1
SBI28TAN5042877,83,24,23,1,1
SBI55JPR2030991,99,22,17,5,1
SBI91WXA0968491,22,22,18,4,1
SBI97OCT3345391,86,24,17,7,1
SBI83OPH5676418,21,25,20,5,1
SBI05EZH2444825,80,27,23,4,1
SBI78SDI9943937,18,25,16,9,1
SBI88VOH9220644,24,23,12,11,1
SBI26IWN8548910,78,15,11,4,1
SBI07MJZ8791370,69,32,28,4,1
SBI28BPN7933314,87,22,19,3,1
SBI64DCT0257956,76,25,16,9,1
SBI28OZC3055556,61,32,23,9,1
SBI00CIJ8436407,62,19,11,8,1
SBI12GQU3030729,70,24,13,11,1
SBI23GCR0371623,95,33,28,5,1
SBI46EQJ0814089,96,29,16,13,1
SBI63NRW5134514,67,26,14,12,1
SBI39XVX0734652,95,27,15,12,1
SBI31SKF2574060,82,19,14,5,1
SBI75WIO4047015,94,22,15,7,1
SBI99WOM6708792,68,25,14,11,1
SBI72UIT7798268,73,22,20,2,1
SBI31EMI8441605,70,27,23,4,1
SBI78GNL8418477,97,22,12,10,1
SBI90SYI0776820,84,22,14,8,1
SBI22OFB8124726,74,29,15,14,1
SBI00LSA8460417,61,23,16,7,1
SBI06MNX0001835,95,28,21,7,1
SBI77ZEQ5251295,23,36,29,7,1
SBI61MCD8770107,65,27,19,8,1
SBI21ZCP1500019,98,23,12,11,1
SBI04VQW3629606,83,19,12,7,1
SBI32EKM1253932,20,18,16,2,1
SBI74KYS9994417,88,23,17,6,1
SBI04OPS2237723,66,30,28,2,1
SBI64RYS5618361,79,21,16,5,1
SBI76UNB6028501,84,26,24,2,1
SBI79QLF4887131,66,19,17,2,1
SBI08HMD4494999,70,23,15,8,1
SBI58IXE7793240,83,23,15,8,1
SBI93DOP1659831,70,29,17,12,1
SBI11SYO2482123,93,22,19,3,1
SBI80WYY7800835,19,17,9,8,1
SBI22HPG1436978,83,27,20,7,1
SBI64GBL2362469,62,30,23,7,1
SBI09MIB3154036,88,31,16,15,1
SBI50EDH4325996,68,28,17,11,1
SBI22TXH0640996,20,15,8,7,1
SBI38RQE7968216,19,31,17,14,1
SBI28QAK9018182,88,27,25,2,1
SBI01VXJ7601554,80,28,20,8,1
SBI44RQP0924460,60,27,15,12,1
SBI84YGA3472531,92,25,13,12,1
SBI07FHV5358074,70,26,19,7,1
SBI11QJM2301990,98,27,18,9,1
SBI69XOI4425828,60,26,20,6,1
SBI44APU6985721,75,22,13,9,1
SBI60TMM6981944,70,28,20,8,1
SBI23NKP4232012,18,26,24,2,1
SBI66LBK2116993,60,22,19,3,1
SBI99KUH5869184,63,23,17,6,1
SBI25LXO0149978,97,24,15,9,1
SBI44XAB5312608,93,30,19,11,1
SBI26BAU0926513,62,34,30,4,1
SBI06JCX0028953,19,27,15,12,1
SBI48WXA7907492,61,23,20,3,1
SBI93LAW2100884,24,21,19,2,1
SBI27SWM6735932,90,34,29,5,1
SBI03ERS3527518,97,32,20,12,1
SBI07CTU1060826,95,26,16,10,1
SBI57JFU3691377,61,18,11,7,1
SBI57TBK0892492,60,25,24,1,1
SBI22PZY0279228,88,20,12,8,1
SBI42NYS3198586,82,21,16,5,1
SBI83XTF3177867,65,31,16,15,1
SBI58KIH1221788,20,29,19,10,1
SBI30YXS3819909,76,40,24,16,1
SBI59SPI3340031,86,19,15,4,1
SBI51APL7291423,91,26,24,2,1
SBI80ANI7851391,69,27,14,13,1
SBI88DXQ2705228,94,35,25,10,1
SBI58NHI1548510,72,18,12,6,1
SBI72EBG8743031,97,23,19,4,1
SBI34XLA2351019,66,35,18,17,1
SBI49UDI5115710,62,22,19,3,1
SBI16FPM6739602,93,29,23,6,1
SBI07IHI0976898,80,32,20,12,1
SBI47WJB8327762,22,26,18,8,1
SBI10WPP9533776,69,18,10,8,1
SBI75QKI0308803,94,24,21,3,1
SBI34BDP9104117,84,22,17,5,1
SBI89ZFG9778760,18,25,13,12,1
SBI45JGY1393432,61,32,30,2,1
SBI02JRU6837570,99,27,17,10,1
SBI76GBL3312728,71,27,15,12,1
SBI14OKM6185117,69,28,15,13,1
SBI78BPY7067240,86,27,17,10,1
SBI91SIT5604799,91,18,17,1,1
SBI59IKA2500080,87,35,21,14,1
SBI31MKL7192842,20,14,9,5,1
SBI98VLM8944446,97,15,11,4,1
SBI03CBO6998730,81,23,15,8,1
SBI36EZP7172408,63,24,21,3,1
SBI18TQE7646409,87,16,9,7,1
SBI90FGJ9117495,99,14,10,4,1
SBI79TWG9961475,25,15,11,4,1
SBI92ZHJ3006397,22,27,15,12,1
SBI72AYL5571800,92,26,24,2,1
SBI23IDB3122808,61,27,16,11,1
SBI23WJJ5450605,75,32,22,10,1
SBI23VRP1423893,64,22,12,10,1
SBI26PMH0108381,84,22,19,3,1
SBI46THR2599243,94,34,29,5,1
SBI17UCX8730758,61,25,24,1,1
SBI61XUD7476588,63,23,21,2,1
SBI17GIZ1633864,85,25,13,12,1
SBI54AZK3641293,88,25,14,11,1
SBI19ZLO2625569,91,22,14,8,1
SBI22MZN4406669,64,23,12,11,1
SBI40FYH7818936,82,28,16,12,1
SBI89JBE9572098,80,22,20,2,1
SBI50XQZ8512349,23,25,18,7,1
SBI69MYH4153033,19,25,15,10,1
SBI92KBD4474547,98,18,13,5,1
SBI00ZFD2389783,65,28,21,7,1
SBI63VTJ6524985,77,26,15,11,1
SBI22LZF9094140,97,28,17,11,1
SBI98DWE6078352,86,12,11,1,1
SBI15ABO9645098,78,19,15,4,1
SBI57JIA1147478,79,27,14,13,1
SBI23JLZ6215244,73,21,12,9,1
SBI25TRX6135674,90,25,14,11,1
SBI04GVD5686751,77,15,10,5,1
SBI42ZLF1356194,68,27,18,9,1
SBI65RRQ8809163,83,26,22,4,1
SBI34UGA8057006,99,26,18,8,1
SBI53UVN1317179,25,23,17,6,1
SBI08WLM4139453,73,31,27,4,1
SBI61AAQ9081010,92,29,28,1,1
SBI10MWR6978240,79,29,22,7,1
SBI69XBG3898472,60,31,29,2,1
SBI12IWY0409300,89,16,14,2,1
SBI89APQ3341701,75,22,19,3,1
SBI42CYF7286050,74,29,23,6,1
SBI15EJQ7827184,71,23,13,10,1
SBI78FJT8382471,68,16,15,1,1
SBI55ONL7543152,85,26,15,11,1
SBI72HAO1893213,95,21,16,5,1
SBI70YIS7994572,82,30,27,3,1
SBI94NIQ9032355,25,27,23,4,1
SBI52BAF1334175,19,26,21,5,1
SBI34POE1544415,82,24,22,2,1
SBI82GVV5310229,72,22,19,3,1
SBI88CSX5426023,25,25,19,6,1
SBI96PGH1168716,95,23,18,5,1
SBI95AFO6119563,79,23,21,2,1
SBI29KLQ8688747,65,28,17,11,1
SBI12BFB8888683,74,28,17,11,1
SBI80RNY6206936,21,22,15,7,1
SBI07QYM2020229,94,25,14,11,1
SBI25PFV1024155,99,37,34,3,1
SBI14XMZ0396874,86,29,18,11,1
SBI63JVK3109249,84,20,18,2,1
SBI70JBS8105339,25,25,19,6,1
SBI17ZYL4117642,60,29,26,3,1
SBI72XGH4565160,77,13,12,1,1
SBI83UGL4281343,79,18,11,7,1
SBI60PHI4730554,21,18,15,3,1
SBI87SZB6838983,99,25,15,10,1
SBI40DIU2816278,95,31,17,14,1
SBI99BUV9549031,25,28,24,4,1
SBI35IED1130673,88,16,10,6,1
SBI36YJP0657943,98,21,18,3,1
SBI44MPD0822463,25,23,14,9,1
SBI67RNY5067845,77,23,19,4,1
SBI06JXY0402587,93,25,19,6,1
SBI79UOD2839514,66,27,19,8,1
SBI74MEE0784337,71,26,16,10,1
SBI32PUG4097415,61,30,22,8,1
SBI87IUO2729083,75,28,25,3,1
SBI15QKR5965977,92,24,14,10,1
SBI65DPE7653874,94,29,23,6,1
SBI79UZV9428958,18,16,12,4,1
SBI46VHT6035504,81,28,17,11,1
SBI08FTD5778911,77,27,24,3,1
SBI51TRN6658733,80,26,23,3,1
SBI81NJT0540485,98,32,17,15,1
SBI20RIA0251859,62,27,15,12,1
SBI95CQE5635939,98,30,18,12,1
SBI90LNH4511380,95,21,18,3,1
SBI13SJI9698954,24,27,22,5,1
SBI93WJB8197063,70,15,10,5,1
SBI34EKB4597314,94,16,13,3,1
SBI06JXC6140075,18,17,14,3,1
SBI78BEN5700336,87,26,17,9,1
SBI91KJK8221447,81,21,11,10,1
SBI65YLR6646535,64,20,17,3,1
SBI24KYW7694287,74,29,26,3,1
SBI40RXH2478059,73,28,25,3,1
SBI01TDH2359055,90,25,18,7,1
SBI37MVC5911687,91,33,20,13,1
SBI42QHY7020803,85,26,22,4,1
SBI35IBC7604525,24,20,17,3,1
SBI73DTT5205017,19,26,17,9,1
SBI91XFN3161122,72,31,27,4,1
SBI50UBS8836085,88,30,22,8,1
SBI79HEY2687438,22,21,20,1,1
SBI35PBV8558037,22,17,10,7,1
SBI49GCI4763586,76,22,12,10,1
SBI02RBU4060568,67,22,15,7,1
SBI05DIN4743876,71,31,29,2,1
SBI07JFX2490675,69,15,9,6,1
SBI24TTN4033588,78,30,29,1,1
SBI41SNY7449394,61,19,15,4,1
SBI92OOM7119832,86,31,23,8,1
SBI02GIY7538981,65,32,18,14,1
SBI79PEF7175868,85,25,16,9,1
SBI82RFH6679212,99,22,14,8,1
SBI25XVK5530596,60,23,15,8,1
SBI58TWW4016271,93,20,16,4,1
SBI43CEL9316098,94,27,15,12,1
SBI62DOF7325278,80,26,25,1,1
SBI51IBV3517349,86,20,19,1,1
SBI03AZJ7404025,61,24,20,4,1
SBI59EZQ9926481,68,27,24,3,1
SBI35NEJ7357908,67,23,19,4,1
SBI53XYQ9523392,68,28,22,6,1
SBI95YJO6351943,88,35,27,8,1
SBI38BMB7660747,84,25,23,2,1
SBI43MMJ8516689,88,28,15,13,1
SBI62EYR5388438,96,24,22,2,1
SBI36DOT1863876,92,23,21,2,1
SBI81ZZV0805892,96,26,20,6,1
SBI60UBU4674705,65,23,14,9,1
SBI18VIU4917249,73,21,14,7,1
SBI48ABO7212788,75,26,17,9,1
SBI46KOZ5960575,65,17,9,8,1
SBI45BCT6028859,69,23,20,3,1
SBI70EXF4276883,83,31,30,1,1
SBI23JMH2991961,73,38,22,16,1
SBI07BGS5829800,96,19,15,4,1
SBI94JVB7536249,25,36,35,1,1
SBI03LBQ1387357,91,27,15,12,1
SBI86LJD4063607,81,26,18,8,1
SBI64EXB5791443,77,25,20,5,1
SBI06AFI0614012,83,23,22,1,1
SBI49ZYA3806755,75,31,17,14,1
SBI77ISS9404268,70,25,19,6,1
SBI48BNY2652321,68,21,13,8,1
SBI44BRD3910824,75,21,20,1,1
SBI28EFP2150347,61,18,15,3,1
SBI16BYR1582622,21,26,17,9,1
SBI65WUM3409345,94,39,36,3,1
SBI79YLT2444849,23,25,22,3,1
SBI14REJ3165090,75,26,19,7,1
SBI84RZF0598531,19,25,21,4,1
SBI89HFO5757101,98,31,16,15,1
SBI56INP7148465,78,24,21,3,1
SBI57YWR6247594,90,26,18,8,1
SBI32OYU9244608,66,24,14,10,1
SBI95YDV0967643,64,21,18,3,1
SBI70BGY4265289,75,27,20,7,1
SBI17LLR4106346,81,24,22,2,1
SBI59NPT1831689,98,17,9,8,1
SBI49LLH0699095,95,26,24,2,1
SBI25HZM7552970,18,22,16,6,1
SBI34OVE1859423,99,24,17,7,1
SBI52IJZ1066006,19,17,12,5,1
SBI65YAE1283341,89,34,28,6,1
SBI56DZT9954237,66,27,22,5,1
SBI48GLS7081174,21,19,14,5,1
SBI58FJE9694832,72,26,18,8,1
SBI25IWA9722081,65,24,21,3,1
SBI42KOK6537574,62,19,11,8,1
SBI68TMP9251302,63,26,14,12,1
SBI07UKH9392344,98,25,22,3,1
SBI77SDX5355551,74,23,17,6,1
SBI14ZBF4581492,80,22,15,7,1
SBI91KXV1239017,65,33,29,4,1
SBI51ISD6617122,70,24,15,9,1
SBI50XXY6113935,87,23,22,1,1
SBI58JGL2622507,92,20,18,2,1
SBI16PBN5760331,25,23,16,7,1
SBI33IXX6421372,66,18,16,2,1
SBI73PXT1582454,61,26,15,11,1
SBI53ITY6869321,87,24,18,6,1
SBI66UUI6076923,25,24,18,6,1
SBI06HUI9624810,82,25,23,2,1
SBI14WQM0964402,22,39,33,6,1
SBI00WRO6244189,62,26,20,6,1
SBI55YCF1233697,64,21,19,2,1
SBI94OVP1764551,65,21,14,7,1
SBI24NBK4232012,65,27,20,7,1
SBI52GNO6519178,64,22,20,2,1
SBI13OXM5852163,21,23,17,6,1
SBI54NNP9970705,84,28,22,6,1
SBI89QRK0933399,91,26,23,3,1
SBI19CVC8193069,99,15,14,1,1
SBI35NMJ1336717,22,26,16,10,1
SBI96WQC1258625,80,22,16,6,1
SBI99PFQ4568916,60,31,17,14,1
SBI90OKQ3905234,99,18,14,4,1
SBI99AWJ3647662,25,19,13,6,1
SBI25ODU1458405,96,25,20,5,1
SBI17QMX7427646,65,29,28,1,1
SBI76KAI5200298,99,17,10,7,1
SBI62SZA7634008,18,19,17,2,1
SBI96UKT7861356,88,26,16,10,1
SBI51UQW2952117,61,19,10,9,1
SBI26TFW8863993,88,19,16,3,1
SBI20DOS2554788,88,29,27,2,1
SBI78YPL7429749,90,27,20,7,1
SBI03RYF1819927,61,23,22,1,1
SBI48RBK5544741,66,22,14,8,1
SBI19PXL4242567,19,30,18,12,1
SBI92TKY5025284,90,31,27,4,1
SBI07QTN0119378,99,27,17,10,1
SBI43JGK2992872,20,17,10,7,1
SBI84QFS6861884,62,28,25,3,1
SBI02EEN7831702,69,31,20,11,1
SBI72WPX0203548,93,32,26,6,1
SBI91GNN7601984,61,33,30,3,1
SBI16GTR7482232,23,27,26,1,1
SBI75OYI9794466,25,23,12,11,1
SBI21SIM2472572,72,24,23,1,1
SBI46BVX3331779,62,28,16,12,1
SBI37ILK6990332,84,23,19,4,1
SBI88OIZ7014278,97,20,17,3,1
SBI83AXC4422527,83,20,15,5,1
SBI84ZOD0190255,69,32,28,4,1
SBI35WQM4575308,23,26,24,2,1
SBI91BWB1259915,80,30,28,2,1
SBI85IMN7368621,73,30,24,6,1
SBI41CDV0048849,94,20,11,9,1
SBI01CVR1462488,60,24,16,8,1
SBI06WSA2108056,98,29,26,3,1
SBI11VLV3334542,83,28,19,9,1
SBI12LFW0009297,25,34,23,11,1
SBI85FIH0354380,87,27,17,10,1
SBI84HFU6464647,25,28,17,11,1
SBI73MDI4067333,73,25,23,2,1
SBI65WJF1680633,77,24,16,8,1
SBI94PGQ3340213,98,28,22,6,1
SBI37WZN9653686,21,25,21,4,1
SBI56DLO0892352,61,29,18,11,1
SBI42SSL9495364,92,19,14,5,1
SBI45DOQ0459984,72,19,10,9,1
SBI62KVW8904767,68,23,17,6,1
SBI04TYF8080981,78,19,18,1,1
SBI97XMV9051536,60,20,19,1,1
SBI97GHD4459311,79,26,23,3,1
SBI20NIY9194505,84,28,25,3,1
SBI81HZH2331024,62,34,23,11,1
SBI89EFL4116154,97,27,26,1,1
SBI34IMF3742707,63,28,24,4,1
SBI43VAE0832039,61,21,16,5,1
SBI72LCN3149219,20,35,22,13,1
SBI44LYH0939984,66,25,18,7,1
SBI54OFM8052426,60,31,24,7,1
SBI95LJB0967479,21,20,12,8,1
SBI22QCA0072664,90,24,20,4,1
SBI65AVJ3990473,83,24,13,11,1
SBI26NKT4975827,99,15,10,5,1
SBI60NUS0731723,76,22,14,8,1
SBI42HSY0499598,22,24,18,6,1
SBI62VTY9775551,96,20,15,5,1
SBI47KTH2001340,65,27,15,12,1
SBI56KLN5833065,95,23,18,5,1
SBI32ZMT8453252,68,28,18,10,1
SBI55RAL2623997,76,25,14,11,1
SBI91INZ5065661,22,19,10,9,1
SBI58NUC2826035,78,20,14,6,1
SBI93MAF4325342,62,22,12,10,1
SBI80DPB0768198,18,21,20,1,1
SBI47NBJ2884396,77,29,15,14,1
SBI86ZED1378749,83,34,29,5,1
SBI85XIU2765141,70,29,24,5,1
SBI16LFP9838184,72,27,25,2,1
SBI83GKR9777320,80,21,13,8,1
SBI14IOL3951726,90,23,22,1,1
SBI68DZW1745503,90,22,13,9,1
SBI12DGN0652158,90,32,18,14,1
SBI44JXK1620587,83,19,15,4,1
SBI63LUY4091341,79,25,20,5,1
SBI38SOS4732011,80,27,18,9,1
SBI34AMC2115003,98,30,23,7,1
SBI01CMA7552084,91,21,20,1,1
SBI05JVW1745159,62,27,16,11,1
SBI56LYH1406355,84,24,17,7,1
SBI63XQP2526957,93,14,12,2,1
SBI81MHQ2045699,63,28,15,13,1
SBI11QLZ4663392,80,27,25,2,1
SBI61DCG5344683,21,23,16,7,1
SBI18GLN7108123,25,31,21,10,1
SBI66QDM1630396,70,23,16,7,1
SBI66WUQ0328196,71,31,20,11,1
SBI30NJD2934234,24,25,16,9,1
SBI98HNX1877135,25,31,20,11,1
SBI10XTU0807552,24,21,19,2,1
SBI56UJQ7293762,83,34,25,9,1
SBI30EAB5425020,79,28,25,3,1
SBI81IPO2234407,65,30,25,5,1
SBI89SVN5390096,62,20,18,2,1
SBI93DPM0720046,86,24,20,4,1
SBI05WKS8125973,82,24,14,10,1
SBI84OJD3865082,23,27,17,10,1
SBI73LBV7069339,69,27,15,12,1
SBI96UNV7227619,91,24,19,5,1
SBI68JOQ1064388,21,24,18,6,1
SBI04XKR2646073,21,25,22,3,1
SBI13KUG5922653,74,22,18,4,1
SBI53TVC1969337,20,36,33,3,1
SBI86OPH7945137,79,25,18,7,1
SBI68BBN7983956,68,28,23,5,1
SBI00ECP5448077,65,33,21,12,1
SBI71KAX8708229,98,25,20,5,1
SBI90UBY4709264,99,36,22,14,1
SBI66FFC3387755,79,15,8,7,1
SBI70NEV2030897,86,21,17,4,1
SBI08DMZ2586104,23,23,16,7,1
SBI61RIN5505582,63,24,20,4,1
SBI11KIQ3233474,82,21,15,6,1
SBI71EDU4930541,89,20,14,6,1
SBI15XXJ1225602,93,18,13,5,1
SBI82CVD6722955,66,17,11,6,1
SBI89WJJ7243828,90,28,17,11,1
SBI00BPQ1079856,79,22,19,3,1
SBI53MBM9123369,85,18,12,6,1
SBI42ULZ6187606,75,25,16,9,1
SBI42EGV1789279,62,30,26,4,1
SBI26FHF3299291,89,19,17,2,1
SBI19XWM6332477,94,28,25,3,1
SBI69MUJ0070131,89,23,16,7,1
SBI21RBC5424711,76,29,22,7,1
SBI51CAD4231084,87,22,19,3,1
SBI99RAZ1691881,62,21,16,5,1
SBI68LXJ0512385,91,29,17,12,1
SBI07IOP0881610,69,22,19,3,1
SBI02JPB1812414,70,30,20,10,1
SBI08QFH7022064,80,24,20,4,1
SBI54OMS9558766,79,23,13,10,1
SBI57SFD1779002,65,27,26,1,1
SBI88SGE9068812,73,25,23,2,1
SBI25OYV8565720,79,21,20,1,1
SBI73AET8822173,63,18,11,7,1
SBI95GQH8044762,65,30,29,1,1
SBI28GIN5445803,71,24,13,11,1
SBI10ZXR9663147,86,21,20,1,1
SBI05AOI6562037,83,30,26,4,1
SBI61ZIY2058820,78,26,23,3,1
SBI15DZI1324487,18,25,17,8,1
SBI72ORW0284170,75,29,24,5,1
SBI42ZUD9584801,77,23,18,5,1
SBI64GQO8567283,70,25,20,5,1
SBI94ESK5093704,20,27,26,1,1
SBI40AHN4806127,78,21,19,2,1
SBI43AMO7547129,62,17,15,2,1
SBI26AQL2081089,20,26,18,8,1
SBI74CRK1932916,18,22,21,1,1
SBI16UPJ3769315,99,27,23,4,1
SBI69TFV6068593,77,30,17,13,1
SBI69WNM7993168,18,25,19,6,1
SBI16TQF5186612,60,24,17,7,1
SBI36CPE7032865,72,21,16,5,1
SBI51AHI7682196,25,29,27,2,1
SBI06DVQ3468523,81,23,22,1,1
SBI90JXF5875295,90,17,12,5,1
SBI42LNE2098066,74,19,18,1,1
SBI79MUI5222725,75,21,17,4,1
SBI64ZIK3095436,96,20,18,2,1
SBI70HML2563991,24,21,12,9,1
SBI79EIK4063655,73,24,15,9,1
SBI79JPT6414530,96,31,24,7,1
SBI67HBK4868879,84,25,19,6,1
SBI24PJM8336357,62,29,22,7,1
SBI41UEA5839996,18,26,25,1,1
SBI62MKZ5511845,67,29,25,4,1
SBI25IMP1021968,92,31,18,13,1
SBI30QLJ6354964,86,17,16,1,1
SBI44QCE1650263,69,17,9,8,1
SBI14FVK0503914,63,23,18,5,1
SBI35BSM4761075,78,22,14,8,1
SBI84UCP8559186,93,28,23,5,1
SBI45KJO2869317,68,26,25,1,1
SBI56XBJ1105591,80,23,12,11,1
SBI83SIE1054922,93,22,19,3,1
SBI79FJQ4333432,91,31,16,15,1
SBI55ZYL9163208,82,25,15,10,1
SBI66EPG0435800,61,29,16,13,1
SBI26VOH3763512,98,31,24,7,1
SBI40ZHA6959738,74,21,20,1,1
SBI57ZXJ6132061,76,13,11,2,1
SBI59EKW0332860,22,23,20,3,1
SBI07LAP6092586,88,21,20,1,1
SBI33KHA3605607,99,19,12,7,1
SBI01KDI2499640,96,26,18,8,1
SBI83OYX0962993,83,23,14,9,1
SBI10GSD9584096,74,30,17,13,1
SBI46FBS0610798,94,23,19,4,1
SBI40KNI6178170,20,24,14,10,1
SBI97MUA6805562,90,17,10,7,1
SBI54DTI6313598,65,20,13,7,1
SBI80DOQ6441325,62,20,13,7,1
SBI40GJJ2266775,85,31,28,3,1
SBI31HIM7543666,88,25,15,10,1
SBI11IDK0201744,85,31,28,3,1
SBI38OEK9285866,79,33,21,12,1
SBI41ZCZ1638813,96,34,25,9,1
SBI06OJJ5956171,20,33,26,7,1
SBI59GKX7226915,70,19,10,9,1
SBI72PHL3638506,71,21,14,7,1
SBI42IAE9049427,94,21,20,1,1
SBI97XIB4446521,25,24,22,2,1
SBI94DFI2126179,71,22,19,3,1
SBI64ZOM8864261,99,20,16,4,1
SBI09JWU4748276,92,19,12,7,1
SBI93TPA3273749,71,29,27,2,1
SBI92AGC9563003,84,23,16,7,1
SBI49BZP6965845,74,26,18,8,1
SBI29GFB8579187,80,31,30,1,1
SBI66CVC5502306,97,20,19,1,1
SBI72RID8027581,63,29,23,6,1
SBI36TMW2185186,81,21,17,4,1
SBI93ZEX2024719,62,23,17,6,1
SBI48XCC8330736,75,21,11,10,1
SBI60SZE6744850,84,22,13,9,1
SBI35TEC2712740,78,29,24,5,1
SBI24BCX3147847,20,25,24,1,1
SBI25XUZ1976949,93,23,17,6,1
SBI44CWX3600072,80,26,16,10,1
SBI48KZX2918918,92,25,20,5,1
SBI14XKD5675525,87,27,21,6,1
SBI86BKI1395916,63,25,20,5,1
SBI51NJW5436115,99,25,24,1,1
SBI01OKR9822083,20,30,27,3,1
SBI75VVZ3148485,66,30,24,6,1
SBI69IDC6760976,66,22,12,10,1
SBI89UAZ8450771,66,24,17,7,1
SBI27WCY0848792,24,34,32,2,1
SBI25IVV3519560,99,21,15,6,1
SBI64UQC5107957,85,21,15,6,1
SBI47GSG2462900,81,28,20,8,1
SBI01FTP6836562,79,21,11,10,1
SBI52TAT4436913,77,16,13,3,1
SBI79DWC3494145,60,35,23,12,1
SBI85ODL5391118,88,37,20,17,1
SBI17ELI8183947,99,29,28,1,1
SBI23MZP0009187,77,33,28,5,1
SBI88ZUK4621852,96,28,22,6,1
SBI01EBP7563579,82,27,24,3,1
SBI96YDD2669824,85,25,15,10,1
SBI15FCK6209253,65,28,27,1,1
SBI92BCO9173889,87,23,16,7,1
SBI34KQT9994260,70,28,20,8,1
SBI05YKW2681446,92,20,12,8,1
SBI58VUW2251044,20,16,15,1,1
SBI18XRS0801269,83,30,23,7,1
SBI11RFP6045539,24,32,26,6,1
SBI24FEN0154833,63,24,14,10,1
SBI95GEJ8790968,25,23,21,2,1
SBI51VIX1016756,78,26,19,7,1
SBI67LTK0363321,78,25,21,4,1
SBI17DKR9158216,78,33,29,4,1
SBI98BZD5460772,65,19,15,4,1
SBI95ILY2605286,23,33,30,3,1
SBI73ZAT9269357,81,18,17,1,1
SBI31GND9936981,85,37,29,8,1
SBI38YFY2638533,98,18,12,6,1
SBI91GUA0937683,70,29,25,4,1
SBI17FPS7796961,83,26,18,8,1
SBI55XXA1893499,67,20,13,7,1
SBI97ZNY3879442,74,19,10,9,1
SBI96MPC4189515,75,26,20,6,1
SBI12MLY9170459,84,29,16,13,1
SBI61ZAU7477855,94,14,12,2,1
SBI30VZS9559043,71,14,12,2,1
SBI89GDE2610393,22,27,17,10,1
SBI16WZE2017219,24,29,16,13,1
SBI27MMS3188839,92,25,21,4,1
SBI02UEU6263577,79,25,18,7,1
SBI01UOU1254982,96,19,10,9,1
SBI94TIY7455398,18,25,21,4,1
SBI22LCZ2449847,73,32,23,9,1
SBI76ISQ5682560,23,29,20,9,1
SBI35WIA2513240,80,20,19,1,1
SBI43QXB6969022,72,27,23,4,1
SBI39UTH6439524,22,21,18,3,1
SBI95RKC9967630,88,30,24,6,1
SBI44YDC2709352,85,28,20,8,1
SBI40TTQ1335071,89,22,13,9,1
SBI37WXB4563122,75,16,14,2,1
SBI22ZOY1054885,21,25,16,9,1
SBI97PSE3879641,84,17,16,1,1
SBI06WPD8766361,88,24,15,9,1
SBI52JVN2088041,81,29,28,1,1
SBI66LAV8011290,63,25,21,4,1
SBI17WZP5573626,85,25,18,7,1
SBI36YFK3491055,23,15,14,1,1
SBI66OYW9800175,63,26,14,12,1
SBI33EUM6582774,24,24,23,1,1
SBI19RSG0019461,82,22,19,3,1
SBI40WRN8463966,63,31,21,10,1
SBI46CYP1838336,84,22,13,9,1
SBI48RMG4648783,72,22,16,6,1
SBI78DPP1386830,61,28,24,4,1
SBI94RYA4319422,91,28,18,10,1
SBI96OPT1218875,97,28,15,13,1
SBI59NZV5115082,97,18,11,7,1
SBI13EFZ9306636,76,19,15,4,1
SBI10QEN0149594,19,26,24,2,1
SBI17FSM0977512,76,17,9,8,1
SBI60QZX4845070,83,11,9,2,1
SBI57OAD6050070,95,25,24,1,1
SBI36DAX3447329,93,24,23,1,1
SBI93YWT7004215,70,35,34,1,1
SBI82VPV5134227,64,22,19,3,1
SBI91YZH9021501,64,24,13,11,1
SBI24QGM5517886,92,17,13,4,1
SBI33ILK0495337,74,28,24,4,1
SBI59WBU4588173,66,30,23,7,1
SBI51BHY7879636,67,26,16,10,1
SBI44UJM5132874,77,20,12,8,1
SBI56ARN9833833,95,25,18,7,1
SBI02OPF3861330,84,14,8,6,1
SBI88WQS7117699,93,25,18,7,1
SBI49XLJ0802026,23,24,13,11,1
SBI70VHE8823050,24,21,17,4,1
SBI44CDY1150382,97,20,17,3,1
SBI30FIV1339591,84,23,21,2,1
SBI36JJA6129069,21,22,20,2,1
SBI20OWX4887467,62,26,25,1,1
SBI01PFW1111497,67,23,21,2,1
SBI29MNB1145138,68,33,27,6,1
SBI90VLC2123603,25,26,22,4,1
SBI54ZXN9399940,96,22,17,5,1
SBI36NOY9363435,25,28,25,3,1
SBI17DVF0555259,65,18,10,8,1
SBI80ITR2432821,60,27,21,6,1
SBI46SPW6999037,67,25,24,1,1
SBI10GNZ5369799,72,21,13,8,1
SBI27ZXD6840688,71,26,21,5,1
SBI07FJQ1187456,92,27,15,12,1
SBI42CFI5606883,99,20,12,8,1
SBI15KWJ5563508,87,27,18,9,1
SBI93OWP0069517,83,23,16,7,1
SBI38APZ0405024,19,28,26,2,1
SBI86OYU1553017,92,30,21,9,1
SBI60PNW8253518,96,26,17,9,1
SBI45BIF7531473,67,28,15,13,1
SBI50RCN9401454,99,25,20,5,1
SBI71YFG2493514,74,33,29,4,1
SBI10YVL6406741,24,33,29,4,1
SBI21IHR4198191,64,21,16,5,1
SBI89KKC5613752,18,32,21,11,1
SBI41NQC2556562,79,26,16,10,1
SBI67AYY3973226,22,23,14,9,1
SBI25XDU4721699,74,23,19,4,1
SBI99ZCJ5761774,90,31,24,7,1
SBI02BNP8645183,78,36,32,4,1
SBI39MDV1958859,18,24,22,2,1
SBI97ZCM2729290,64,26,14,12,1
SBI28VQX4746806,22,20,16,4,1
SBI40ZOE9373780,62,26,21,5,1
SBI03RXU7604661,82,25,21,4,1
SBI18LTH5247792,67,19,17,2,1
SBI68VZZ5963618,75,11,7,4,1
SBI08FFZ7473550,96,21,20,1,1
SBI28TOB1269718,88,20,19,1,1
SBI01QIA2727236,19,27,24,3,1
SBI12DQV5456695,25,24,22,2,1
SBI24QEP1540113,66,21,18,3,1
SBI78DJU7522264,91,12,9,3,1
SBI52HVE0094421,72,30,18,12,1
SBI92JQN8157407,80,23,22,1,1
SBI07USM6770658,72,32,31,1,1
SBI55HCJ3196229,73,20,14,6,1
SBI51OSZ8661663,85,26,25,1,1
SBI02EBG3934072,84,24,15,9,1
SBI65CQR0488636,60,25,17,8,1
SBI82DHB2930590,68,22,15,7,1
SBI90ZSA7998882,60,28,15,13,1
SBI55YGQ6824930,98,19,18,1,1
SBI85BNY1022683,19,31,21,10,1
SBI22YTM1331159,94,21,16,5,1
SBI86YMX0404928,88,27,21,6,1
SBI64IJR2957443,65,26,24,2,1
SBI87QHE9371668,67,26,19,7,1
SBI27JHZ4444526,84,24,21,3,1
SBI23VPC6062109,63,27,24,3,1
SBI11TSH8483858,63,27,26,1,1
SBI67BFZ1797037,97,19,12,7,1
SBI32GFG5606484,66,25,14,11,1
SBI94VUN7517883,70,27,23,4,1
SBI32XVG7299344,88,31,27,4,1
SBI33SLS6416873,73,17,13,4,1
SBI43WSV6970495,93,22,21,1,1
SBI23XZV5536996,63,19,10,9,1
SBI72VBO7463866,98,21,16,5,1
SBI09DXP6853884,78,21,19,2,1
SBI66EJT0791504,93,33,30,3,1
SBI19FFJ3476728,22,24,22,2,1
SBI89NHH1388186,63,26,21,5,1
SBI61QEW9375577,88,28,22,6,1
SBI07SWL5347489,90,25,24,1,1
SBI16DEB1015235,72,25,17,8,1
SBI50PSH7397336,23,27,22,5,1
SBI63YSH5743784,25,31,16,15,1
SBI29NBJ8265972,89,19,13,6,1
SBI34MAG3595141,74,23,15,8,1
SBI98XAX3053874,97,32,27,5,1
SBI26YRN3870880,22,25,22,3,1
SBI24SIH6630225,84,32,22,10,1
SBI21UZF5099284,94,27,25,2,1
SBI12KQO7513798,91,25,22,3,1
SBI83BEL9351371,85,35,33,2,1
SBI22OTQ2188937,94,30,16,14,1
SBI84SFM7597281,83,21,14,7,1
SBI18PTD1314433,99,33,19,14,1
SBI20QVC4708710,74,30,21,9,1
SBI40ZEH4739267,65,24,22,2,1
SBI54BHO9782690,66,32,27,5,1
SBI17FUN2282224,95,31,27,4,1
SBI88ONP6449981,82,31,19,12,1
SBI82USL7188249,69,19,10,9,1
SBI10IGT6784672,86,27,21,6,1
SBI21XUU2741190,75,27,24,3,1
SBI49UFU7083356,63,22,20,2,1
SBI81JAF0542162,91,26,20,6,1
SBI46MJD0279988,87,33,28,5,1
SBI69QQK2678791,60,21,14,7,1
SBI68PNY8292496,79,32,17,15,1
SBI28RMV7600087,23,33,22,11,1
SBI30OPN5908398,75,13,12,1,1
SBI97INC4097353,64,26,18,8,1
SBI33SLP5823129,99,19,14,5,1
SBI78MKP8068645,25,28,25,3,1
SBI26CYS0569140,78,19,10,9,1
SBI50ZYD8461346,79,27,15,12,1
SBI26NWR7769314,21,22,18,4,1
SBI14TJG5592504,98,24,17,7,1
SBI28TGW6390213,82,26,16,10,1
SBI29WMC9102806,75,24,16,8,1
SBI67XVJ1726841,79,20,18,2,1
SBI77LZU4065850,21,28,21,7,1
SBI15FLZ0316980,88,23,20,3,1
SBI31QLL5117171,86,17,16,1,1
SBI18DGI8251818,78,27,18,9,1
SBI50ZDU4581084,77,28,21,7,1
SBI72FWM7227602,90,24,23,1,1
SBI51GFB2886473,77,31,28,3,1
SBI04BJW3102387,71,33,23,10,1
SBI82RWL0862340,64,20,19,1,1
SBI23TJE7226939,77,24,21,3,1
SBI78ZDA9172080,82,27,24,3,1
SBI07OVA6597821,74,27,14,13,1
SBI84CLE4520481,94,25,19,6,1
SBI42GWL9713781,22,15,12,3,1
SBI17JDN3085372,70,24,15,9,1
SBI19NVQ4510419,95,31,27,4,1
SBI04XYO1863927,19,27,16,11,1
SBI50NAL4810961,97,25,18,7,1
SBI46RJX0713649,78,25,19,6,1
SBI96BDL9327211,82,25,14,11,1
SBI42XRC2132874,83,25,23,2,1
SBI56LVE6375182,73,28,22,6,1
SBI59VGT3891476,70,23,14,9,1
SBI62IJP0541550,21,16,13,3,1
SBI11GXB2009355,64,24,22,2,1
SBI61HIO1348459,90,24,17,7,1
SBI99TMZ0842269,99,32,28,4,1
SBI04TFM0050710,72,28,17,11,1
SBI69BJF6197010,76,26,14,12,1
SBI82RMI0828462,96,21,20,1,1
SBI94MLK1281100,82,20,15,5,1
SBI77URJ9354247,89,37,20,17,1
SBI44QSY6551805,95,17,10,7,1
SBI61HAI6438867,84,28,15,13,1
SBI40FCS6716201,93,30,19,11,1
SBI69PRN9821031,95,24,17,7,1
SBI69NNA3660857,70,19,16,3,1
SBI99KUN8847662,60,28,26,2,1
SBI66OLB4664341,79,31,24,7,1
SBI85GQM7805990,97,26,21,5,1
SBI17TKI8650256,68,36,27,9,1
SBI13HQJ9090335,25,19,14,5,1
SBI67ZFU1860764,91,24,14,10,1
SBI38VAE6345893,64,15,10,5,1
SBI87LMN9843426,24,18,12,6,1
SBI58OVK4109320,65,20,19,1,1
SBI01BHE8416711,90,25,19,6,1
SBI19SWL3931369,66,33,27,6,1
SBI28NQT8007902,90,19,14,5,1
SBI95AVR8360905,78,19,13,6,1
SBI73OKA9993475,84,33,23,10,1
SBI93FGE8860243,62,32,20,12,1
SBI45UZB8476686,61,15,11,4,1
SBI15WJT8040370,90,27,20,7,1
SBI19NAC1293522,82,25,19,6,1
SBI26DHR2232993,71,24,21,3,1
SBI09HKZ7991357,24,20,15,5,1
SBI21AWA0899250,89,21,18,3,1
SBI65WVJ6078935,23,18,14,4,1
SBI53FDV5007500,66,21,13,8,1
SBI40LZE0003050,87,22,14,8,1
SBI64ZOZ1843351,92,20,19,1,1
SBI65AES7898027,70,26,22,4,1
SBI27EDM8779781,92,15,10,5,1
SBI77HYY8014281,74,28,17,11,1
SBI21SVV1519923,83,15,11,4,1
SBI80XOK4822950,19,24,15,9,1
SBI49BOY5773456,77,35,31,4,1
SBI68DGI3878415,82,30,23,7,1
SBI20EZN5765232,78,23,18,5,1
SBI13XHG2371680,72,29,19,10,1
SBI54VFR9520524,63,20,17,3,1
SBI57UMF1056934,97,26,14,12,1
SBI69YXI8162606,82,25,18,7,1
SBI19KQN3251799,69,21,12,9,1
SBI45LZS0779240,74,25,13,12,1
SBI95LAP7067980,92,23,15,8,1
SBI92SLX1770604,95,30,28,2,1
SBI12YRL3161468,71,24,14,10,1
SBI74MPH4696456,63,29,19,10,1
SBI40SZP6665659,80,19,15,4,1
SBI86SRA9145120,72,28,16,12,1
SBI99MOS1075364,79,27,20,7,1
SBI30YJL2183700,69,25,22,3,1
SBI23TUE4916635,18,31,22,9,1
SBI56IFC6952885,86,24,16,8,1
SBI42VED7191369,21,27,26,1,1
SBI96YLC3663292,82,26,20,6,1
SBI64RAH1223115,77,17,16,1,1
SBI02DCF9850098,79,21,14,7,1
SBI58VLW9731632,21,29,16,13,1
SBI78ABJ5504658,87,29,20,9,1
SBI84KOJ6956952,85,29,19,10,1
SBI09BHN5926721,81,25,21,4,1
SBI07OTI1803083,61,23,20,3,1
SBI38FYM6728817,93,25,24,1,1
SBI39GCF6296926,85,24,14,10,1
SBI27KPT0792374,67,27,25,2,1
SBI27HUM8562122,23,24,16,8,1
SBI14PNY2714718,66,22,19,3,1
SBI04NTB9720210,21,17,12,5,1
SBI33KEA6199058,68,21,19,2,1
SBI69CQJ1050093,75,23,16,7,1
SBI46QKD0622356,81,18,17,1,1
SBI61OFJ2199413,84,30,21,9,1
SBI33WSL5818040,97,30,19,11,1
SBI36LHE0609608,82,20,18,2,1
SBI27IFM5670073,20,25,20,5,1
SBI45QMY6542320,97,21,20,1,1
SBI04COG8541450,65,30,16,14,1
SBI57UTE2185494,93,10,7,3,1
SBI76QMP4808475,79,24,17,7,1
SBI64ZKW0060083,72,22,20,2,1
SBI07PRC4468349,79,30,27,3,1
SBI79XYH6095868,83,22,13,9,1
SBI77FCK2566685,18,15,8,7,1
SBI34QFO5571757,65,20,13,7,1
SBI75CGH8476254,93,26,17,9,1
SBI74ZSG8867043,81,32,31,1,1
SBI94GNR8378457,66,25,21,4,1
SBI37NCT3027907,87,17,14,3,1
SBI47LBG8735245,80,29,26,3,1
SBI30EFL0140106,22,27,19,8,1
SBI58VOG1712677,93,27,14,13,1
SBI24KIH2077893,19,25,19,6,1
SBI38POA7064417,83,19,17,2,1
SBI84CXK1841541,67,25,17,8,1
SBI87GPR9545789,65,17,10,7,1
SBI32SEM5191466,92,25,21,4,1
SBI37RSI1143433,62,20,15,5,1
SBI91OCO8508179,61,27,17,10,1
SBI66LEF3723906,92,32,21,11,1
SBI84OOD0822400,19,27,20,7,1
SBI87MBE5984007,73,20,13,7,1
SBI08PBR2903049,97,20,17,3,1
SBI63FEQ8774336,19,26,17,9,1
SBI77MNB9708912,61,24,19,5,1
SBI19ZYU4137127,72,16,10,6,1
SBI35RFW1564840,71,19,16,3,1
SBI70DDM6358633,25,26,17,9,1
SBI10EGF3693313,24,27,25,2,1
SBI89ZVG3346184,74,24,18,6,1
SBI26UFE7847006,60,23,22,1,1
SBI14UNL2451175,86,28,16,12,1
SBI62COO3109002,95,23,12,11,1
SBI45NUH1815068,91,25,24,1,1
SBI84BJZ2389926,86,12,7,5,1
SBI13SRB9322544,94,28,21,7,1
SBI02YIS1650226,25,20,11,9,1
SBI32WFV3399548,81,26,23,3,1
SBI89LLN9379722,82,25,14,11,1
SBI99DJG3159278,61,24,22,2,1
SBI59FDA2439096,64,23,20,3,1
SBI19VVN5400271,62,24,13,11,1
SBI40OUE6954400,89,30,17,13,1
SBI54IOG0928554,80,22,20,2,1
SBI07WJO8593252,80,31,30,1,1
SBI12LSL3537835,95,18,12,6,1
SBI20WCX0048718,75,8,6,2,1
SBI92RSE0463971,82,21,18,3,1
SBI42CWL6038082,22,18,17,1,1
SBI53LHA0652664,73,22,14,8,1
SBI04YME3829881,96,24,15,9,1
SBI59VHC2001791,95,27,18,9,1
SBI23QLX9660018,20,22,20,2,1
SBI43DYD4249836,83,29,18,11,1
SBI92FDK1270703,92,20,13,7,1
SBI76BIA3831644,95,26,15,11,1
SBI75GXB9338411,90,25,21,4,1
SBI66QLY1610058,92,19,16,3,1
SBI54QVP3517039,69,26,23,3,1
SBI49IQC7967273,62,29,26,3,1
SBI99BVD0473619,70,21,12,9,1
SBI89XLM5310012,61,21,18,3,1
SBI73YBP8447812,80,27,22,5,1
SBI04DKQ5851127,68,21,14,7,1
SBI76QPJ0253805,66,29,28,1,1
SBI05ECX5878961,94,24,13,11,1
SBI65HST0542373,21,22,16,6,1
SBI01VCX8871864,77,23,22,1,1
SBI78CKE9229624,78,17,10,7,1
SBI58DEC0094646,83,23,17,6,1
SBI46TNJ4749489,90,23,21,2,1
SBI81MVC6836311,70,23,14,9,1
SBI34UXE4901370,75,20,17,3,1
SBI34PUQ1894159,77,24,17,7,1
SBI13KCU8581713,82,29,16,13,1
SBI78EXO4676034,19,25,13,12,1
SBI74BHI2312332,23,22,21,1,1
SBI79VTW2634998,94,23,20,3,1
SBI62PXA9560056,85,28,24,4,1
SBI90TMI1768083,98,17,9,8,1
SBI03AAO3701832,81,25,14,11,1
SBI06PBM0196701,95,24,23,1,1
SBI88QOL0464542,77,29,15,14,1
SBI13GHJ3834085,76,24,17,7,1
SBI63XUC5278672,61,18,17,1,1
SBI17MJO7844924,79,23,21,2,1
SBI27DTW2192487,78,27,16,11,1
SBI95TSS1155778,97,26,21,5,1
SBI59FFV8125770,23,27,24,3,1
SBI63YXO0383015,80,35,33,2,1
SBI35JJF4170750,86,20,19,1,1
SBI14GMI5424430,97,18,14,4,1
SBI75IIP1091750,64,26,22,4,1
SBI05KIH6070216,88,24,16,8,1
SBI24DOJ7716821,18,34,25,9,1
SBI65EME3206825,65,22,21,1,1
SBI87FRZ4405830,94,27,22,5,1
SBI92RPR3462234,98,22,12,10,1
SBI93KWW7782379,61,21,14,7,1
SBI96JIT0268826,21,21,15,6,1
SBI59NMF0276138,18,18,13,5,1
SBI91RMS3083676,75,28,20,8,1
SBI52HUD4081955,77,26,25,1,1
SBI00AVC6972784,69,31,17,14,1
SBI96GHG6282382,85,24,20,4,1
SBI11ECX0640832,85,37,22,15,1
SBI68QBL8864421,19,25,15,10,1
SBI26NPL7932305,64,22,17,5,1
SBI07BHW1732079,19,22,17,5,1
SBI22HXW3558894,76,21,11,10,1
SBI20QMT2732186,79,22,19,3,1
SBI03ITB4550901,23,20,18,2,1
SBI52IJR2804508,78,20,17,3,1
SBI17ZEY5069672,60,24,20,4,1
SBI73EPX4406206,83,35,27,8,1
SBI47LZB9491102,94,19,14,5,1
SBI16COH9620187,95,22,21,1,1
SBI12YPT6328793,62,24,14,10,1
SBI71YPW9383951,21,29,16,13,1
SBI23KMO0955064,75,19,11,8,1
SBI17QSZ3890615,67,14,8,6,1
SBI49CXR7802377,23,28,20,8,1
SBI10RYT9248130,18,26,15,11,1
SBI93DXN3784611,75,27,22,5,1
SBI26FVW8116097,80,25,19,6,1
SBI17PRJ8478202,23,18,10,8,1
SBI27QSG5364339,61,12,10,2,1
SBI06TII6088459,77,32,29,3,1
SBI90QME3650053,72,23,22,1,1
SBI94HKH1036707,21,25,20,5,1
SBI02CXJ6330131,94,16,10,6,1
SBI75TCP2861264,21,18,12,6,1
SBI92LOD2151449,93,32,26,6,1
SBI12YJR6515417,89,29,17,12,1
SBI36EJK3784054,82,23,17,6,1
SBI63TRG4469687,75,30,24,6,1
SBI00WSL9943005,84,21,16,5,1
SBI99FTH3282683,74,21,12,9,1
SBI75NXQ7267749,70,22,20,2,1
SBI74YLB2338380,74,23,13,10,1
SBI05NBQ4912557,24,30,19,11,1
SBI18KRY3027229,93,29,21,8,1
SBI90MPC8378694,86,19,12,7,1
SBI27CCG5262533,60,21,15,6,1
SBI08NIB0627827,64,35,29,6,1
SBI86CQA7605733,80,21,13,8,1
SBI52MLU5902126,94,23,16,7,1
SBI52FAD6573799,76,29,25,4,1
SBI70JTN8056721,63,19,13,6,1
SBI42MES2889251,90,25,20,5,1
SBI47LNR6057938,88,23,16,7,1
SBI28VTD9948319,79,28,15,13,1
SBI30EKT2821598,22,26,23,3,1
SBI35VFF4106906,97,24,16,8,1
SBI39ERI4208479,90,41,23,18,1
SBI36FOK7580887,67,26,24,2,1
SBI36BCZ2515013,81,28,21,7,1
SBI18MYJ9883471,69,36,30,6,1
SBI06XXN3282417,74,27,17,10,1
SBI96XPN1386487,63,21,12,9,1
SBI79PVX4910069,79,32,24,8,1
SBI60CQG9101887,60,24,20,4,1
SBI80MDJ9315744,84,22,16,6,1
SBI75HHV5210764,86,30,23,7,1
SBI53MYS0024696,64,27,19,8,1
SBI42IQC8810664,22,21,17,4,1
SBI58ZJR6546635,63,27,22,5,1
SBI52ULQ5372813,90,21,18,3,1
SBI36HOX2181329,61,31,30,1,1
SBI10JTS9223319,86,20,18,2,1
SBI64XUU7297169,95,20,14,6,1
SBI16PYH1536228,81,25,21,4,1
SBI57TQV8924513,77,26,22,4,1
SBI51ZXK3194418,72,15,10,5,1
SBI47ZWH9205438,70,28,26,2,1
SBI47JWK2354794,76,20,16,4,1
SBI57NHZ1571529,20,26,18,8,1
SBI68ZXG4747275,82,20,18,2,1
SBI35RRU3166269,87,37,23,14,1
SBI37GMI2527230,77,18,10,8,1
SBI67BLK5394044,60,26,14,12,1
SBI15YAO1357252,74,19,11,8,1
SBI17MPF9837224,72,33,21,12,1
SBI18ECH6253392,18,24,13,11,1
SBI90VNH1993581,98,28,21,7,1
SBI90KVF8146962,97,21,15,6,1
SBI60KDY8938368,85,16,11,5,1
SBI61MCJ4689090,62,33,27,6,1
SBI46HAY0200622,19,32,27,5,1
SBI24YRS4466827,90,21,19,2,1
SBI56HDK5147246,25,19,12,7,1
SBI27IPM7998269,60,23,18,5,1
SBI32MPR2389774,70,22,17,5,1
SBI01PAB1992868,94,23,12,11,1
SBI44CGJ0602923,80,21,17,4,1
SBI03HIZ9822413,73,20,12,8,1
SBI57OJR5388969,96,22,17,5,1
SBI79GJV6485650,92,25,22,3,1
SBI60HBF0606099,89,30,19,11,1
SBI50OHW0089612,24,30,24,6,1
SBI30FLU3636935,73,25,17,8,1
SBI46FGD0972048,91,24,22,2,1
SBI02AVZ0907858,68,31,16,15,1
SBI97XWO2414423,74,32,22,10,1
SBI91LAH4124214,21,28,23,5,1
SBI13BZQ7129753,95,19,16,3,1
SBI94DGN7346827,72,20,19,1,1
SBI12MEP2827966,89,29,26,3,1
SBI77EHP2618402,83,30,16,14,1
SBI87DRG7380845,91,21,13,8,1
SBI43UAO0148616,74,19,16,3,1
SBI35WWF6679002,70,17,10,7,1
SBI90HFN8299106,63,22,13,9,1
SBI14FCO8976014,93,27,24,3,1
SBI31FTE9740802,88,32,20,12,1
SBI61ROD2949353,93,27,14,13,1
SBI42ITA1754327,23,26,14,12,1
SBI78RRT9737384,65,30,23,7,1
SBI87NQC1474614,76,31,26,5,1
SBI90BMI2351086,68,21,11,10,1
SBI93WPB2086211,69,32,18,14,1
SBI40GIC2584542,88,31,29,2,1
SBI71FJF9975107,89,26,16,10,1
SBI01FDB8088489,19,29,19,10,1
SBI72OCX8997404,22,23,13,10,1
SBI20XEA2523009,61,21,20,1,1
SBI40ZWK4379357,97,31,26,5,1
SBI05VDE2316659,20,29,20,9,1
SBI99FVM9028595,92,20,19,1,1
SBI43FOK5699797,73,33,23,10,1
SBI46MLG5557347,96,30,24,6,1
SBI24FMY5702706,64,19,16,3,1
SBI37TSF3956686,22,25,19,6,1
SBI45ZRT4916632,97,33,19,14,1
SBI00VTE9134064,78,24,20,4,1
SBI90ISM5001335,72,30,21,9,1
SBI49AXD7060112,96,25,24,1,1
SBI39VSD2827374,98,22,19,3,1
SBI94ZGJ4322826,20,29,24,5,1
SBI60KBG4923940,60,29,28,1,1
SBI13KKZ2481930,63,28,17,11,1
SBI51YKX5443048,96,31,27,4,1
SBI31HJN4325093,78,26,16,10,1
SBI61CEW0109575,21,23,14,9,1
SBI38ZCH5335446,83,24,22,2,1
SBI50EQX7860695,74,27,16,11,1
SBI40OXA9989057,89,25,15,10,1
SBI58CBU8000992,71,21,14,7,1
SBI26BEW5426806,72,28,18,10,1
SBI32ARV1242492,65,29,28,1,1
SBI47DWH1677342,85,29,18,11,1
SBI92QRV8236604,75,24,17,7,1
SBI82UTS5272347,64,22,20,2,1
SBI97IVP5001967,20,33,23,10,1
SBI84OYF5080170,87,30,18,12,1
SBI80OOR3038458,64,17,15,2,1
SBI47HQK1135540,99,24,22,2,1
SBI76KTG4856202,87,21,17,4,1
SBI54RIY0602875,61,24,20,4,1
SBI82LWW1777107,81,24,19,5,1
SBI00XIY3429449,93,13,7,6,1
SBI34UZG6210293,71,22,12,10,1
SBI56ZQZ2626513,93,33,28,5,1
SBI75QEX0848624,86,23,13,10,1
SBI24LJJ6766222,97,26,23,3,1
SBI83OCZ2560836,85,19,13,6,1
SBI40QRK8905892,93,19,17,2,1
SBI80ZQC0866577,78,21,13,8,1
SBI07KIM1978864,96,30,23,7,1
SBI10XJK8130813,86,25,13,12,1
SBI02KYB8943820,75,22,14,8,1
SBI08RRH7131717,95,32,17,15,1
SBI08PPM7137497,65,24,19,5,1
SBI95XKJ3074897,95,17,13,4,1
SBI36TWO2194130,78,23,21,2,1
SBI89IQO6768016,61,23,16,7,1
SBI25NKV1709195,21,24,21,3,1
SBI72YDA0151687,23,26,15,11,1
SBI87BJY9383007,19,21,20,1,1
SBI26XKD5142445,83,24,16,8,1
SBI30ZQL2778186,77,18,15,3,1
SBI41HLO0771110,65,26,18,8,1
SBI29ESZ5878613,66,28,18,10,1
SBI23YJD7568623,19,24,18,6,1
SBI88GWO7957181,94,21,11,10,1
SBI07ADN7594487,21,24,21,3,1
SBI88RWQ5460062,92,23,16,7,1
SBI95WJD3398477,72,27,21,6,1
SBI33IPI5937721,91,18,14,4,1
SBI15JHH4480213,24,23,12,11,1
SBI89EEB0394218,98,25,22,3,1
SBI62QWA7614207,90,31,16,15,1
SBI47CWY0818044,97,23,14,9,1
SBI73DMI3621379,82,29,18,11,1
SBI74YFV1459832,96,26,19,7,1
SBI15IHG1642702,84,30,25,5,1
SBI40HTR3612979,18,23,20,3,1
SBI01RJB4634427,62,19,12,7,1
SBI19OOB7058161,69,19,16,3,1
SBI60NBG6565877,80,31,23,8,1
SBI62HAC3756279,92,34,20,14,1
SBI76BDI5254675,86,23,18,5,1
SBI59DCI7540843,78,30,25,5,1
SBI65ZDN6518939,82,26,22,4,1
SBI23XPN9285994,25,15,11,4,1
SBI63FRA4401683,95,27,24,3,1
SBI46DHY5299669,70,25,20,5,1
SBI35JDX3239876,96,34,29,5,1
SBI13JBM9324167,84,21,17,4,1
SBI08SPU7710112,88,28,16,12,1
SBI64YWN0256094,62,19,18,1,1
SBI11CPW2893017,21,25,18,7,1
SBI62BBM6023169,79,19,15,4,1
SBI13YVY2053837,85,26,16,10,1
SBI63BRY6485351,72,35,33,2,1
SBI50APA4291076,68,20,12,8,1
SBI88HWE9595965,22,33,32,1,1
SBI79KBP1830312,95,21,17,4,1
SBI34ADH9032126,20,28,20,8,1
SBI64TGF2751242,25,23,18,5,1
SBI25NKI6435667,76,21,19,2,1
SBI85GGS9024791,91,19,16,3,1
SBI55VCH4031392,20,25,17,8,1
SBI89XZR2681957,78,30,16,14,1
SBI50NGD7040315,71,25,18,7,1
SBI95RTH4863535,71,22,19,3,1
SBI93PCH2116228,84,27,24,3,1
SBI59QMA4183398,77,24,21,3,1
SBI43PHV8410780,89,28,20,8,1
SBI52HRX9837102,85,20,15,5,1
SBI05NRK8664515,96,20,17,3,1
SBI76VMP7358801,64,29,26,3,1
SBI77RER4042516,77,24,19,5,1
SBI41URL1567524,21,25,24,1,1
SBI92TPI8716658,72,22,20,2,1
SBI56PHH1145036,92,36,27,9,1
SBI01MLE6085650,70,29,28,1,1
SBI34MFR0989418,85,29,25,4,1
SBI70KMS4829816,64,26,14,12,1
SBI70QAU6838086,90,25,19,6,1
SBI48NUL7662061,94,27,21,6,1
SBI48ICK2629297,83,21,17,4,1
SBI11XYT6082658,95,21,12,9,1
SBI53UVA4483470,97,29,19,10,1
SBI05ZXX0717734,76,25,19,6,1
SBI22TIA8508399,85,27,23,4,1
SBI42MYN6157304,79,20,12,8,1
SBI05MWG0413416,79,33,23,10,1
SBI12ALO5653739,67,19,17,2,1
SBI93YLP3236098,96,19,14,5,1
SBI23OQL9451363,18,23,20,3,1
SBI63MYI1210186,20,28,20,8,1
SBI69UUQ0089914,19,15,11,4,1
SBI58JBS6326688,75,25,19,6,1
SBI19THU0183839,86,20,13,7,1
SBI85JGY8905733,88,23,20,3,1
SBI83RWJ3523595,93,25,22,3,1
SBI05SSD8402139,81,20,11,9,1
SBI34TPU2955656,87,22,20,2,1
SBI13KVR4263696,21,26,16,10,1
SBI89EBD3169977,75,28,22,6,1
SBI01LAM8418322,23,23,14,9,1
SBI87UCY4051171,20,22,20,2,1
SBI22RSC8920289,87,24,13,11,1
SBI66XCO7544302,83,22,17,5,1
SBI95HXO6547163,60,23,17,6,1
SBI87YWV5748748,19,27,26,1,1
SBI52BHN6234775,25,15,12,3,1
SBI18IIE4151268,21,17,13,4,1
SBI79RMH5649856,82,23,18,5,1
SBI44TVL5342326,78,21,15,6,1
SBI00OGH6668056,64,21,19,2,1
SBI25DEM6351450,84,22,14,8,1
SBI84NWV0452857,20,24,14,10,1
SBI25DXE1091510,95,20,15,5,1
SBI34SNK9604036,83,32,22,10,1
SBI72GUD0130433,63,29,15,14,1
SBI98COX2976686,89,24,22,2,1
SBI69UHR2325481,19,20,11,9,1
SBI88WCK6324658,84,22,17,5,1
SBI44PFK6802476,97,20,17,3,1
SBI24VMO0113917,64,28,20,8,1
SBI58JRF5594500,63,24,14,10,1
SBI27EMM0491549,66,20,17,3,1
SBI55DYG4217811,68,24,22,2,1
SBI97OJQ4892683,75,26,21,5,1
SBI08WKB6271697,71,25,16,9,1
SBI48MJZ2870511,19,26,19,7,1
SBI42RVO3061548,71,13,7,6,1
SBI69WGX4400712,76,26,15,11,1
SBI72ZEW0561259,86,33,18,15,1
SBI74XSQ8995723,71,22,20,2,1
SBI81YYT6301426,73,24,20,4,1
SBI42TDD7093292,78,27,23,4,1
SBI79VFZ2689760,99,23,16,7,1
SBI76PMZ2509022,93,22,18,4,1
SBI82BOK8467979,74,24,22,2,1
SBI70CCI5231267,61,26,14,12,1
SBI16FOS2514931,78,26,25,1,1
SBI02PUG5318610,76,27,20,7,1
SBI97HFJ0923273,73,18,10,8,1
SBI99PTR7228934,66,28,17,11,1
SBI03HYP3779505,94,19,15,4,1
SBI11FDS9874857,63,26,18,8,1
SBI41BYZ6400045,99,32,23,9,1
SBI26CBO8422120,65,20,12,8,1
SBI99KLS4977425,69,25,16,9,1
SBI04BHQ2952342,87,25,18,7,1
SBI34XYH3795224,95,18,12,6,1
SBI55HCL4879549,99,25,24,1,1
SBI22WEL9772238,88,18,10,8,1
SBI28PQB9568623,67,19,15,4,1
SBI33JOC5364789,87,30,26,4,1
SBI51PCU0589318,77,18,13,5,1
SBI45HPE3595420,75,26,23,3,1
SBI13WLS8859953,87,16,10,6,1
SBI36MKO7835648,22,24,18,6,1
SBI73IHI5708325,88,19,14,5,1
SBI41ACO9860975,95,26,17,9,1
SBI29JBD7993407,24,22,19,3,1
SBI12NBP7483532,74,26,14,12,1
SBI98IZF2052364,97,28,24,4,1
SBI93NOL7429319,79,25,21,4,1
SBI96SZX4878653,91,25,14,11,1
SBI31VJX1699285,21,20,11,9,1
SBI78TAI1593407,89,23,22,1,1
SBI82SQH6340268,93,37,21,16,1
SBI59XWQ1645039,71,23,20,3,1
SBI77ZOL0505908,18,29,16,13,1
SBI77LEK1028538,24,14,10,4,1
SBI41GRD7327841,22,30,28,2,1
SBI86VUF2619387,91,28,15,13,1
SBI99DDL5205909,91,27,25,2,1
SBI97JPJ9943621,21,20,17,3,1
SBI75IBM4671227,96,19,14,5,1
SBI68HFG3033451,93,18,16,2,1
SBI63NVN7478308,85,28,18,10,1
SBI77LSM0389101,69,29,23,6,1
SBI30JZR8348207,62,27,20,7,1
SBI11PND3782780,87,22,20,2,1
SBI33BHS5952612,82,27,22,5,1
SBI78JWR9844107,93,22,21,1,1
SBI67JAT0023419,73,17,15,2,1
SBI32DKC6599484,98,23,17,6,1
SBI85VMH9109222,61,27,15,12,1
SBI61LDK2823490,93,28,15,13,1
SBI21HXY0008708,74,29,22,7,1
SBI66QWS8134669,86,21,17,4,1
SBI34NEJ1583356,68,31,27,4,1
SBI25TCY7208556,79,28,24,4,1
SBI14YVK0720544,86,22,15,7,1
SBI99ZRI1867092,76,30,28,2,1
SBI29VKQ0696802,61,16,12,4,1
SBI13BGS8203839,19,35,22,13,1
SBI87BNT3271735,74,20,17,3,1
SBI54XMM6397935,80,26,23,3,1
SBI29QOA5397854,73,22,18,4,1
SBI58LII9658072,63,17,14,3,1
SBI80BKB3418968,90,15,9,6,1
SBI98KTY2463149,92,25,16,9,1
SBI01CJR0224890,22,31,18,13,1
SBI67LJU9543241,84,25,22,3,1
SBI45MSW8875271,61,17,11,6,1
SBI53JGX0508463,86,29,15,14,1
SBI08FQV0853623,83,28,22,6,1
SBI29TOE5124201,83,27,21,6,1
SBI70ZVC3136667,20,20,18,2,1
SBI46YSI0140860,22,22,16,6,1
SBI65BRX0366325,96,22,19,3,1
SBI31MFS6194492,19,34,23,11,1
SBI09FBP9152952,89,20,19,1,1
SBI73KWP3644042,64,27,14,13,1
SBI81VBV6399459,60,26,15,11,1
SBI39TXB2390716,90,21,13,8,1
SBI80RGT9810241,69,29,25,4,1
SBI04XWB8527452,23,29,26,3,1
SBI83HUX2158669,25,12,8,4,1
SBI86GXN7204086,19,13,10,3,1
SBI58NTW1434476,24,26,18,8,1
SBI39TEC0717499,86,22,12,10,1
SBI61BUV2648149,73,21,20,1,1
SBI76APZ6167089,95,33,23,10,1
SBI17EFB7838100,82,29,28,1,1
SBI95XIQ4170854,19,25,15,10,1
SBI13BMP4489375,95,15,11,4,1
SBI56EDQ5382067,85,22,13,9,1
SBI99SGX8910934,83,31,21,10,1
SBI31PQL5422171,83,30,17,13,1
SBI77TBQ8110234,72,15,14,1,1
SBI24ETW0412706,82,31,17,14,1
SBI79IVL7593505,91,21,18,3,1
SBI98PGT6081348,24,22,17,5,1
SBI82PZN7940926,82,35,27,8,1
SBI98OIY5367669,96,25,23,2,1
SBI65YME7573177,87,25,17,8,1
SBI16AQY5263839,88,26,25,1,1
SBI11LDM9748369,79,12,8,4,1
SBI24KQF2602003,79,21,11,10,1
SBI82KYZ9756937,90,30,16,14,1
SBI18SGA3604422,60,18,12,6,1
SBI39LFX0651379,85,27,20,7,1
SBI10BOG4031912,61,32,21,11,1
SBI35JYB8991771,63,30,28,2,1
SBI14BRL8365864,71,40,34,6,1
SBI93LLQ6167613,88,37,23,14,1
SBI04YAG9668541,86,31,19,12,1
SBI51CRY8262403,69,25,15,10,1
SBI01FXD7484301,88,21,19,2,1
SBI25XML4070400,73,28,15,13,1
SBI88TPB2392886,86,24,13,11,1
SBI12FAO1139003,85,26,15,11,1
SBI25SLY0005584,86,21,17,4,1
SBI43RFY4293746,82,32,25,7,1
SBI62NRH0524962,25,23,13,10,1
SBI33ELL7598370,71,25,17,8,1
SBI40MWW0297234,84,18,12,6,1
SBI59QMT6650819,60,25,21,4,1
SBI89ZGW5592609,72,21,19,2,1
SBI81IZC8286644,65,25,15,10,1
SBI00UCQ3361144,89,30,24,6,1
SBI73EXO0218350,64,20,14,6,1
SBI58GGE0685515,74,26,25,1,1
SBI36YXM4223732,68,26,14,12,1
SBI71YGH8334512,61,27,14,13,1
SBI92BGH9022685,20,24,21,3,1
SBI02SUU2341689,19,31,23,8,1
SBI84KKC7461953,25,24,18,6,1
SBI70BFQ8423252,18,24,15,9,1
SBI45SVR4147621,82,28,20,8,1
SBI10RWJ8089649,70,26,19,7,1
SBI60ETK3153277,19,23,15,8,1
SBI30GEW3704111,79,30,28,2,1
SBI25HDE5908310,20,17,12,5,1
SBI67XDQ5307874,98,25,24,1,1
SBI26IIT5077719,88,26,21,5,1
SBI98VPZ5426584,97,26,16,10,1
SBI19EEN2776461,82,29,19,10,1
SBI00VAS9438791,77,25,20,5,1
SBI10ONW1730922,96,26,20,6,1
SBI56YZP3811984,89,29,25,4,1
SBI91YFH3287799,84,24,15,9,1
SBI52ADQ6421861,63,30,28,2,1
SBI17NBA0325911,83,25,16,9,1
SBI58IHO4462809,62,17,12,5,1
SBI04QZP5230606,92,31,25,6,1
SBI06RDC6060318,99,26,24,2,1
SBI13LWL4060628,71,20,14,6,1
SBI69EEQ7012559,83,22,20,2,1
SBI18TMZ1384684,85,29,24,5,1
SBI13IKR6500339,67,25,24,1,1
SBI62MDU7375447,65,26,21,5,1
SBI49SRT2646629,66,21,16,5,1
SBI07QYQ4992541,89,36,22,14,1
SBI07JHB4611911,22,23,13,10,1
SBI38QJO1378409,73,27,16,11,1
SBI60IRG0238407,95,30,22,8,1
SBI32ONA9339306,63,19,14,5,1
SBI46DLS0626711,62,22,14,8,1
SBI34CWD1622171,75,27,16,11,1
SBI28BUV3682016,95,24,14,10,1
SBI07CTO8570915,91,18,13,5,1
SBI97DXO1875621,82,27,22,5,1
SBI73IFG9671237,92,28,25,3,1
SBI88NAG7623977,85,31,22,9,1
SBI19BHE4796288,94,21,15,6,1
SBI74TED1156031,81,30,27,3,1
SBI46YGX4614459,79,32,31,1,1
SBI64ZHU2816172,79,22,20,2,1
SBI47MLX5577474,67,19,16,3,1
SBI36WNO7440672,78,31,22,9,1
SBI97IQJ1973583,78,27,21,6,1
SBI75EKE2268552,72,29,26,3,1
SBI60VVP6268417,22,26,14,12,1
SBI48AOI3880296,93,34,24,10,1
SBI91PLB2211016,78,26,21,5,1
SBI27FYG3914098,92,31,23,8,1
SBI98KXL3342113,82,27,15,12,1
SBI16HAO5894673,75,18,17,1,1
SBI10TAG1683953,83,24,21,3,1
SBI27BZW3818677,24,23,17,6,1
SBI82WEE1439940,64,26,17,9,1
SBI72TNC7816247,68,20,13,7,1
SBI92TCJ7280076,63,20,18,2,1
SBI76PNX1667648,90,19,16,3,1
SBI38LVC2178228,78,28,27,1,1
SBI81KYX7970591,74,24,19,5,1
SBI00HTN6006826,81,29,16,13,1
SBI96TBG1390672,64,24,13,11,1
SBI82AAY8286905,90,26,20,6,1
SBI07DNE9005153,22,24,15,9,1
SBI58CFU2286272,19,28,15,13,1
SBI46NSW2710293,93,13,11,2,1
SBI03JMI6612591,63,21,14,7,1
SBI23XPB9152901,89,24,17,7,1
SBI81FXU6908102,92,22,12,10,1
SBI54RNE3584847,96,26,25,1,1
SBI31ALD1315446,87,28,19,9,1
SBI17JNR8686970,90,25,18,7,1
SBI86GKL6181805,90,22,14,8,1
SBI20IKF0095110,74,18,12,6,1
SBI56FEP2527423,84,28,24,4,1
SBI72RYE9610958,98,24,18,6,1
SBI57PZH6197651,90,26,20,6,1
SBI79ADK8696393,60,14,12,2,1
SBI58SSO4344558,69,25,13,12,1
SBI01FPZ1746373,21,31,16,15,1
SBI89KOG6307759,20,24,13,11,1
SBI32GGE8534281,96,25,23,2,1
SBI38AMY0915111,95,26,20,6,1
SBI52RTM0202003,80,24,15,9,1
SBI07GDE7111253,63,16,11,5,1
SBI65ZXJ7695692,60,32,23,9,1
SBI92AAP9294807,18,28,17,11,1
SBI23EVH0964393,65,30,20,10,1
SBI02QWG7096039,93,30,28,2,1
SBI97YGF3209029,87,19,14,5,1
SBI27TFD6848587,72,19,15,4,1
SBI67OFE9539681,94,18,14,4,1
SBI09PPV3267881,97,21,20,1,1
SBI29QOG8422432,65,18,16,2,1
SBI88PCY0159684,74,24,18,6,1
SBI67CDP6285710,93,26,23,3,1
SBI86IWZ6327920,87,20,16,4,1
SBI62ZCP3380281,99,22,17,5,1
SBI81BRR8684619,65,30,26,4,1
SBI52PZJ6845359,93,25,24,1,1
SBI66KBJ9886374,89,35,27,8,1
SBI00RJD2227503,24,27,22,5,1
SBI24MTB9419912,63,24,22,2,1
SBI44KEE5381702,66,26,21,5,1
SBI02EAP6396874,78,27,26,1,1
SBI93FTR0402952,99,28,15,13,1
SBI75TWC7699022,95,25,17,8,1
SBI83CEH5028634,84,24,19,5,1
SBI87ZZM2418061,25,35,20,15,1
SBI01PIH4097834,82,20,12,8,1
SBI71WBT9782786,22,24,16,8,1
SBI03AEE5690001,68,25,16,9,1
SBI43ZEW1725443,91,27,25,2,1
SBI39PXU4269067,99,24,13,11,1
SBI74HCP8758594,78,23,19,4,1
SBI78AUM3010635,90,26,23,3,1
SBI23YZA3684456,61,29,18,11,1
SBI29DRU7779163,83,18,16,2,1
SBI32UZY2220291,82,17,16,1,1
SBI64CVD8665128,62,20,16,4,1
SBI29QOA5508043,73,24,17,7,1
SBI73CEX4999733,92,16,11,5,1
SBI95HTG9130425,20,19,15,4,1
SBI80HAG4576297,69,27,25,2,1
SBI31EET4946963,96,32,27,5,1
SBI94PTX8564821,71,22,14,8,1
SBI90DTG6891574,84,33,32,1,1
SBI44BUL2911293,63,24,23,1,1
SBI86SIU9202632,22,24,21,3,1
SBI77BIJ8539526,19,15,10,5,1
SBI94DMT7037853,18,29,17,12,1
SBI76ECO2447085,23,28,26,2,1
SBI53HSP4740687,81,25,13,12,1
SBI96TWT4952043,75,23,18,5,1
SBI11EJI0013797,97,28,25,3,1
SBI58ATV2962996,93,31,17,14,1
SBI17GYM2424713,99,16,15,1,1
SBI03MJA2391366,96,26,21,5,1
SBI75WIK8260470,99,26,24,2,1
SBI77BDR8698043,99,23,16,7,1
SBI09DHX5915404,78,24,18,6,1
SBI49UJM4574160,69,25,15,10,1
SBI00JRY3100644,87,22,16,6,1
SBI29UST9972871,24,23,19,4,1
SBI64KRY9717783,24,21,12,9,1
SBI76BML9623666,93,29,15,14,1
SBI27DTN1457813,62,25,17,8,1
SBI78MMS8246955,77,19,12,7,1
SBI10AOW3983680,25,31,22,9,1
SBI92QQY5954864,83,30,29,1,1
SBI52TSY7755526,92,26,16,10,1
SBI53GVN4149214,66,30,21,9,1
SBI44YNB5549708,76,26,17,9,1
SBI80LLO5103035,60,25,19,6,1
SBI93SLW4150291,85,24,23,1,1
SBI15GIF2618041,69,24,19,5,1
SBI33OOQ4489714,98,23,12,11,1
SBI49JHW4058489,75,30,18,12,1
SBI31SZV3280944,23,21,17,4,1
SBI10SIW3790505,66,26,18,8,1
SBI55RXW4776699,79,28,16,12,1
SBI21OBQ9389063,20,28,16,12,1
SBI23VUX3338423,76,21,16,5,1
SBI25ENY0768410,85,24,16,8,1
SBI64GWU9523943,98,30,29,1,1
SBI64XUJ6051488,98,19,16,3,1
SBI85GPK0161241,92,29,28,1,1
SBI60EGY7678530,76,27,23,4,1
SBI85HKS1060394,60,25,21,4,1
SBI64LIS9983964,99,25,19,6,1
SBI88DHL4006044,65,30,16,14,1
SBI49XBS1483369,99,20,13,7,1
SBI59LJY3108644,94,13,12,1,1
SBI82PIE0034155,60,20,12,8,1
SBI98IDP3189139,22,25,24,1,1
SBI85XYR1790430,75,32,19,13,1
SBI11IFO9002999,83,22,18,4,1
SBI80BZB8166208,22,27,26,1,1
SBI49CFS6739340,62,33,24,9,1
SBI59WPI5606779,97,36,28,8,1
SBI99RTG2159986,78,23,14,9,1
SBI65OOJ4688401,22,27,25,2,1
SBI73MEQ3743500,95,25,15,10,1
SBI27IVB1322551,99,25,17,8,1
SBI26PRE8983550,99,16,11,5,1
SBI46MDG4185606,82,19,12,7,1
SBI57ZXH6024972,97,23,14,9,1
SBI02DZL6026168,95,31,18,13,1
SBI21YOG5740781,80,16,9,7,1
SBI12SSX1010400,20,30,16,14,1
SBI41LHI2033326,65,30,21,9,1
SBI54PUI9033254,22,26,19,7,1
SBI43QUY2711409,92,21,15,6,1
SBI72MNP5956704,87,27,23,4,1
SBI59VDN7295251,69,21,18,3,1
SBI80IMD2371318,97,27,26,1,1
SBI70XMQ6213321,96,16,10,6,1
SBI55TMR5654068,18,20,14,6,1
SBI51NZO6697396,73,23,22,1,1
SBI78YDW8503967,70,25,18,7,1
SBI04NGD4719109,76,27,25,2,1
SBI69TRG9100137,91,19,17,2,1
SBI96ECT4974471,90,27,26,1,1
SBI87ISH2229099,72,22,19,3,1
SBI35KPJ9233642,81,25,22,3,1
SBI24FAJ9408036,25,26,23,3,1
SBI97SXT2663436,96,25,13,12,1
SBI11KCR2303421,97,28,27,1,1
SBI07BCC5810469,18,33,31,2,1
SBI95DKZ0542678,95,21,13,8,1
SBI33ZXC2426879,19,24,20,4,1
SBI33FGI7749945,22,27,22,5,1
SBI11GCE9100374,61,20,19,1,1
SBI07TFL3938815,18,32,30,2,1
SBI13EEI4007606,65,23,12,11,1
SBI50BEX6727331,73,23,14,9,1
SBI15YSM7604673,68,26,17,9,1
SBI71TSN1533086,78,24,18,6,1
SBI41YTJ1356419,93,16,15,1,1
SBI39MHE9841686,90,34,19,15,1
SBI37TPM7755824,84,33,28,5,1
SBI05NGP1827806,95,35,25,10,1
SBI45UEP0373317,69,30,25,5,1
SBI63GXW5997240,71,21,16,5,1
SBI72NPJ0657414,97,32,29,3,1
SBI61QRI5955972,71,22,18,4,1
SBI92FPX1477094,87,14,11,3,1
SBI44SRS4527551,18,33,18,15,1
SBI83YWA1650926,98,20,16,4,1
SBI48DMX6151872,90,25,16,9,1
SBI17NFL2124336,90,24,20,4,1
SBI57NJE5177300,88,30,23,7,1
SBI90QYI2449632,68,31,22,9,1
SBI64QZY9239367,81,24,18,6,1
SBI18OBN0386710,78,32,26,6,1
SBI13GKS8210928,86,21,12,9,1
SBI69GAH7292444,63,23,17,6,1
SBI07XKM7696413,94,19,18,1,1
SBI09QSP7713351,77,31,22,9,1
SBI35MUA7709831,68,23,13,10,1
SBI92GKV2220153,95,21,19,2,1
SBI09VFY0709067,19,29,28,1,1
SBI97ATG6462016,62,22,16,6,1
SBI19IZN7576130,94,23,17,6,1
SBI09NSP8922337,79,22,18,4,1
SBI78SLM9568828,66,26,19,7,1
SBI25LBU3084765,24,17,10,7,1
SBI43GWV7016664,79,26,21,5,1
SBI40QCC4950137,66,17,10,7,1
SBI14ADU7818517,75,20,13,7,1
SBI57VYD0042412,72,26,15,11,1
SBI37MHA9420247,67,33,19,14,1
SBI42IDG2798772,76,26,17,9,1
SBI73SGY9177264,81,22,12,10,1
SBI62UDQ7754885,23,32,31,1,1
SBI71GDO7615641,86,31,19,12,1
SBI17ZYH5315575,68,28,16,12,1
SBI73YAZ1566244,95,29,21,8,1
SBI87QYE8039493,95,27,18,9,1
SBI26SZQ1739574,93,27,20,7,1
SBI63PXO6451403,25,19,11,8,1
SBI64LSP5508535,22,31,19,12,1
SBI83CNR6998437,74,29,19,10,1
SBI41BDV7006339,97,20,17,3,1
SBI08FKR3595299,78,22,17,5,1
SBI58KTT1745050,80,30,17,13,1
SBI94OCB8225964,63,15,10,5,1
SBI28IOA3240660,99,31,29,2,1
SBI52JYC1997735,94,29,28,1,1
SBI85ZDW5775637,20,24,23,1,1
SBI89OPZ6110220,65,18,17,1,1
SBI44YRH1367052,79,24,14,10,1
SBI61WHD4169593,79,22,21,1,1
SBI39TKD9185824,22,25,16,9,1
SBI98CKN0605281,22,27,24,3,1
SBI15UVA7279123,24,26,16,10,1
SBI78UTH1511963,80,29,17,12,1
SBI00DPK1186443,74,27,21,6,1
SBI50KEL2283372,76,25,23,2,1
SBI57VEO7861822,80,26,17,9,1
SBI95BGG1906240,21,23,15,8,1
SBI33IWM7126584,78,26,15,11,1
SBI46NKP3934407,91,27,21,6,1
SBI15YRS9887403,62,33,28,5,1
SBI61LHG7347437,71,27,19,8,1
SBI59UUX5421969,60,17,13,4,1
SBI00NBP7587592,95,36,25,11,1
SBI08UZE6608327,73,20,11,9,1
SBI00KSE5860665,69,36,31,5,1
SBI92JGT3079641,79,27,26,1,1
SBI27SKZ8390156,69,30,26,4,1
SBI65KHS5363215,85,18,15,3,1
SBI19FLV4907575,60,25,23,2,1
SBI26XVG9768023,71,29,23,6,1
SBI95IQF9194060,61,21,19,2,1
SBI32SYJ6837621,23,28,20,8,1
SBI25ECS3882066,98,29,23,6,1
SBI54GOV8558869,21,31,30,1,1
SBI58YLW1158619,85,21,13,8,1
SBI64MDA3149247,70,23,22,1,1
SBI87MGZ5238726,20,20,11,9,1
SBI00SUK1780881,73,21,20,1,1
SBI95LSM5620718,76,24,15,9,1
SBI41VWT8658605,78,32,27,5,1
SBI57VRE5032462,67,19,11,8,1
SBI58UMN2051149,89,16,12,4,1
SBI97ABQ7640764,83,23,18,5,1
SBI73PAW7556884,80,21,13,8,1
SBI17KKZ0557306,69,22,18,4,1
SBI36MKA9800635,60,33,30,3,1
SBI07MHG8866125,87,21,16,5,1
SBI06KIY1970900,96,16,14,2,1
SBI81AUK5687283,24,27,16,11,1
SBI23JOU3689041,18,24,17,7,1
SBI67QAA3465616,69,17,15,2,1
SBI11MIG3728039,60,16,15,1,1
SBI28ASP1857289,75,28,17,11,1
SBI14JGX6078293,82,29,28,1,1
SBI63YAE1205417,61,33,25,8,1
SBI11MWD7269814,67,15,11,4,1
SBI65FMK3595252,70,21,17,4,1
SBI59ETW7008141,69,24,13,11,1
SBI63DYY2462937,65,22,21,1,1
SBI88GRD2285597,24,30,20,10,1
SBI98OPM4147611,66,26,15,11,1
SBI05KZF4933724,74,22,20,2,1
SBI88GPV7958222,62,34,21,13,1
SBI94HCW6194011,24,20,14,6,1
SBI35FIS0959001,19,26,22,4,1
SBI66CTB9565999,79,22,13,9,1
SBI65PSH1493927,70,29,26,3,1
SBI19BMM4770529,63,27,21,6,1
SBI67NFX9096037,85,30,28,2,1
SBI09JKD0073051,73,26,23,3,1
SBI73HXN1828224,87,17,15,2,1
SBI91JIR3511175,71,24,20,4,1
SBI43OWM8332885,64,25,14,11,1
SBI63FPC8151216,67,13,11,2,1
SBI22ZGX3908612,82,25,13,12,1
SBI80NNT7618074,96,22,20,2,1
SBI68ODP3352659,75,28,19,9,1
SBI76WFW8845488,66,29,19,10,1
SBI60YJZ2381931,98,25,22,3,1
SBI19UHI2903711,93,24,17,7,1
SBI01DHQ5869346,78,20,15,5,1
SBI15UOK3111208,65,24,15,9,1
SBI25ACC1485847,83,32,27,5,1
SBI69DJJ9744754,71,31,26,5,1
SBI09QUY8147384,73,21,17,4,1
SBI14OFG5998300,71,25,13,12,1
SBI29GCD3575307,20,20,19,1,1
SBI03RWK4087280,74,25,21,4,1
SBI07GGI8008681,23,22,18,4,1
SBI49BWL8899289,83,25,23,2,1
SBI61BFX0727395,91,28,23,5,1
SBI08YTC5105550,68,24,22,2,1
SBI78ZBN0057489,68,24,19,5,1
SBI49AES7900876,98,19,16,3,1
SBI28PLG5069273,77,28,26,2,1
SBI31EAN8151344,60,25,15,10,1
SBI52IZH8965959,66,28,15,13,1
SBI29VTZ7810151,81,23,16,7,1
SBI59BLN3898676,96,24,17,7,1
SBI59OXG0339825,67,27,14,13,1
SBI66SLP0693115,20,24,13,11,1
SBI78LOC8055305,91,21,18,3,1
SBI14XFK8829091,78,17,12,5,1
SBI56EDY9064403,62,21,11,10,1
SBI95FAN7931462,19,22,17,5,1
SBI05OBI1707426,24,28,15,13,1
SBI26AOY7436222,93,16,12,4,1
SBI06PKV7957343,71,36,34,2,1
SBI54NNH0381834,85,31,20,11,1
SBI07RCM9101692,83,22,21,1,1
SBI62OKV6582506,21,29,21,8,1
SBI68BOE2903258,92,14,13,1,1
SBI97GOG0444626,76,28,20,8,1
SBI41LLY0425091,19,29,15,14,1
SBI90PJG7438330,18,18,15,3,1
SBI00STN0016985,95,29,22,7,1
SBI31BMR7065232,18,23,16,7,1
SBI72CGU7422761,86,16,10,6,1
SBI98DSZ9218707,79,30,25,5,1
SBI14DTW7545337,91,20,18,2,1
SBI98XOM9195019,87,30,22,8,1
SBI09QRG9297337,94,28,20,8,1
SBI67WBE9837462,88,31,28,3,1
SBI01IDX7818958,19,32,23,9,1
SBI43YGA2086371,19,18,16,2,1
SBI01WSL2560784,79,40,32,8,1
SBI25KOD4926249,93,30,22,8,1
SBI55GMK0101038,23,29,17,12,1
SBI67JJF9885616,21,23,20,3,1
SBI52SDE3915190,75,23,16,7,1
SBI66BGO1274806,95,24,15,9,1
SBI60MTM5545618,73,26,14,12,1
SBI51CRS1537673,86,17,13,4,1
SBI25EKH2086172,77,19,16,3,1
SBI23LHS2143449,60,19,15,4,1
SBI44ZCW5828119,87,23,13,10,1
SBI19ROG2091115,78,21,13,8,1
SBI35XFG2117624,25,32,20,12,1
SBI85IWQ8216033,73,29,24,5,1
SBI43IMN7841965,65,19,18,1,1
SBI01BOM4506915,71,22,17,5,1
SBI50BAY1032107,23,26,16,10,1
SBI21FTT6383174,79,24,21,3,1
SBI28OMQ4059895,77,20,13,7,1
SBI27DHO9871505,63,29,21,8,1
SBI14LOP1569568,80,29,19,10,1
SBI31BMP4295469,61,26,19,7,1
SBI62XIJ0502666,77,26,15,11,1
SBI43CGE3932269,97,21,11,10,1
SBI55ONA9093973,63,26,25,1,1
SBI67EXX2469515,66,20,11,9,1
SBI87CUZ4533504,19,28,15,13,1
SBI39FMB1463662,81,21,20,1,1
SBI31OQZ2931393,68,12,7,5,1
SBI19HCN5758819,93,37,20,17,1
SBI54CRB2174930,25,28,19,9,1
SBI80CRB1740002,67,20,12,8,1
SBI34YYX1420377,78,23,22,1,1
SBI04LIF1315796,78,27,19,8,1
SBI42CTA9558709,25,19,12,7,1
SBI34YIC7565010,69,26,14,12,1
SBI22URJ6520140,60,19,18,1,1
SBI98GMJ7335773,75,24,16,8,1
SBI21IDU4497577,20,30,23,7,1
SBI36MYG0191348,82,23,14,9,1
SBI86OME0903267,76,15,9,6,1
SBI47VKK2295240,64,20,13,7,1
SBI87LWP7631339,87,25,15,10,1
SBI36RSL0664860,68,21,20,1,1
SBI00ZRB4189299,67,27,23,4,1
SBI04QRY0038894,89,28,22,6,1
SBI88SHU4128869,79,25,13,12,1
SBI35KIK4774102,83,28,16,12,1
SBI94TKE8083630,78,22,13,9,1
SBI31ZAH8410381,69,40,30,10,1
SBI94UHN0603664,83,26,25,1,1
SBI30YQB0287172,76,20,16,4,1
SBI66JYO5087822,20,31,16,15,1
SBI25WXB9128405,18,24,23,1,1
SBI29GQL4655622,70,25,15,10,1
SBI69HFF6820239,91,23,17,6,1
SBI64PVX6843204,61,24,15,9,1
SBI52AOD5998143,95,26,14,12,1
SBI13TPP3980627,92,21,20,1,1
SBI50CHY5421223,70,22,12,10,1
SBI87KFC1682155,20,22,15,7,1
SBI71BQD0670524,23,19,16,3,1
SBI84GLE1014473,62,26,23,3,1
SBI22ENE4342222,89,30,17,13,1
SBI37GVR2309266,22,22,20,2,1
SBI79PWP0023318,69,20,12,8,1
SBI81ICR2196655,21,27,17,10,1
SBI75CUO1370374,64,18,12,6,1
SBI80RWX6388434,80,24,20,4,1
SBI73RPR2089951,18,21,16,5,1
SBI11HIA9195648,62,31,24,7,1
SBI38UGR0146830,19,18,13,5,1
SBI92PVD8151440,86,21,14,7,1
SBI12DVB1877863,91,21,11,10,1
SBI28RHE7149899,70,29,26,3,1
SBI61WSF7525974,93,31,16,15,1
SBI67OUP1767992,92,21,20,1,1
SBI30BOA6999885,90,25,16,9,1
SBI73KDY8295147,63,23,15,8,1
SBI24OIG2466473,92,22,12,10,1
SBI38CSM6530686,60,24,18,6,1
SBI39GCR0275385,88,31,26,5,1
SBI87RDT0641343,25,22,12,10,1
SBI46WZB5077352,73,24,14,10,1
SBI76WSK8870417,85,20,19,1,1
SBI13PFA5900630,82,21,16,5,1
SBI02VPT7669130,91,31,17,14,1
SBI82WOG2661976,89,34,19,15,1
SBI69GLO5670374,60,21,13,8,1
SBI22SCZ7007459,79,21,13,8,1
SBI19OTE4070286,77,23,20,3,1
SBI59KGN4008425,96,21,19,2,1
SBI92EID3513946,91,30,23,7,1
SBI44BKX5530046,71,22,19,3,1
SBI08REA6363289,71,27,18,9,1
SBI57RVF3584148,63,17,15,2,1
SBI60YOD0005942,93,28,17,11,1
SBI03QCQ5608574,86,20,17,3,1
SBI50PJF1074809,24,20,12,8,1
SBI85ERL9073808,25,26,18,8,1
SBI39RUA5632192,60,32,17,15,1
SBI96RHD7636215,72,19,13,6,1
SBI79KPN4436126,67,25,20,5,1
SBI79HUB5940228,66,25,24,1,1
SBI53OZM7583406,96,17,13,4,1
SBI62PMJ9144866,88,23,19,4,1
SBI17XFE5215197,84,26,18,8,1
SBI01EHL1879634,70,24,23,1,1
SBI13TZR6088537,73,29,18,11,1
SBI77LWS2628247,60,21,19,2,1
SBI34QEV4374297,65,17,12,5,1
SBI59YZK1029419,64,23,21,2,1
SBI23AEX3977007,72,32,18,14,1
SBI16FZE7234660,90,13,7,6,1
SBI97JKL9727518,87,27,14,13,1
SBI72PEK0220298,80,28,26,2,1
SBI84YEJ6122979,67,34,18,16,1
SBI92OYA0212181,73,33,30,3,1
SBI38BZD8053575,99,17,9,8,1
SBI67SOR9566346,66,23,14,9,1
SBI51POC7156820,71,30,17,13,1
SBI13BBL0491190,75,21,12,9,1
SBI04HRY6382596,91,11,10,1,1
SBI60SIQ8963476,84,25,22,3,1
SBI88DXB2083815,89,20,11,9,1
SBI08GYY8032784,89,20,18,2,1
SBI58GYA8411572,81,23,16,7,1
SBI76FKR3928867,82,30,22,8,1
SBI55YZL3293700,95,25,21,4,1
SBI41EYD7187683,80,19,12,7,1
SBI26RMS4842530,64,20,16,4,1
SBI93DML9317326,25,20,17,3,1
SBI83PBM6984987,90,18,10,8,1
SBI91MAR6114969,72,26,16,10,1
SBI50EUG1919740,72,25,22,3,1
SBI12QYV5534873,99,21,20,1,1
SBI97SEW6842868,83,13,11,2,1
SBI42LOR4607347,97,21,12,9,1
SBI94AWF2172076,93,22,12,10,1
SBI09RPB4402316,95,27,16,11,1
SBI90OXO8144322,78,23,12,11,1
SBI50MIW3484720,24,29,27,2,1
SBI34HYI4866502,95,25,19,6,1
SBI95XGG2817552,61,18,10,8,1
SBI06MCH9820847,89,27,22,5,1
SBI50KHW3596412,88,24,13,11,1
SBI21WWW0497958,23,22,21,1,1
SBI19JID2994035,93,25,14,11,1
SBI60SSX6971662,77,32,28,4,1
SBI42IQI2922036,21,26,23,3,1
SBI92UJQ4618430,82,29,28,1,1
SBI76FQU6793827,82,20,14,6,1
SBI39MHH0058305,68,15,8,7,1
SBI21ABO4052511,90,30,17,13,1
SBI37WSR4485102,79,24,22,2,1
SBI48ISH7292499,73,29,22,7,1
SBI22KEK0361823,78,17,10,7,1
SBI93ORL4032465,85,31,30,1,1
SBI00YWQ1138001,83,23,16,7,1
SBI54KDW2733898,86,26,23,3,1
SBI40WEP8606658,60,24,16,8,1
SBI72TFE1512046,98,29,21,8,1
SBI96IXN4211171,99,19,15,4,1
SBI25OUN9523927,89,27,15,12,1
SBI38GFH6194906,24,34,33,1,1
SBI28TWT6916782,87,25,22,3,1
SBI17ENZ2381670,23,26,21,5,1
SBI59FNM6565774,92,25,13,12,1
SBI78OAG1415635,60,9,6,3,1
SBI00QYI9462092,68,31,17,14,1
SBI90QUB2328232,83,22,13,9,1
SBI24EDM6690798,24,19,13,6,1
SBI66CXF5068420,92,24,13,11,1
SBI14KMV5045187,76,24,21,3,1
SBI43UNO8526423,72,29,25,4,1
SBI95YTC1478552,93,21,15,6,1
SBI52IUM0585139,85,29,24,5,1
SBI20SIG4956745,83,19,16,3,1
SBI87SYZ9154767,71,23,13,10,1
SBI23OOJ7357014,22,31,20,11,1
SBI65KGO4057391,74,24,13,11,1
SBI45VRL6255596,97,26,14,12,1
SBI88BEL0796980,66,19,18,1,1
SBI32DHP3585973,82,30,27,3,1
SBI34NWZ4534551,89,17,15,2,1
SBI11SVS2356480,67,24,21,3,1
SBI81JGK5628575,76,23,17,6,1
SBI28JSL4518703,68,28,19,9,1
SBI45IVF4240809,97,26,16,10,1
SBI57LOX7915500,88,34,19,15,1
SBI21ZQQ8125067,19,20,11,9,1
SBI21WRA1200501,22,22,20,2,1
SBI67OHU4649339,24,24,23,1,1
SBI32CZN7321076,79,24,21,3,1
SBI65VWZ3537704,86,25,18,7,1
SBI41ZFO0580692,92,24,19,5,1
SBI67BOU7604209,64,29,25,4,1
SBI43KRG6840847,23,18,13,5,1
SBI56WCI8277851,79,31,24,7,1
SBI91GKJ1131229,80,33,18,15,1
SBI37TML9693740,74,24,13,11,1
SBI32KJR4823652,72,20,18,2,1
SBI11ANH7685964,61,20,19,1,1
SBI46HRJ6903381,90,18,16,2,1
SBI08BOE3788261,68,24,17,7,1
SBI67ZZE9596008,20,23,13,10,1
SBI26VTM0618608,74,29,18,11,1
SBI67NCN7665511,95,35,19,16,1
SBI24ZMW3133958,92,19,14,5,1
SBI85NPD3459704,81,30,23,7,1
SBI02PKG6713925,76,24,23,1,1
SBI26ERM4570388,75,20,13,7,1
SBI74FGH2180011,19,13,12,1,1
SBI34XAQ6091811,19,32,27,5,1
SBI88HYD6761393,20,21,15,6,1
SBI92GDW7395804,61,30,24,6,1
SBI47NAI6109733,67,20,14,6,1
SBI22PFD2895421,77,20,19,1,1
SBI07VXQ4342992,95,29,27,2,1
SBI98MIK6957789,65,21,20,1,1
SBI21DOK5224035,93,19,15,4,1
SBI43MDE6778570,98,18,11,7,1
SBI88MIU0972236,94,25,17,8,1
SBI57BFK0697405,97,27,19,8,1
SBI79ZCJ3941496,90,22,15,7,1
SBI26WJJ0895906,60,24,18,6,1
SBI23XHC0908212,72,27,21,6,1
SBI86EMM5235937,89,28,25,3,1
SBI70BTB9921665,66,23,17,6,1
SBI55HZK5969644,70,29,17,12,1
SBI71AQY7100277,73,22,19,3,1
SBI78JPW7906751,22,24,17,7,1
SBI30JHJ6035108,20,25,20,5,1
SBI72FYX7950004,70,29,20,9,1
SBI22QLM2388727,65,21,14,7,1
SBI21IMU3400882,64,34,22,12,1
SBI25TYX1198136,61,23,13,10,1
SBI25TXK0119910,64,24,22,2,1
SBI29YJQ2760867,91,23,13,10,1
SBI88BUZ0993029,79,26,23,3,1
SBI52AKY9919630,99,19,11,8,1
SBI13XGH7971868,23,14,12,2,1
SBI48DZE2287898,90,19,11,8,1
SBI25LHE5141001,87,31,25,6,1
SBI26WAW3808285,95,23,18,5,1
SBI51UJD9760980,73,22,15,7,1
SBI29VHX4593588,24,25,18,7,1
SBI81SDT4233768,78,21,11,10,1
SBI87ROQ5310822,61,27,15,12,1
SBI63IIO5148763,86,22,16,6,1
SBI47TOM1531985,94,25,14,11,1
SBI10YZM1887971,82,28,17,11,1
SBI79JOH5877688,87,25,24,1,1
SBI23WXH9362517,80,27,23,4,1
SBI01DSP7655474,94,29,18,11,1
SBI51WPB0858535,69,25,16,9,1
SBI80VMU6890422,83,29,25,4,1
SBI67HHQ9227021,25,24,20,4,1
SBI09PLL7418822,66,22,16,6,1
SBI80ARU5716766,70,30,25,5,1
SBI02QVF2372115,95,28,20,8,1
SBI34XDP2131566,60,27,20,7,1
SBI50KZM9290548,93,23,14,9,1
SBI42WYH5505606,21,25,16,9,1
SBI58PPF0921129,62,29,22,7,1
SBI38WQB2305973,67,23,16,7,1
SBI70YDZ0374086,73,26,16,10,1
SBI59LXR6508052,64,15,13,2,1
SBI94SPG3238042,63,30,23,7,1
SBI68DQZ7145755,81,29,24,5,1
SBI51YRH8626026,80,22,13,9,1
SBI13HFB7795239,74,21,13,8,1
SBI02JJV7870116,86,28,21,7,1
SBI71AVH8834409,23,21,15,6,1
SBI64VCG7321899,66,32,26,6,1
SBI81MRV6424788,86,22,21,1,1
SBI69FDW1899005,89,27,19,8,1
SBI74YQQ6245507,88,28,17,11,1
SBI65KQZ7458574,98,33,28,5,1
SBI61BXL3509315,88,21,16,5,1
SBI51NGS9462884,90,23,19,4,1
SBI40MYT6887802,86,30,18,12,1
SBI83NAE1564762,79,27,19,8,1
SBI21UOS5523509,82,27,14,13,1
SBI89ZKP0907599,83,13,9,4,1
SBI85ZFS5823008,61,20,19,1,1
SBI88SNZ0931373,22,27,24,3,1
SBI40JJI6586758,86,27,16,11,1
SBI01FBA0920500,75,25,17,8,1
SBI21EAW1465128,20,28,22,6,1
SBI99WMD7168029,96,29,15,14,1
SBI97FJK8306713,20,24,21,3,1
SBI26OMP0712879,92,27,23,4,1
SBI96CQL8064314,68,22,12,10,1
SBI71KVO7549340,86,28,24,4,1
SBI26WVG5414149,22,18,15,3,1
SBI03UNX8029349,86,33,28,5,1
SBI53EPL0575759,18,22,19,3,1
SBI86RUC5985070,22,22,20,2,1
SBI12BGM2105000,18,22,16,6,1
SBI49ONY2063750,63,25,22,3,1
SBI24KMJ4908366,72,24,21,3,1
SBI61PNO6017236,20,27,15,12,1
SBI92KGB1114293,79,25,18,7,1
SBI88ZOR0908168,75,14,8,6,1
SBI37VCN9926843,80,27,17,10,1
SBI23JIB9114510,94,24,13,11,1
SBI61AST3580365,60,24,15,9,1
SBI39XCQ0897116,92,21,15,6,1
SBI03YDZ1749758,88,18,11,7,1
SBI54BJJ0122055,98,29,17,12,1
SBI94NXM5384867,20,27,25,2,1
SBI08UQY7999409,71,24,14,10,1
SBI37WZE3634072,80,35,22,13,1
SBI74TUT9268811,21,28,24,4,1
SBI12BOW3638234,70,19,12,7,1
SBI92KBD1754583,23,28,21,7,1
SBI79WLI5294250,25,32,31,1,1
SBI86QGE0304829,87,26,18,8,1
SBI16YZP2918325,96,30,29,1,1
SBI41KOC7545392,65,27,14,13,1
SBI88WHB2513392,79,23,15,8,1
SBI73PDF4305905,25,26,15,11,1
SBI50IQO6880539,68,19,10,9,1
SBI27XQT0833317,63,20,16,4,1
SBI30ISZ3012568,25,23,15,8,1
SBI65LZE6071309,74,30,18,12,1
SBI89EDJ9639930,23,17,16,1,1
SBI73GHH0468864,24,27,15,12,1
SBI30DRP9566246,67,27,22,5,1
SBI44HAA8863068,22,24,21,3,1
SBI07JGW5226144,66,25,18,7,1
SBI33HKN4836112,19,25,24,1,1
SBI70EAD9024437,92,35,21,14,1
SBI86RPJ6535126,66,23,21,2,1
SBI35OCD1553452,24,16,11,5,1
SBI87RHA7432657,65,20,19,1,1
SBI54EUX3436878,75,18,16,2,1
SBI09QCC8799151,71,34,33,1,1
SBI91EPY4073947,23,22,14,8,1
SBI80IVY5021220,63,31,24,7,1
SBI63EFT2649474,89,29,19,10,1
SBI03ZNA5109752,96,24,14,10,1
SBI50RWD7150347,82,32,26,6,1
SBI78UQH2352565,23,38,33,5,1
SBI94NLA5310562,76,24,22,2,1
SBI96ESR4088542,95,22,12,10,1
SBI13TKF9373962,19,29,27,2,1
SBI70LYP1897598,70,15,8,7,1
SBI13VYT1753753,72,20,12,8,1
SBI77WHL3451342,19,24,21,3,1
SBI58OVO9168450,69,29,19,10,1
SBI15PJT4440511,66,23,14,9,1
SBI82ZCG3814025,65,29,21,8,1
SBI37JZM2578573,62,18,16,2,1
SBI50QMA4483633,88,17,11,6,1
SBI86MNU8534195,81,20,11,9,1
SBI55GDE2076724,91,22,14,8,1
SBI68FLC7264735,22,31,22,9,1
SBI69SCS8996541,84,23,14,9,1
SBI15RMO7026503,63,29,17,12,1
SBI91ZSY7272815,88,26,25,1,1
SBI72FCS1787746,62,18,12,6,1
SBI29WTS1552210,83,22,20,2,1
SBI76AGY2499223,72,27,24,3,1
SBI32BMC2350054,75,21,11,10,1
SBI23NTQ0614143,75,25,15,10,1
SBI80PBM4603771,78,24,17,7,1
SBI99QJU3532872,78,29,24,5,1
SBI21UGW7857833,86,24,14,10,1
SBI30OWS5495949,93,33,27,6,1
SBI49BXE6470785,92,15,10,5,1
SBI96WZF8809050,99,28,15,13,1
SBI39ZJV7896583,60,21,20,1,1
SBI21LSD6371332,72,29,16,13,1
SBI53JJW0645072,84,20,13,7,1
SBI85XWR8072221,87,28,16,12,1
SBI61AEO8328378,66,29,15,14,1
SBI37JYK3087758,92,24,14,10,1
SBI13NUZ9994077,70,23,17,6,1
SBI21RDK7724051,18,33,17,16,1
SBI45PQM9857030,60,25,20,5,1
SBI13GHO8411770,86,22,15,7,1
SBI91TQY6820371,23,27,24,3,1
SBI77YYN1574205,64,26,21,5,1
SBI46ERH6999379,64,18,15,3,1
SBI39NGG1961180,91,23,19,4,1
SBI94VZZ3811050,25,27,23,4,1
SBI69MPV6710636,93,27,22,5,1
SBI87NRM8886867,70,19,17,2,1
SBI92XHV0308457,98,26,16,10,1
SBI90IHS6003718,85,22,12,10,1
SBI01JTJ0194416,80,17,14,3,1
SBI62DTG1938842,21,18,13,5,1
SBI35TYQ8609956,64,25,23,2,1
SBI06LNJ5498321,77,30,17,13,1
SBI37WML2011271,67,24,21,3,1
SBI93GCO7056073,86,22,12,10,1
SBI52EVF2835486,72,33,23,10,1
SBI25SBN6604596,78,20,17,3,1
SBI58QSZ9833618,80,24,15,9,1
SBI46MBY7364812,81,22,18,4,1
SBI97PVU6641969,81,35,22,13,1
SBI55DRS2183925,76,19,18,1,1
SBI00RGU1699908,22,24,22,2,1
SBI94WNM0832405,92,18,16,2,1
SBI64KSF6624213,79,26,22,4,1
SBI23PCK1737143,25,20,12,8,1
SBI32GLN3264337,94,16,15,1,1
SBI90IIZ9472943,62,34,26,8,1
SBI26EMD5137173,76,37,29,8,1
SBI57HCC6624542,92,31,23,8,1
SBI80YRO2243029,19,25,17,8,1
SBI34LNX3927604,22,22,20,2,1
SBI42VUZ9608893,60,32,27,5,1
SBI72IFM1248665,24,24,23,1,1
SBI44KEJ5317340,93,25,15,10,1
SBI57RZH2903828,18,26,16,10,1
SBI27YUS9635568,22,25,24,1,1
SBI61NKU3413365,77,25,18,7,1
SBI52ITZ2165682,64,10,8,2,1
SBI58CRR7502181,73,21,14,7,1
SBI08NBY0640827,75,27,14,13,1
SBI61QXK1360044,81,23,17,6,1
SBI23GIK5624008,73,23,19,4,1
SBI84ABX8540223,64,25,21,4,1
SBI29VQG6866646,89,29,28,1,1
SBI42NTR7194219,76,29,18,11,1
SBI56FRJ6350781,91,23,15,8,1
SBI46UBM0096329,20,22,16,6,1
SBI53TXX1373163,82,22,20,2,1
SBI37HPD8033133,71,24,15,9,1
SBI06EWR8763937,69,34,26,8,1
SBI04KEU7363904,73,23,13,10,1
SBI80MTV6562676,84,30,26,4,1
SBI10UNE8622762,93,33,17,16,1
SBI82AAS1617162,21,21,15,6,1
SBI52NHM4648189,93,27,15,12,1
SBI45KWE0660257,76,24,17,7,1
SBI07VNH1198443,73,21,11,10,1
SBI80WEE1070726,63,15,12,3,1
SBI95LNI7635417,62,27,20,7,1
SBI06EPD9418567,60,25,17,8,1
SBI80RPL2542344,89,25,17,8,1
SBI12HUF1987511,70,23,21,2,1
SBI61BHQ5565752,75,23,15,8,1
SBI33AHY8002119,60,24,21,3,1
SBI16MKY3102763,87,29,16,13,1
SBI95DGK5100414,64,22,16,6,1
SBI18RIR5799681,93,28,22,6,1
SBI94UEX3190547,24,17,15,2,1
SBI84RNZ2776856,94,26,16,10,1
SBI75SPD3349892,86,18,16,2,1
SBI71CII6801092,23,27,21,6,1
SBI62QLA5045810,89,36,21,15,1
SBI77UKF1393123,18,27,21,6,1
SBI45DJV4232357,18,31,28,3,1
SBI35WUJ6705972,25,27,14,13,1
SBI38YNN6810339,88,21,16,5,1
SBI44VME9636490,60,23,18,5,1
SBI58DLZ8073589,83,20,11,9,1
SBI18VUB0710039,71,26,20,6,1
SBI88VIY8475715,76,33,28,5,1
SBI88GJL9524024,70,22,20,2,1
SBI56OPL6172816,76,28,22,6,1
SBI53KNQ7499885,91,28,22,6,1
SBI94EBV1190453,20,27,19,8,1
SBI46KGZ5797008,24,18,16,2,1
SBI39FLE9785832,21,21,11,10,1
SBI34SOP3968903,71,21,15,6,1
SBI41EYH9224416,92,29,28,1,1
SBI36TQI6094141,91,26,14,12,1
SBI63JLT2485688,85,21,14,7,1
SBI76RXO3804591,60,26,20,6,1
SBI09DWB9558975,81,28,18,10,1
SBI76WOX9202086,66,25,23,2,1
SBI02YVC5016430,70,18,14,4,1
SBI08PNY6307905,61,26,20,6,1
SBI64LKO3516895,71,28,17,11,1
SBI69ZEF3767920,98,33,18,15,1
SBI09QDW2941043,88,21,20,1,1
SBI32GNR2554944,76,33,28,5,1
SBI82HTR6651158,69,20,15,5,1
SBI55EDT4182058,81,24,21,3,1
SBI67PWZ8955731,23,23,19,4,1
SBI28YAL4955850,80,35,30,5,1
SBI22POP5603812,97,24,13,11,1
SBI30CLG9894832,61,30,18,12,1
SBI38GZG0005202,92,26,23,3,1
SBI56IGT2782663,63,22,20,2,1
SBI96MAU8131388,96,34,33,1,1
SBI17RFD1844265,74,30,27,3,1
SBI53WRR0544653,68,29,20,9,1
SBI55KJL3028240,21,29,28,1,1
SBI12JLN0824666,89,21,12,9,1
SBI49MLP6373271,72,25,24,1,1
SBI15VAI5120921,25,22,16,6,1
SBI89JMA0008830,82,21,12,9,1
SBI69STR7829683,97,18,11,7,1
SBI74NXK8928172,78,21,19,2,1
SBI36IUX7323123,80,31,25,6,1
SBI52AXN7255420,69,27,19,8,1
SBI12ZKL2870686,62,19,13,6,1
SBI10BXA2431850,96,14,13,1,1
SBI53KLJ7842530,23,30,24,6,1
SBI33JCC8535468,63,24,17,7,1
SBI15XNE1225888,71,22,14,8,1
SBI98PJZ0160280,67,20,17,3,1
SBI80ROK9186295,91,26,15,11,1
SBI21JZF8104952,88,16,12,4,1
SBI56PST2240566,20,21,14,7,1
SBI82LLC8568702,86,27,22,5,1
SBI09GFE5913362,96,23,16,7,1
SBI66SJE9932736,62,19,10,9,1
SBI44VAM2462272,78,20,13,7,1
SBI41YVQ6821200,97,13,12,1,1
SBI05EWM4370941,63,25,16,9,1
SBI90OHV8452567,67,20,18,2,1
SBI36RQQ9260615,23,26,21,5,1
SBI24XEP2707008,61,21,16,5,1
SBI84VYW0396334,99,24,21,3,1
SBI18NCF3652172,60,22,18,4,1
SBI92IIZ8230276,70,29,20,9,1
SBI35NAA4625449,71,25,14,11,1
SBI60TMR6080881,97,25,16,9,1
SBI64KDS6535140,98,26,24,2,1
SBI48GSA0663912,91,26,24,2,1
SBI30SZS8085278,84,21,16,5,1
SBI22JBP2638813,65,26,19,7,1
SBI22NKK8291905,81,26,16,10,1
SBI70WKP8934340,84,24,17,7,1
SBI00CLW0242868,22,23,16,7,1
SBI98FTS4185481,68,18,16,2,1
SBI32MKJ1441554,62,25,15,10,1
SBI16RML4985346,80,11,9,2,1
SBI22TCP5553780,63,22,12,10,1
SBI26VBC0999240,74,28,19,9,1
SBI85SLL2417529,76,17,12,5,1
SBI83RTI9075465,98,21,15,6,1
SBI91GEN1486470,90,20,12,8,1
SBI33HXG7708606,88,29,18,11,1
SBI99GWC2171260,88,19,10,9,1
SBI41GRT6738424,88,21,17,4,1
SBI22NHF4232490,96,23,18,5,1
SBI41AWB7828016,74,23,19,4,1
SBI38EIJ8357965,65,30,19,11,1
SBI32VRT0223070,97,20,11,9,1
SBI85PAT1418644,82,17,9,8,1
SBI62ZEJ5691860,98,31,25,6,1
SBI34WRA1184370,91,20,17,3,1
SBI44POU3470051,22,27,18,9,1
SBI68ZPX0513135,62,26,18,8,1
SBI22GXC3959826,65,24,21,3,1
SBI72ECY5079724,98,21,18,3,1
SBI08UUE8205060,22,27,26,1,1
SBI98SML3431927,23,28,19,9,1
SBI79IFN2647818,18,22,13,9,1
SBI42HCC1327071,22,27,24,3,1
SBI75DIU9341524,21,21,13,8,1
SBI63GMP1359839,65,22,12,10,1
SBI59SQH3853725,87,28,24,4,1
SBI72WVW6987629,91,25,13,12,1
SBI87RIH2553164,81,26,24,2,1
SBI69FKL5420550,65,22,12,10,1
SBI23XBJ5727097,82,31,23,8,1
SBI81JKY9214727,69,27,16,11,1
SBI74HNU9570161,87,21,19,2,1
SBI09EHR3435715,80,28,22,6,1
SBI03UGS4078664,94,19,16,3,1
SBI96GSE6555176,98,34,28,6,1
SBI41GVO8948249,83,24,23,1,1
SBI43VSM6513760,99,29,25,4,1
SBI44KDU7625519,72,14,11,3,1
SBI42JCT7528960,86,23,17,6,1
SBI41XHP4901501,60,19,12,7,1
SBI09MHH2966239,71,25,16,9,1
SBI50ONG1848857,90,27,22,5,1
SBI12CXI6784303,82,23,18,5,1
SBI80ODM7437636,72,15,11,4,1
SBI01BTB5452741,96,19,10,9,1
SBI99NAW4722513,95,22,17,5,1
SBI65ZFI5052202,79,25,23,2,1
SBI97ZDY3960633,73,20,18,2,1
SBI85BJT6806759,93,28,15,13,1
SBI49DBN6980701,89,22,12,10,1
SBI69SRG5455363,91,30,22,8,1
SBI85CSM1807637,98,22,14,8,1
SBI59MVD4677055,72,17,14,3,1
SBI21UTS8762845,78,16,12,4,1
SBI60NZT9184584,80,28,25,3,1
SBI83UKX4596440,68,29,22,7,1
SBI05ZBR3043193,21,17,12,5,1
SBI45XBX2619926,94,30,27,3,1
SBI67OJX4117922,73,27,17,10,1
SBI86ACA9456422,67,26,18,8,1
SBI95QKA7001460,18,30,20,10,1
SBI93CBH9283651,96,21,14,7,1
SBI19CHP2753421,24,28,17,11,1
SBI00HTI7851003,76,31,28,3,1
SBI89AME6954853,93,35,25,10,1
SBI91YPF0467558,22,31,16,15,1
SBI00TVT6136456,68,19,18,1,1
SBI20FUQ3934293,64,31,28,3,1
SBI53DRF7520922,65,24,21,3,1
SBI11WYT8545433,67,22,21,1,1
SBI36FJU8367062,83,28,21,7,1
SBI60HTM9019303,66,25,24,1,1
SBI84UNF7268104,98,22,19,3,1
SBI68YJX9879503,81,17,9,8,1
SBI02DFO1482388,69,26,14,12,1
SBI39XOV5369039,68,25,24,1,1
SBI27XMY5986928,22,26,24,2,1
SBI53ZXS7422055,97,26,24,2,1
SBI99QRI5088870,86,26,19,7,1
SBI44UVG4388994,20,23,17,6,1
SBI18XER3637729,77,15,11,4,1
SBI77FBP7441567,19,22,20,2,1
SBI41YUW8283155,75,31,24,7,1
SBI00YFP7515483,73,26,17,9,1
SBI14MJA0436024,83,16,13,3,1
SBI74QBT6907485,64,24,22,2,1
SBI19OTP3386506,96,18,17,1,1
SBI50VQW4888011,18,20,18,2,1
SBI10GXX5226987,77,21,17,4,1
SBI12HGW9812650,61,17,16,1,1
SBI74UTE1071882,96,28,26,2,1
SBI62UAP1105619,80,25,24,1,1
SBI51GFA3070473,70,24,16,8,1
SBI55ALJ0997301,89,27,18,9,1
SBI30VRW0281621,85,25,15,10,1
SBI88RPL8373722,67,21,13,8,1
SBI18SKD8430525,75,25,16,9,1
SBI15LPN5270425,88,25,13,12,1
SBI26HJE2910219,83,38,28,10,1
SBI37JVV2752905,83,26,19,7,1
SBI56GNA9387093,60,30,28,2,1
SBI59IZD0032016,24,17,15,2,1
SBI10VAW3163152,67,25,22,3,1
SBI87TPC8065670,98,35,20,15,1
SBI92EKI2182504,62,31,17,14,1
SBI62DHQ7153681,25,27,26,1,1
SBI56OBX9360197,84,24,14,10,1
SBI36HFF3041587,89,24,23,1,1
SBI90RPC1108930,84,31,17,14,1
SBI65UUK4326633,90,27,19,8,1
SBI79ALT1960406,20,21,11,10,1
SBI57NKW5324878,73,27,19,8,1
SBI89XQY2091397,93,21,12,9,1
SBI84EAA2606513,77,26,21,5,1
SBI37KZK3733035,94,24,18,6,1
SBI34MOZ7168960,94,14,11,3,1
SBI03RHW8500218,65,22,18,4,1
SBI58NQH9465231,91,26,16,10,1
SBI77CMA1984346,78,19,14,5,1
SBI44LML9525166,72,27,17,10,1
SBI34CSH0185309,84,19,13,6,1
SBI10RDN3864835,24,23,22,1,1
SBI19NDU4552107,21,27,20,7,1
SBI51RRA0513772,72,31,28,3,1
SBI97EBJ5114840,67,18,11,7,1
SBI90ZAB4136045,64,14,10,4,1
SBI29XLV8034541,88,22,14,8,1
SBI54SMW5390070,25,25,17,8,1
SBI89TYZ7495278,88,22,12,10,1
SBI34DKF7065652,70,28,19,9,1
SBI66TJD7321313,85,30,25,5,1
SBI24POX3128051,67,20,16,4,1
SBI72KEH1510070,25,18,15,3,1
SBI89LXW3790659,85,20,13,7,1
SBI75ZRO2731506,60,20,15,5,1
SBI10RRL1903992,88,27,23,4,1
SBI64WLQ1755087,81,30,18,12,1
SBI83PXQ8440984,73,24,19,5,1
SBI72MHA4741346,25,16,13,3,1
SBI16IHO2289110,89,32,26,6,1
SBI32GVM2957228,90,29,22,7,1
SBI41TEG1810893,77,26,15,11,1
SBI00IGS3039618,95,27,22,5,1
SBI60BFS0966184,83,37,35,2,1
SBI12ERU0004761,81,27,23,4,1
SBI30EZF8753151,73,24,16,8,1
SBI35AWH7900105,24,31,27,4,1
SBI38DJP2437654,76,30,21,9,1
SBI88SHM6682967,62,20,11,9,1
SBI79QFT5375815,83,21,19,2,1
SBI68CXM0620651,61,29,20,9,1
SBI71FLX7344440,68,25,20,5,1
SBI84IOS9573294,23,16,13,3,1
SBI78CVT5337086,85,17,9,8,1
SBI96VCI2156050,91,12,9,3,1
SBI36WQC7121191,19,25,13,12,1
SBI14GBN7478953,24,14,13,1,1
SBI46USJ7851863,24,21,19,2,1
SBI40JIE5133257,70,22,16,6,1
SBI52BWK2816180,77,22,21,1,1
SBI29VOR5704233,25,16,11,5,1
SBI92XNT7290202,18,28,25,3,1
SBI35GBE4722797,78,28,17,11,1
SBI58ESA0926550,86,19,13,6,1
SBI12LYK5578777,97,26,14,12,1
SBI97SJB3524478,94,27,24,3,1
SBI82QYR6397400,70,26,19,7,1
SBI31HBA2753309,96,21,16,5,1
SBI08SCQ2256999,18,16,12,4,1
SBI40MNG8211018,75,23,21,2,1
SBI75HZY5900041,74,25,21,4,1
SBI39FKJ5639769,24,30,25,5,1
SBI70ZPM7934919,65,15,8,7,1
SBI33KBD4690938,93,25,17,8,1
SBI13LZC4590967,96,23,16,7,1
SBI85BTF7988663,80,27,20,7,1
SBI90ZXU7400040,21,19,16,3,1
SBI83DFD4242356,90,26,20,6,1
SBI02BLG7723021,18,28,21,7,1
SBI66YQE8066000,73,16,11,5,1
SBI37IEW1770166,87,21,12,9,1
SBI07YLJ9054841,71,28,25,3,1
SBI06GFB3377110,73,23,13,10,1
SBI97WVC4386089,78,18,11,7,1
SBI36MHD0434284,89,29,23,6,1
SBI62VLU3379428,64,25,22,3,1
SBI26ASJ5005028,65,25,21,4,1
SBI70RRQ7094971,78,22,20,2,1
SBI81JQS1690686,76,15,13,2,1
SBI11USG3905760,61,25,16,9,1
SBI02KVR1910979,72,30,24,6,1
SBI42FZJ8103573,72,26,14,12,1
SBI89IQR6013477,82,29,17,12,1
SBI08CDI9801110,98,25,17,8,1
SBI28RSC8680812,78,24,23,1,1
SBI41XDX3996467,62,29,19,10,1
SBI37XPE4380509,84,34,19,15,1
SBI39HOV4840434,84,30,17,13,1
SBI88CMB1942732,62,18,14,4,1
SBI85AQK1707859,99,26,23,3,1
SBI92JAV3113683,96,39,22,17,1
SBI85KRP8358111,68,21,13,8,1
SBI26ZNJ4906832,97,24,21,3,1
SBI56NQE7613487,60,30,27,3,1
SBI96GBK9751819,96,27,22,5,1
SBI60FQJ4822347,96,32,26,6,1
SBI29ARS9320755,63,25,14,11,1
SBI76EHK0054613,21,21,15,6,1
SBI93LKL1719019,62,30,18,12,1
SBI24HDW8579608,95,34,26,8,1
SBI90FQS4944541,63,33,28,5,1
SBI39IUI4841681,98,20,16,4,1
SBI24FJL9993307,84,18,16,2,1
SBI29SFD4100110,74,31,29,2,1
SBI81CQD3595755,63,21,18,3,1
SBI76HOK8911900,77,28,21,7,1
SBI66FTH8748971,73,21,20,1,1
SBI06ZGP8059412,82,29,22,7,1
SBI81HOX0467583,92,26,25,1,1
SBI26OPQ7921895,71,31,23,8,1
SBI10FSU1955309,80,29,26,3,1
SBI79GFR0893884,97,22,20,2,1
SBI52XOB5925897,89,39,29,10,1
SBI03AUY2337382,73,21,20,1,1
SBI27RNA6371546,74,18,13,5,1
SBI00QHS4417743,92,28,19,9,1
SBI89TLX9233743,79,25,21,4,1
SBI73VYS4612943,88,25,18,7,1
SBI25KMQ7268387,78,19,12,7,1
SBI31PIY8504657,61,20,13,7,1
SBI84MVE8764178,82,30,19,11,1
SBI66PAA5873519,77,25,15,10,1
SBI51GDG2191554,94,29,16,13,1
SBI76KMS8246226,71,28,27,1,1
SBI02ZCL9614694,75,26,24,2,1
SBI09ZPV3293690,89,31,21,10,1
SBI14RJC0590658,90,23,13,10,1
SBI26HZV0405065,69,30,27,3,1
SBI56NQR9120965,63,33,19,14,1
SBI91WCV1626603,69,32,21,11,1
SBI75BRC4360312,86,20,19,1,1
SBI62PIA6446325,99,34,18,16,1
SBI41QEM8829490,69,33,28,5,1
SBI40UDM2180741,93,27,25,2,1
SBI84HXT3081873,88,26,16,10,1
SBI49GQY7906802,64,24,20,4,1
SBI12NGN8680175,99,22,20,2,1
SBI65CCH6280057,86,26,24,2,1
SBI31OEM2357508,95,29,17,12,1
SBI55JBW2108892,68,24,19,5,1
SBI80XFS3378060,90,22,17,5,1
SBI88MXJ0159576,77,24,21,3,1
SBI52GWY5026925,92,33,21,12,1
SBI39ZPM9069204,65,23,16,7,1
SBI70TKP0188949,66,26,17,9,1
SBI92SGY3005575,73,31,25,6,1
SBI12KYN8295344,18,15,9,6,1
SBI49LVI5919888,99,28,24,4,1
SBI52FCR7926321,90,20,15,5,1
SBI53VRC7175842,67,24,20,4,1
SBI52LQU7394899,90,33,23,10,1
SBI98VPS1637013,80,24,16,8,1
SBI35BKT5793980,20,31,28,3,1
SBI09AKJ0569232,85,24,19,5,1
SBI87FJH6069805,75,16,14,2,1
SBI79NVD0739011,72,23,17,6,1
SBI37VDR0902173,63,23,16,7,1
SBI03LEN5826521,60,16,13,3,1
SBI45SQM0126348,21,23,13,10,1
SBI03GVC0804938,99,28,21,7,1
SBI74FPD6594697,61,20,18,2,1
SBI87SYB4305633,99,26,18,8,1
SBI02BRJ5718570,60,32,17,15,1
SBI90LAC3107916,70,32,29,3,1
SBI35XDD3779436,87,22,21,1,1
SBI65FNC1602808,96,30,23,7,1
SBI14OMB2080836,62,25,14,11,1
SBI66KWH1704822,93,17,13,4,1
SBI89OIQ7307159,73,24,21,3,1
SBI64DWX2118721,87,24,23,1,1
SBI87SEU0715074,88,29,18,11,1
SBI68HBW5127100,25,23,19,4,1
SBI74MSG5980280,78,26,22,4,1
SBI70DQN5146579,72,21,14,7,1
SBI38BEM1902906,96,29,19,10,1
SBI82EHD1653162,61,23,19,4,1
SBI59UMC1556108,77,30,21,9,1
SBI61AZL7329296,89,19,14,5,1
SBI43ENJ0697847,97,22,20,2,1
SBI26TWL8331441,97,25,16,9,1
SBI81VLU3666308,23,24,17,7,1
SBI90PNP8726992,92,28,18,10,1
SBI45JUW5114556,22,24,19,5,1
SBI41LAN0285093,95,23,22,1,1
SBI10OFN7136354,89,25,14,11,1
SBI33OHQ7333177,75,16,15,1,1
SBI70HKI6172681,86,30,18,12,1
SBI49UWB1557533,65,26,24,2,1
SBI13UJI7377375,67,19,15,4,1
SBI69PLY8042708,88,21,13,8,1
SBI00IHF7124999,82,21,17,4,1
SBI53HPO4344587,87,11,9,2,1
SBI53TVA2437331,71,28,16,12,1
SBI85PSM9660079,96,35,28,7,1
SBI27ZGZ7172729,23,28,25,3,1
SBI75QOH8229686,84,13,10,3,1
SBI40EXW4359010,79,17,15,2,1
SBI62RIC6398460,81,19,11,8,1
SBI91TNS1668528,89,22,21,1,1
SBI65WDS8014816,93,20,17,3,1
SBI65KBC7861977,94,34,18,16,1
SBI69PHE4041669,77,32,24,8,1
SBI18FCF6822147,18,17,15,2,1
SBI04DCL7308490,19,36,21,15,1
SBI51XTR8426557,63,33,21,12,1
SBI33JPG3261135,99,26,20,6,1
SBI48XBS8290131,96,12,9,3,1
SBI99PVU4742564,90,19,18,1,1
SBI32KXY8035596,84,20,15,5,1
SBI18OYQ0334792,83,29,26,3,1
SBI05QEM3915025,91,37,34,3,1
SBI60PQM6694169,94,24,14,10,1
SBI10VTB7265074,83,34,19,15,1
SBI00KBM9938721,77,14,12,2,1
SBI57RPW3855719,80,23,18,5,1
SBI58SHA8381848,84,26,19,7,1
SBI83BMC7785423,73,29,16,13,1
SBI26JBY9710539,79,20,14,6,1
SBI74GZX9111599,95,16,12,4,1
SBI37XDE3462692,24,27,26,1,1
SBI73CLZ7125519,97,26,15,11,1
SBI49BAS4119462,87,21,11,10,1
SBI29THD1539501,18,23,14,9,1
SBI66IOE8015253,72,33,23,10,1
SBI90WUB1463269,62,21,18,3,1
SBI90FJY3887632,83,26,18,8,1
SBI52RKY3190990,92,21,19,2,1
SBI54PBN7827689,62,18,15,3,1
SBI63COF1215971,24,22,12,10,1
SBI82GFE3328388,21,27,15,12,1
SBI63JKU0625300,74,30,23,7,1
SBI56QKE4857609,81,29,15,14,1
SBI62ILC1498492,70,26,19,7,1
SBI46VRI3402077,68,37,22,15,1
SBI78SZZ7740665,72,25,24,1,1
SBI41XIN3961231,23,26,23,3,1
SBI59JRG6765097,75,30,27,3,1
SBI35DJW8190359,76,23,19,4,1
SBI53XIB3453312,89,17,15,2,1
SBI77GSV8375751,66,26,23,3,1
SBI28LPJ4332529,62,19,15,4,1
SBI54CSY2029116,63,19,13,6,1
SBI07WXA7681050,68,26,16,10,1
SBI63UAE2792498,20,25,16,9,1
SBI88EAH6942188,20,28,26,2,1
SBI66NAX9260652,61,31,21,10,1
SBI21AAG9082132,25,23,12,11,1
SBI88XLG4407785,93,28,22,6,1
SBI98GII0094753,61,25,16,9,1
SBI01VTN2845340,94,19,12,7,1
SBI62DGW9186150,94,23,17,6,1
SBI36YHG9526391,89,26,25,1,1
SBI70MVU0804917,77,23,22,1,1
SBI40AEA4241804,67,23,12,11,1
SBI51TXT6190158,69,27,17,10,1
SBI56EPS0410435,94,35,23,12,1
SBI43DPJ3892105,63,32,29,3,1
SBI19ZBE8747993,82,20,14,6,1
SBI18LQD4384637,89,30,29,1,1
SBI20TKA9747239,89,25,19,6,1
SBI94HPC3794035,97,23,17,6,1
SBI25MQO2254606,85,32,26,6,1
SBI01QHR5902723,73,26,14,12,1
SBI28TVI0124996,65,32,20,12,1
SBI04VQH9349383,89,25,24,1,1
SBI19MZH5790289,74,24,17,7,1
SBI69JDD0594745,68,28,18,10,1
SBI93QFT9277902,64,26,21,5,1
SBI87VDV4799635,90,22,14,8,1
SBI66OIT9470103,93,31,23,8,1
SBI53WAD1952611,21,26,19,7,1
SBI93GNT0839006,68,20,12,8,1
SBI83IJG5154952,90,17,12,5,1
SBI29IRZ0977684,76,24,22,2,1
SBI07QEZ6183875,85,22,21,1,1
SBI97NOX6628771,83,22,19,3,1
SBI24EOI7796951,19,21,20,1,1
SBI58GIN8757597,77,17,14,3,1
SBI81NCK6231254,20,21,12,9,1
SBI80NHR0272617,66,27,18,9,1
SBI66KPU1981291,92,21,18,3,1
SBI40UKC7707463,96,35,32,3,1
SBI75LKP9638639,75,22,19,3,1
SBI92DIE9350857,90,28,26,2,1
SBI35JIS2605627,73,16,10,6,1
SBI55IFN6748523,73,28,15,13,1
SBI45NIF3446984,61,20,15,5,1
SBI56GDG8515723,67,25,24,1,1
SBI18GNM5232344,72,16,15,1,1
SBI22SGF0702384,77,21,11,10,1
SBI55UHM0361989,84,18,14,4,1
SBI89FCJ0584038,67,21,17,4,1
SBI80TVV3616056,86,24,17,7,1
SBI39BSO4063455,75,25,13,12,1
SBI59YFE6468253,73,19,12,7,1
SBI88SBN2525582,97,32,30,2,1
SBI95YIO9543005,80,26,22,4,1
SBI16EYC9768016,79,28,24,4,1
SBI74YNO4219959,63,33,19,14,1
SBI13HGA6894790,84,30,20,10,1
SBI44AQI2911986,71,28,23,5,1
SBI30IMW6109085,70,22,12,10,1
SBI43PCN2586230,68,21,14,7,1
SBI65KBW6062958,79,26,19,7,1
SBI54QBG9781952,68,30,28,2,1
SBI21YJK1848950,25,29,24,5,1
SBI01ATZ1390327,96,32,19,13,1
SBI57TTK4709715,87,15,10,5,1
SBI10UEB5011457,61,25,24,1,1
SBI45QOU3746907,84,29,15,14,1
SBI14CTG4844579,79,20,19,1,1
SBI12MZF5155278,62,29,25,4,1
SBI64TXW1749826,75,26,17,9,1
SBI34HTH0247463,62,29,16,13,1
SBI03JMO2389755,60,22,12,10,1
SBI52KCF4129740,90,15,12,3,1
SBI95DVT4243322,21,23,21,2,1
SBI90ONF1561467,72,28,27,1,1
SBI17SPC9441401,89,22,17,5,1
SBI65UWZ3774585,24,23,15,8,1
SBI56ZOO5443092,69,25,24,1,1
SBI18GDD9734485,80,25,14,11,1
SBI40BOH0886928,81,25,20,5,1
SBI25GTH6144993,19,26,19,7,1
SBI99KLL6195143,79,21,19,2,1
SBI19LNU7549726,25,23,21,2,1
SBI61XCN0246747,79,23,15,8,1
SBI57BLV2584191,74,19,15,4,1
SBI73NTF9702976,93,33,28,5,1
SBI75OKZ6427966,67,23,12,11,1
SBI78SLS0948800,25,24,22,2,1
SBI84MKR4367808,79,24,17,7,1
SBI03TES0301641,64,34,21,13,1
SBI04FVG5549647,92,27,24,3,1
SBI88HMG2908368,77,23,18,5,1
SBI17LNK9131563,85,31,26,5,1
SBI50UXQ6701258,21,28,16,12,1
SBI96KLI7943833,65,28,25,3,1
SBI58NHW8515087,91,34,22,12,1
SBI57ZRO8030418,91,30,24,6,1
SBI42WTH8110472,64,25,20,5,1
SBI55JLP5480278,81,16,10,6,1
SBI15ZOQ2576236,97,29,22,7,1
SBI06YUV9395073,70,26,24,2,1
SBI11KRX6437337,69,20,18,2,1
SBI13IIH5081145,22,25,21,4,1
SBI70BCQ3265056,97,21,19,2,1
SBI96URB1334353,22,26,19,7,1
SBI60QBN6708236,91,24,22,2,1
SBI61MXN4382701,67,28,19,9,1
SBI85OWJ1077297,64,28,15,13,1
SBI92NGL4901702,80,17,15,2,1
SBI97XBR1276932,70,25,14,11,1
SBI76DTD0896942,79,16,12,4,1
SBI01BXO1361876,91,24,21,3,1
SBI55QLB6398243,92,22,13,9,1
SBI89ZBK8798495,62,28,17,11,1
SBI83JNZ5353006,85,21,15,6,1
SBI96IKB2231859,67,26,22,4,1
SBI85ZNF1641412,20,25,18,7,1
SBI04FKJ1603756,84,21,11,10,1
SBI63VSD2750061,98,26,18,8,1
SBI33UGY1759139,76,27,22,5,1
SBI89RYW9026059,60,27,17,10,1
SBI96CES2493836,93,31,16,15,1
SBI82XNY6121858,91,25,24,1,1
SBI93PKR1838925,83,21,19,2,1
SBI99OYH0186935,66,23,18,5,1
SBI49XAE8172573,69,21,11,10,1
SBI00JGE0738840,90,24,23,1,1
SBI46RTI0909538,69,25,18,7,1
SBI96ODK7377213,81,32,19,13,1
SBI09JMQ6341232,94,25,19,6,1
SBI58SHN0950009,95,20,11,9,1
SBI84SIW9205688,73,26,20,6,1
SBI82BSH3529087,86,16,10,6,1
SBI46UBY6370486,68,21,20,1,1
SBI18MVW6998407,99,23,17,6,1
SBI16RJO8081345,84,22,17,5,1
SBI11FBX5258661,63,21,14,7,1
SBI29WDJ6156769,91,32,26,6,1
SBI67DAM7068528,88,25,20,5,1
SBI36LAC2255888,85,28,18,10,1
SBI59TEY4504706,93,22,17,5,1
SBI42TQQ2749002,20,30,24,6,1
SBI39UPH3849594,90,22,13,9,1
SBI98ICI0624011,21,25,20,5,1
SBI25MJY5509424,67,23,17,6,1
SBI60TTR4044470,80,18,10,8,1
SBI45YXY5303195,62,27,24,3,1
SBI85JGR0599361,62,27,25,2,1
SBI99IIS5577675,74,22,21,1,1
SBI92GHV4782176,24,20,17,3,1
SBI98JMM9082351,63,22,14,8,1
SBI12BSN8052746,70,21,11,10,1
SBI75YBN6517056,65,16,11,5,1
SBI08FBJ7363523,66,32,24,8,1
SBI97PKJ0995669,67,31,30,1,1
SBI86RUW8800571,22,17,15,2,1
SBI54UVG8412476,96,24,23,1,1
SBI87SYG6512090,69,15,13,2,1
SBI87AKO1379743,85,26,20,6,1
SBI85OHN5624362,84,30,25,5,1
SBI21AYX8081282,74,35,31,4,1
SBI14ANA7912345,18,19,14,5,1
SBI86LPG0236075,97,13,7,6,1
SBI85BZC2689122,63,22,15,7,1
SBI50HJM8447709,91,21,15,6,1
SBI07XWO5320571,97,27,23,4,1
SBI04ASV5013062,79,24,23,1,1
SBI20RCF9508204,84,28,20,8,1
SBI63MTI2990015,91,22,18,4,1
SBI27XTB7164517,88,20,15,5,1
SBI50GZO5390777,71,18,16,2,1
SBI44JQZ7931106,86,26,18,8,1
SBI46LDR8211064,95,26,17,9,1
SBI09SIP9805609,70,18,16,2,1
SBI87IQW1692356,97,24,19,5,1
SBI25IWP4975844,74,33,20,13,1
SBI48SGJ8984070,85,24,14,10,1
SBI99MIW6396249,23,32,24,8,1
SBI03CMA7609709,84,13,7,6,1
SBI51IFR1317846,70,27,15,12,1
SBI68MAW3206549,95,20,19,1,1
SBI57GXI7753187,71,23,20,3,1
SBI53INI7532192,20,27,26,1,1
SBI67KMO7076047,85,29,25,4,1
SBI90QLP5781454,70,28,20,8,1
SBI99PJF7973418,65,24,17,7,1
SBI45IGI4603500,89,25,20,5,1
SBI64ICV8825986,95,23,21,2,1
SBI75ZZG7548107,25,23,12,11,1
SBI04GKP0475644,64,20,19,1,1
SBI26SVM8990278,95,17,14,3,1
SBI91CCY1717914,92,25,15,10,1
SBI19OCZ8549487,96,20,13,7,1
SBI02COO6493568,65,25,14,11,1
SBI11TYY3528701,61,14,12,2,1
SBI46GWC8258463,76,19,15,4,1
SBI11JQR1248798,19,33,21,12,1
SBI85ORN5740146,82,22,12,10,1
SBI39PEQ8594778,89,26,23,3,1
SBI51ECU5027756,72,22,21,1,1
SBI92AFM3949409,83,28,25,3,1
SBI16TRK6685215,60,24,14,10,1
SBI71VIK3754082,82,18,17,1,1
SBI14ZFT4175922,61,22,17,5,1
SBI70RNL5418163,72,20,13,7,1
SBI69RZS2327183,25,22,16,6,1
SBI92QTI1380360,21,28,15,13,1
SBI67ZJZ2054679,73,26,15,11,1
SBI49PRD1112087,76,24,14,10,1
SBI23XLX9250282,83,27,17,10,1
SBI88SXN6273734,90,27,20,7,1
SBI39CEO5718728,18,25,14,11,1
SBI59PVH8494083,96,27,18,9,1
SBI69HZH1073815,93,14,8,6,1
SBI64WGW8741077,74,24,13,11,1
SBI79LHH8561740,70,25,21,4,1
SBI51RQW4642999,98,17,13,4,1
SBI83QTJ2721659,92,17,14,3,1
SBI33JGI2820823,81,20,13,7,1
SBI68SDW6176940,86,22,21,1,1
SBI04PHN1866714,68,32,28,4,1
SBI48MEK5557180,93,12,8,4,1
SBI97VWR9949526,97,25,14,11,1
SBI95FPG3558127,98,25,17,8,1
SBI39QCQ5935537,69,27,16,11,1
SBI58OLJ6151192,76,20,13,7,1
SBI34TSY9268062,18,18,17,1,1
SBI92IKV0521191,68,22,18,4,1
SBI97ZMD1863333,24,20,11,9,1
SBI85RMJ9726229,95,23,14,9,1
SBI02ZHZ8228176,74,32,31,1,1
SBI61BDN0232333,23,24,23,1,1
SBI42ALZ8815410,73,24,20,4,1
SBI97FRI4897255,68,26,22,4,1
SBI14RIH8573167,91,18,13,5,1
SBI05EVN4663816,94,32,28,4,1
SBI19GEJ5253874,65,33,30,3,1
SBI25JGY4985880,21,23,21,2,1
SBI20HMO3728004,87,33,22,11,1
SBI01PFI3261550,18,23,17,6,1
SBI16BLU5372968,86,27,14,13,1
SBI23IGU3193049,74,24,13,11,1
SBI17IPR7425445,22,28,26,2,1
SBI81MWO3998453,61,24,18,6,1
SBI10MSW5329149,20,18,11,7,1
SBI81JMW2339795,21,27,21,6,1
SBI13NRX1854957,65,29,18,11,1
SBI73WIQ3020652,70,17,9,8,1
SBI71PQU1013255,89,27,24,3,1
SBI12KTN3174874,63,18,10,8,1
SBI88ZCT4064443,81,31,19,12,1
SBI46WIJ4022746,19,33,18,15,1
SBI95NZT9708922,97,17,16,1,1
SBI36AJX6791479,99,24,19,5,1
SBI42XKC3924235,69,19,16,3,1
SBI99MOZ6856383,97,29,28,1,1
SBI53FAQ3248566,73,28,19,9,1
SBI31NZR3068572,91,26,15,11,1
SBI77IIP5961402,63,31,25,6,1
SBI86LVD2895602,90,26,16,10,1
SBI86VBR8867927,97,19,12,7,1
SBI11JFJ8448085,21,28,26,2,1
SBI44TED4159151,84,27,26,1,1
SBI19RBX2199783,88,18,10,8,1
SBI24TSS8229189,79,17,14,3,1
SBI08ANT7587397,74,20,17,3,1
SBI70CLN3569933,69,22,16,6,1
SBI04NGG2195281,93,20,15,5,1
SBI50AOR0279823,79,13,11,2,1
SBI84BYR7195887,90,23,14,9,1
SBI61PLZ4878728,91,23,14,9,1
SBI92SWM5104530,93,30,29,1,1
SBI51JIH1282723,90,22,12,10,1
SBI81DTK2588402,99,32,17,15,1
SBI25RUK2318416,75,27,19,8,1
SBI45TGQ1994317,62,29,27,2,1
SBI91HQH0569936,96,19,17,2,1
SBI42WVC7833671,24,22,15,7,1
SBI32BIH4542053,87,21,15,6,1
SBI65ZGA8707722,62,26,15,11,1
SBI93MXP5120709,66,27,18,9,1
SBI10XRO9945223,96,20,13,7,1
SBI74YGP6331198,22,22,15,7,1
SBI11TXO7092098,63,20,11,9,1
SBI27MSO2439306,82,32,21,11,1
SBI27ZRX6064516,90,22,15,7,1
SBI43NDN3144766,72,21,18,3,1
SBI67FON8525818,87,18,17,1,1
SBI43ENT5107273,97,23,22,1,1
SBI84VAQ2298680,85,25,14,11,1
SBI08YNC2677732,87,25,21,4,1
SBI08BKM2133050,63,25,22,3,1
SBI30QCC5269305,85,20,12,8,1
SBI42MOC8905820,67,21,19,2,1
SBI28XRC9911837,86,20,11,9,1
SBI57OIN8813986,87,19,17,2,1
SBI12GBV3664714,21,26,16,10,1
SBI38GKM6617553,21,23,18,5,1
SBI16EOY0104068,79,22,19,3,1
SBI88PXW0609541,92,30,26,4,1
SBI30NTL4921136,68,15,11,4,1
SBI56GEB3730554,62,27,23,4,1
SBI35ULU2342688,62,21,14,7,1
SBI49LTF1842044,67,18,16,2,1
SBI37KLV4311433,81,31,19,12,1
SBI28VIB0251551,90,27,19,8,1
SBI71DRU1454724,60,23,18,5,1
SBI08VBR1737602,71,21,17,4,1
SBI74IWO7680971,90,30,28,2,1
SBI43AJZ9954759,63,24,20,4,1
SBI68IZT8895226,84,21,18,3,1
SBI89ZTJ6522506,78,16,15,1,1
SBI87GYX6730863,74,30,27,3,1
SBI87MIM8054073,60,30,19,11,1
SBI42GJB9451831,84,23,13,10,1
SBI89VFW9300443,18,22,14,8,1
SBI69KCN5619580,76,20,18,2,1
SBI41AJZ9984521,89,23,17,6,1
SBI65ECD2234486,70,19,13,6,1
SBI52ZJH3088090,93,24,17,7,1
SBI35FYG6505239,19,20,12,8,1
SBI92SSF1010451,97,26,19,7,1
SBI22CYF7759077,81,29,27,2,1
SBI84ENZ5213699,77,22,21,1,1
SBI75RAT7092725,96,26,23,3,1
SBI56MVF0198728,20,28,21,7,1
SBI23PHL1110876,68,32,20,12,1
SBI39UXT9682927,70,27,15,12,1
SBI67HHI5464689,72,29,27,2,1
SBI70EHU8365525,65,26,24,2,1
SBI69EQN5489337,86,26,25,1,1
SBI60JHN5915448,75,23,22,1,1
SBI63SMF0977607,84,28,26,2,1
SBI56AYY0883940,74,27,16,11,1
SBI16RNU1617810,63,30,21,9,1
SBI28KGX4924213,79,32,19,13,1
SBI39VRZ0710616,62,26,22,4,1
SBI03ROL5511239,61,24,14,10,1
SBI52MHV4799646,92,24,22,2,1
SBI10YIG2025317,61,17,14,3,1
SBI69DMH8512520,78,22,14,8,1
SBI68VGM9769772,77,15,14,1,1
SBI03OOI5827190,93,24,23,1,1
SBI56RVK1473302,71,25,21,4,1
SBI48BRN5489538,20,24,19,5,1
SBI37SSH6897234,80,30,28,2,1
SBI40VRT7996503,85,24,18,6,1
SBI94EPS0505893,94,23,20,3,1
SBI69HQH5355954,73,23,18,5,1
SBI80NLC4700286,72,20,12,8,1
SBI65FHT9798987,67,32,18,14,1
SBI04XUI3193277,24,26,14,12,1
SBI61WKC5820584,60,16,15,1,1
SBI73EUW8774871,87,24,16,8,1
SBI10KOL3467614,25,17,11,6,1
SBI26LNK9163144,89,21,20,1,1
SBI83JQF5900675,87,22,16,6,1
SBI38XHX4678336,23,25,22,3,1
SBI48PHF3831769,23,26,21,5,1
SBI58XFF4140878,84,25,15,10,1
SBI88HHK7682147,76,12,11,1,1
SBI59PSF8726943,67,17,13,4,1
SBI58QEB0886368,91,19,18,1,1
SBI04WWS8914214,71,25,17,8,1
SBI71QDP9503002,97,28,24,4,1
SBI19QMC0421370,61,23,20,3,1
SBI16JOD1848989,90,21,15,6,1
SBI50ACF5847670,85,26,16,10,1
SBI49EVJ9430539,99,28,20,8,1
SBI03QOB7869562,18,20,16,4,1
SBI91VDG5488029,60,24,21,3,1
SBI27FVD2592302,81,21,20,1,1
SBI31XTS3787671,64,28,21,7,1
SBI41GBK8246368,76,23,21,2,1
SBI18EWE8567898,61,23,22,1,1
SBI65YHD1877431,94,20,17,3,1
SBI06AXK1882159,68,31,25,6,1
SBI18KGD1938737,25,21,13,8,1
SBI72OMJ4207001,65,26,23,3,1
SBI47QFX1165801,72,24,13,11,1
SBI50IKJ0519140,89,31,17,14,1
SBI29JLH8541740,77,33,32,1,1
SBI03CKA5101905,63,30,21,9,1
SBI66BEF3986795,92,15,10,5,1
SBI61NGM2937505,77,26,19,7,1
SBI72WIT0595843,98,19,11,8,1
SBI17OMK3409178,92,22,12,10,1
SBI48HYD4084421,65,18,10,8,1
SBI93ABU8385010,64,28,16,12,1
SBI25WDI1049530,74,18,12,6,1
SBI31MKP0263010,65,29,23,6,1
SBI78NAR0845454,23,18,10,8,1
SBI26ZAZ3972374,87,22,16,6,1
SBI24NJO5723968,25,25,24,1,1
SBI39DOV8192427,23,15,12,3,1
SBI04IED2905426,92,27,25,2,1
SBI52ZCN5125920,84,19,15,4,1
SBI57VBL8717915,62,18,15,3,1
SBI83SQT5882521,98,17,13,4,1
SBI15CWF6947647,79,23,21,2,1
SBI18GOS2774108,19,27,26,1,1
SBI97DKP0043892,92,27,23,4,1
SBI02IJU8563663,21,23,13,10,1
SBI21CJG5637172,76,26,24,2,1
SBI26CON3468509,99,28,23,5,1
SBI22QGN6769007,93,28,25,3,1
SBI05ZIJ8110066,96,22,12,10,1
SBI00VIL4644726,86,27,26,1,1
SBI16BGW0537431,69,17,16,1,1
SBI05CSK4817712,19,21,14,7,1
SBI33USU3247191,85,20,16,4,1
SBI14UUC7305595,90,24,22,2,1
SBI45VMI0315917,98,33,28,5,1
SBI32TRU3755267,95,18,17,1,1
SBI65ANK9870605,60,28,17,11,1
SBI87USH8647078,84,22,13,9,1
SBI15RXY0640229,20,27,17,10,1
SBI85HJO1590832,90,25,16,9,1
SBI35VLU6101309,69,29,16,13,1
SBI05NJJ3150498,88,26,22,4,1
SBI07KIS4540916,77,23,15,8,1
SBI49SWB8072172,91,28,19,9,1
SBI45GZC6744713,96,25,16,9,1
SBI05IRN7615972,68,17,16,1,1
SBI34SDT1384752,84,21,11,10,1
SBI18QVK0260254,88,23,19,4,1
SBI19HRZ1689360,91,18,17,1,1
SBI38ALT6606754,62,12,10,2,1
SBI48WDP7201765,20,26,21,5,1
SBI91YZO0457504,71,27,17,10,1
SBI27FSU1830150,75,26,17,9,1
SBI56FHH6912197,87,24,13,11,1
SBI51FOS8875192,90,30,27,3,1
SBI30UPM9701226,18,18,11,7,1
SBI29XHM9182559,60,29,15,14,1
SBI37QJT9146546,22,23,16,7,1
SBI43LUN6223070,79,20,14,6,1
SBI68WWE0597213,75,26,14,12,1
SBI40XNV1175924,22,30,17,13,1
SBI70WHO5531900,90,27,19,8,1
SBI43NOC6409860,84,28,15,13,1
SBI78PPB7962276,96,26,15,11,1
SBI76IWG6167766,81,25,15,10,1
SBI57MUM8303746,20,30,29,1,1
SBI19TFP5670766,87,31,25,6,1
SBI32TNS9514901,74,20,14,6,1
SBI25WYZ9388821,64,16,14,2,1
SBI79SIM5130295,75,27,25,2,1
SBI86OLO9414623,23,22,15,7,1
SBI36SMG9259515,82,22,16,6,1
SBI93OEV7416034,87,26,18,8,1
SBI28UCG8677776,69,22,16,6,1
SBI56YSE3800615,83,24,14,10,1
SBI30NZE1679960,18,16,12,4,1
SBI38QWH0896953,85,19,14,5,1
SBI34RNU9040861,98,17,13,4,1
SBI88MEO6696188,67,23,12,11,1
SBI82GFM1034210,22,30,22,8,1
SBI74IDQ9005334,18,16,9,7,1
SBI96DAK5697919,22,25,23,2,1
SBI42CJF8152989,24,28,16,12,1
SBI79VBI0804554,64,28,17,11,1
SBI28RQR9111214,24,24,19,5,1
SBI48LOJ0188999,76,25,14,11,1
SBI06POA5235365,18,31,28,3,1
SBI14QAQ9253920,83,22,12,10,1
SBI04VBP9260659,22,22,16,6,1
SBI04OHR9813394,76,30,17,13,1
SBI08YDG9209298,98,33,20,13,1
SBI52OGP3443425,80,29,28,1,1
SBI24AMF4427007,62,25,14,11,1
SBI17HEF7736423,97,22,16,6,1
SBI65RVE9897080,63,30,23,7,1
SBI27TLT0503384,60,28,26,2,1
SBI93HVE4198583,22,22,14,8,1
SBI48CKY1029513,18,25,16,9,1
SBI58BAO7223149,75,26,18,8,1
SBI25WLK9295684,92,23,17,6,1
SBI93SIZ9788436,88,18,12,6,1
SBI36IQC0800984,99,28,23,5,1
SBI91ZZK6657621,62,21,18,3,1
SBI20KAH7361879,84,26,19,7,1
SBI75YBG4941111,84,16,9,7,1
SBI80EML2891948,98,21,20,1,1
SBI78YYC9570129,82,29,26,3,1
SBI14BSO9121763,91,22,17,5,1
SBI37ZID8510803,98,27,14,13,1
SBI96YMH1487755,20,25,20,5,1
SBI29GXO5667300,73,27,20,7,1
SBI90QVD5763332,98,24,14,10,1
SBI65SQW1747552,81,24,19,5,1
SBI53PRY0994529,64,34,19,15,1
SBI46UZN4149526,67,23,15,8,1
SBI08UPA7733445,60,19,11,8,1
SBI33QFD4737207,81,26,18,8,1
SBI48ZVY8059600,76,25,18,7,1
SBI87TKX4539674,85,15,8,7,1
SBI53WEN5376448,77,25,21,4,1
SBI54ESH7134447,93,32,24,8,1
SBI94YSR3633909,78,26,21,5,1
SBI86ESO2269993,68,26,15,11,1
SBI47TIO4872763,64,31,30,1,1
SBI88KRB9391589,81,20,13,7,1
SBI23OKZ0271382,75,23,16,7,1
SBI97AHU9523808,98,24,21,3,1
SBI04HVR0425647,81,26,17,9,1
SBI65KNU0286434,77,23,12,11,1
SBI80FKD8473615,20,21,18,3,1
SBI82HCW9769097,23,17,11,6,1
SBI49HJH1739536,73,28,20,8,1
SBI28KCE5460124,72,24,16,8,1
SBI06QGS0869072,84,30,27,3,1
SBI74VKK3113696,63,23,13,10,1
SBI50FLF5348786,83,23,22,1,1
SBI65ISJ8896418,65,24,22,2,1
SBI69VKX3936600,86,26,15,11,1
SBI47XKY6225328,88,23,12,11,1
SBI39XDA1194602,18,29,17,12,1
SBI60DIP9726459,19,28,23,5,1
SBI53YPS7385150,67,25,19,6,1
SBI13YYX7788497,88,27,25,2,1
SBI82CYN8171929,71,18,16,2,1
SBI73BKQ5130624,74,27,18,9,1
SBI67TVW6825854,62,16,12,4,1
SBI83LRF2542764,88,16,9,7,1
SBI92LYR6868651,73,23,12,11,1
SBI04REV3008214,74,22,15,7,1
SBI05VKE4291309,86,26,18,8,1
SBI73FAU1959432,83,21,20,1,1
SBI20YJW9687408,22,26,16,10,1
SBI59IWF4063897,76,26,24,2,1
SBI63GBB5451042,23,22,21,1,1
SBI29FFT7327694,82,20,12,8,1
SBI76HZY4373662,74,23,13,10,1
SBI09YDQ6408653,21,25,18,7,1
SBI60BWE1451920,92,24,19,5,1
SBI82MGW8873832,72,33,22,11,1
SBI53VMY2385674,60,26,17,9,1
SBI84YSG2378403,63,27,20,7,1
SBI27UQB9526607,95,29,24,5,1
SBI66FUL5158130,60,39,36,3,1
SBI75ODV1689791,75,30,29,1,1
SBI01CET1842811,64,28,17,11,1
SBI63QBV6682937,86,23,22,1,1
SBI74ZDC7427331,80,29,22,7,1
SBI52SAF2065549,90,32,23,9,1
SBI47ICJ8806472,83,16,15,1,1
SBI05PMV7093337,98,24,17,7,1
SBI86PCD6534352,71,20,15,5,1
SBI35DXW2638037,91,21,13,8,1
SBI44NFM1097476,71,23,15,8,1
SBI16UVY1039708,21,21,14,7,1
SBI51YCJ7075143,85,31,28,3,1
SBI74CPF9362252,20,21,13,8,1
SBI05AJU9713962,95,28,19,9,1
SBI04MUA7978453,78,27,22,5,1
SBI44WKT5278522,66,28,19,9,1
SBI21LUR0263082,64,20,17,3,1
SBI76BPE7226111,22,24,14,10,1
SBI36PGN8396104,82,28,16,12,1
SBI80JAX8718842,62,25,19,6,1
SBI95FYM3038422,84,34,28,6,1
SBI95DYA3605434,78,23,21,2,1
SBI69KPA0107181,98,26,23,3,1
SBI44BDQ3807559,80,27,25,2,1
SBI91YYU1882348,23,23,20,3,1
SBI65PBT3392385,88,21,12,9,1
SBI66ORN3957314,24,22,15,7,1
SBI07JVL2733256,86,18,13,5,1
SBI63PGK9996722,22,22,12,10,1
SBI45VXF7847499,93,18,17,1,1
SBI71MWS1041918,69,18,15,3,1
SBI72GLA0504994,86,22,15,7,1
SBI93QWJ9724268,24,22,18,4,1
SBI79DLX5960888,62,23,16,7,1
SBI04QVB0201383,20,21,12,9,1
SBI27QHM5431042,85,20,17,3,1
SBI72XGB0597800,84,22,19,3,1
SBI83NEC1257733,86,23,14,9,1
SBI32EBK7467782,93,26,17,9,1
SBI10BMQ6894356,63,35,33,2,1
SBI89PTV3816934,80,26,25,1,1
SBI34RRA8136873,64,23,22,1,1
SBI74YWY9653184,95,22,15,7,1
SBI14KMQ8069800,80,22,14,8,1
SBI98KNH5914290,82,32,17,15,1
SBI16YIW0380925,76,28,24,4,1
SBI71CFJ7950543,18,11,8,3,1
SBI34NIZ4861519,69,22,18,4,1
SBI40VIA0798105,85,21,19,2,1
SBI77MZF2648119,93,32,17,15,1
SBI06HQD9474523,24,22,20,2,1
SBI80VJY7070386,91,31,24,7,1
SBI04UCS6413055,64,31,25,6,1
SBI77FPT9116929,70,33,26,7,1
SBI34XZQ3424832,98,23,20,3,1
SBI52LMZ7170003,64,17,10,7,1
SBI35MXM5469281,67,20,19,1,1
SBI53ANI3812586,86,28,17,11,1
SBI35YFS9049700,63,28,18,10,1
SBI73UYS8507772,78,21,13,8,1
SBI51KTV9414232,64,17,9,8,1
SBI85KSM2675639,71,15,14,1,1
SBI58VUN6864655,78,25,23,2,1
SBI92JCT1010638,90,25,19,6,1
SBI19WEA9414325,24,33,27,6,1
SBI91CFB5777059,61,19,18,1,1
SBI89MZN8845904,66,22,14,8,1
SBI77XTT6356418,97,27,23,4,1
SBI51EMT0737083,23,23,13,10,1
SBI68IVL5483403,84,28,25,3,1
SBI94QYT6229215,63,33,29,4,1
SBI17XUD0923844,61,23,16,7,1
SBI65UUG9958516,93,23,22,1,1
SBI90NUO8594988,92,26,15,11,1
SBI04QKZ2187429,91,34,23,11,1
SBI38IJT9042806,20,27,20,7,1
SBI61JYD0388466,20,30,24,6,1
SBI47MGQ4233743,67,27,18,9,1
SBI80PUA3543421,79,20,14,6,1
SBI60VIN8315741,22,24,13,11,1
SBI26SON9955279,20,21,17,4,1
SBI73VQN0757020,96,22,16,6,1
SBI91ZSI5668157,68,20,11,9,1
SBI84ORQ3998491,95,17,11,6,1
SBI82KDS7055651,82,20,14,6,1
SBI60CKV7921649,76,28,18,10,1
SBI82DJH7100472,60,23,17,6,1
SBI91FSB9185971,88,31,21,10,1
SBI61SEP1263245,93,28,27,1,1
SBI73ZNH5972350,94,25,20,5,1
SBI38KWM0027677,20,20,18,2,1
SBI25QUQ9204754,65,24,13,11,1
SBI56HOF3500987,99,28,22,6,1
SBI78AWT6721663,20,24,18,6,1
SBI72MKZ4318934,75,22,18,4,1
SBI67BAG4811377,84,32,27,5,1
SBI04DJO8356614,65,29,24,5,1
SBI57TUH8822268,60,27,23,4,1
SBI22KQZ2619561,76,23,12,11,1
SBI86ZNZ7717746,77,29,25,4,1
SBI43GOV2220520,88,19,15,4,1
SBI44ZVT3346169,23,20,17,3,1
SBI18COA5219635,72,18,10,8,1
SBI34YRX6469042,91,17,14,3,1
SBI89IKS9316859,68,22,13,9,1
SBI80LAH9529385,94,28,26,2,1
SBI66CBB0308211,77,21,16,5,1
SBI16ARA9792454,97,29,25,4,1
SBI60LMF4802961,74,29,21,8,1
SBI41KJN1287337,60,16,9,7,1
SBI30JYJ9074518,68,29,23,6,1
SBI47EYP1655762,60,27,25,2,1
SBI58AXU5097606,82,27,23,4,1
SBI82HYQ8956918,70,29,21,8,1
SBI31GLY3181758,84,23,15,8,1
SBI98SYN5818908,81,24,22,2,1
SBI18ZME4137308,77,21,18,3,1
SBI01DID0482502,93,24,15,9,1
SBI73MCG8300677,81,26,18,8,1
SBI06LHE9589336,73,28,27,1,1
SBI47JAC1566940,86,30,26,4,1
SBI95VBB9986102,70,19,10,9,1
SBI10YXT8761727,98,23,18,5,1
SBI52BGI9800980,21,13,8,5,1
SBI73BEX7406209,60,21,14,7,1
SBI40AUU9394233,24,26,14,12,1
SBI58QRW8437344,91,22,14,8,1
SBI57MPK5926623,97,21,17,4,1
SBI43QPZ8873339,96,23,13,10,1
SBI68AUB8832940,72,22,17,5,1
SBI86KXX4516749,83,17,10,7,1
SBI31VWW0135036,79,32,20,12,1
SBI25BAO9986802,24,26,17,9,1
SBI77IWM7714276,82,28,23,5,1
SBI95BEN0084504,88,21,12,9,1
SBI05JQK8430407,82,20,18,2,1
SBI42FUU1873114,74,21,12,9,1
SBI59IPX8290550,82,25,21,4,1
SBI65HVW7715425,93,18,13,5,1
SBI64ZZB9605714,87,26,17,9,1
SBI76AEU5650195,76,23,22,1,1
SBI44VOP2120229,73,25,20,5,1
SBI06PRT1091627,24,35,20,15,1
SBI57TUZ3270895,65,24,23,1,1
SBI03NZF0576754,18,30,19,11,1
SBI84BHL6624641,91,29,24,5,1
SBI10PSP1697122,83,29,22,7,1
SBI18HWQ7982240,25,18,15,3,1
SBI95RIT8968953,61,20,13,7,1
SBI56XLX7407831,73,15,10,5,1
SBI52XGJ0151527,98,29,27,2,1
SBI88REJ9854662,90,19,16,3,1
SBI74REM1919390,84,21,13,8,1
SBI00KLS9623458,60,14,13,1,1
SBI51PYM1050000,63,22,13,9,1
SBI81ASH6175632,21,16,14,2,1
SBI61MUN9747461,91,25,13,12,1
SBI91BDB1568693,20,21,15,6,1
SBI25TGT6536420,80,20,18,2,1
SBI73KPF4730741,74,23,13,10,1
SBI51GVO3297608,63,36,19,17,1
SBI78GXE3127169,82,27,19,8,1
SBI71AOO1363604,74,15,11,4,1
SBI98ZUQ2059510,75,23,13,10,1
SBI29CMS9596073,66,18,10,8,1
SBI78XPS2035195,95,21,13,8,1
SBI14KYH5805994,64,24,23,1,1
SBI79SMK3070122,92,25,19,6,1
SBI16DGU6903229,24,21,16,5,1
SBI85IZJ5698329,21,14,9,5,1
SBI71MVH0654277,99,26,15,11,1
SBI82TWR1433738,21,23,12,11,1
SBI80DZR7763861,82,20,14,6,1
SBI18RUX9251007,80,17,15,2,1
SBI81RQE8302963,20,22,19,3,1
SBI00HUY0893249,72,19,17,2,1
SBI24VZN9124849,64,20,17,3,1
SBI57QVA2542168,90,27,23,4,1
SBI45RFW3399375,94,23,14,9,1
SBI26OLK5930773,86,20,16,4,1
SBI57AES6173052,74,22,16,6,1
SBI35RZQ5077338,18,30,26,4,1
SBI68JTG3678488,92,30,17,13,1
SBI07IVJ6457007,24,26,16,10,1
SBI29TNM8405047,24,31,26,5,1
SBI42NKF3389484,80,18,12,6,1
SBI98KXI1403624,69,25,15,10,1
SBI07ZZU7675584,19,26,18,8,1
SBI09LKN4538991,85,26,18,8,1
SBI76ZYT7904573,18,29,27,2,1
SBI51AMC1667357,18,23,17,6,1
SBI47SIO9232427,21,29,22,7,1
SBI99FLI0658099,21,35,19,16,1
SBI88XKG5869814,18,22,18,4,1
SBI58BED7482820,81,19,17,2,1
SBI50ZBF4138281,64,23,20,3,1
SBI96MYQ7787761,90,24,16,8,1
SBI83SHZ4911071,94,24,21,3,1
SBI39LKO6319339,77,16,15,1,1
SBI68PLR6556454,63,26,15,11,1
SBI98RUZ5811187,71,21,13,8,1
SBI77OWH0364373,73,20,11,9,1
SBI55GXR2154673,22,15,10,5,1
SBI44KDF2198180,91,26,15,11,1
SBI45MVT0218180,68,16,14,2,1
SBI02HAI1126880,25,28,23,5,1
SBI06NVF1223705,25,26,18,8,1
SBI99JTL0677787,77,30,23,7,1
SBI16LLW8344575,75,19,10,9,1
SBI30ZXM2256658,97,31,23,8,1
SBI82XHK5235793,98,29,15,14,1
SBI69AUL1024400,71,21,20,1,1
SBI42JWI5724549,85,30,17,13,1
SBI28BFS7742912,67,25,14,11,1
SBI25QZB7074500,66,18,14,4,1
SBI95GHK6403839,80,32,24,8,1
SBI69XLD3925758,83,26,15,11,1
SBI06YPF2162332,20,31,26,5,1
SBI05QVL9634966,75,19,15,4,1
SBI73UXZ8346933,97,20,12,8,1
SBI16GJO8826314,77,28,24,4,1
SBI55ASR0069913,90,30,22,8,1
SBI23CQL9937254,69,28,26,2,1
SBI00EUY1168168,21,26,19,7,1
SBI21DZK1048318,95,26,16,10,1
SBI37TAU7645048,81,28,24,4,1
SBI79KYM8132301,76,21,11,10,1
SBI90JJJ4696381,89,32,28,4,1
SBI69JWD8347346,94,22,17,5,1
SBI71LXR0887361,62,39,21,18,1
SBI15WJF5649306,18,30,28,2,1
SBI09CWX0457957,91,22,15,7,1
SBI33YFL0683544,60,23,12,11,1
SBI78HZB4936294,94,24,22,2,1
SBI20GFF8926242,89,28,25,3,1
SBI45RWH8183311,69,23,16,7,1
SBI27FYG8016488,75,20,12,8,1
SBI97UHE6285852,83,28,27,1,1
SBI73SLL1844108,87,29,24,5,1
SBI20LBK8753401,89,32,30,2,1
SBI61MOO5160257,98,24,14,10,1
SBI21EWX5271527,99,25,24,1,1
SBI08KGO1513258,68,24,18,6,1
SBI65FIA5434146,97,28,26,2,1
SBI02HAZ3366011,21,21,20,1,1
SBI85HNE5974942,71,24,21,3,1
SBI62VME3107143,69,26,17,9,1
SBI83JWU0577154,18,26,18,8,1
SBI33ARC9013423,60,30,22,8,1
SBI34LXH1490199,92,31,18,13,1
SBI03ZQF8889439,66,28,24,4,1
SBI39SLJ5020341,84,24,21,3,1
SBI79VWJ9236153,92,22,13,9,1
SBI34ZEO8058553,87,26,20,6,1
SBI77WYB3783234,79,24,18,6,1
SBI84KSZ2465585,24,30,29,1,1
SBI85EGZ2120583,25,26,21,5,1
SBI73JCB7387243,60,28,21,7,1
SBI63LAE1610018,81,25,16,9,1
SBI69AMM0548840,18,23,13,10,1
SBI90ZPS2188699,70,21,19,2,1
SBI57QDN3755064,85,23,13,10,1
SBI38NNO6505202,97,40,35,5,1
SBI37LCA8809077,73,23,13,10,1
SBI91AVD7947190,67,24,13,11,1
SBI66XGU1318829,93,26,21,5,1
SBI33JDL5376876,88,23,19,4,1
SBI64XLY9569405,90,21,16,5,1
SBI15FKT4742298,89,23,14,9,1
SBI97VDV1123308,83,26,24,2,1
SBI75WWV6087408,97,28,21,7,1
SBI22GJJ3251850,95,31,26,5,1
SBI78OBL7369787,94,28,27,1,1
SBI52VUS9042326,93,22,20,2,1
SBI35GTO4959479,22,24,23,1,1
SBI95DTJ6787101,64,20,16,4,1
SBI12LBR8162728,76,22,13,9,1
SBI38IZL0641705,97,18,13,5,1
SBI62CHR5449533,83,28,16,12,1
SBI72HYK3911261,88,24,23,1,1
SBI37QBF1856359,60,26,14,12,1
SBI10QOG0396731,83,31,26,5,1
SBI98UDH4129440,78,25,15,10,1
SBI10ORE1745332,25,21,16,5,1
SBI14OCK0632499,69,23,20,3,1
SBI71QCH4137520,86,23,21,2,1
SBI77ICD2807332,72,24,15,9,1
SBI61GSN4638389,63,31,28,3,1
SBI71RIK5111498,74,13,8,5,1
SBI59KJA9616206,97,23,19,4,1
SBI68VUS2422003,64,21,13,8,1
SBI80BZH8962996,86,21,19,2,1
SBI13DVX1004883,72,29,24,5,1
SBI86BER9966737,69,20,13,7,1
SBI69DBU9923797,94,34,32,2,1
SBI25PFH4043823,69,19,18,1,1
SBI99HBW0151900,89,20,13,7,1
SBI50QLU4588155,69,20,11,9,1
SBI05XPM6802743,82,31,22,9,1
SBI79NDL8788723,69,25,22,3,1
SBI52KMO7760041,82,26,15,11,1
SBI36XTO2788918,73,26,24,2,1
SBI96CVV8184463,82,21,15,6,1
SBI79XFA1884336,68,21,18,3,1
SBI04GYW0602729,86,20,19,1,1
SBI35BHD8114758,78,23,14,9,1
SBI77KDU9913144,75,19,11,8,1
SBI12TCO7027862,73,19,12,7,1
SBI14DNR7164003,21,26,20,6,1
SBI37IDQ3530622,82,18,11,7,1
SBI23VZJ8652315,68,30,24,6,1
SBI30SPX0334463,96,18,12,6,1
SBI96MFH1036653,76,23,20,3,1
SBI29KJM0764934,68,17,10,7,1
SBI65KAD1401118,98,21,17,4,1
SBI25TSQ9724014,90,21,19,2,1
SBI62TLY3236158,85,20,17,3,1
SBI07ETD8815769,66,21,11,10,1
SBI16PQT6336390,61,23,20,3,1
SBI62ZGG9963621,20,30,21,9,1
SBI26STU0885391,18,17,9,8,1
SBI53MKD7047947,87,31,17,14,1
SBI69VIL5437005,74,18,12,6,1
SBI19RFJ9499533,91,17,16,1,1
SBI16IXM5661980,79,21,19,2,1
SBI92EIS1308543,79,25,18,7,1
SBI54VJG9710448,19,28,15,13,1
SBI35PQH5421324,95,30,21,9,1
SBI56IZW2639278,89,20,11,9,1
SBI79EED6344001,94,21,15,6,1
SBI73VLY3204928,70,18,12,6,1
SBI11GBA1338167,18,21,12,9,1
SBI55RXP1809007,74,23,16,7,1
SBI18GYJ8101090,64,34,19,15,1
SBI28BYB9480293,89,29,22,7,1
SBI53WPL6539699,60,20,18,2,1
SBI29WJP9796063,94,31,30,1,1
SBI41KOL2676187,65,26,16,10,1
SBI37WTB0492723,92,14,11,3,1
SBI76TKR1310913,70,18,10,8,1
SBI77YPX4851913,86,27,21,6,1
SBI31GXU6635478,72,33,27,6,1
SBI37ZDC9060631,22,23,12,11,1
SBI18TMZ9644772,98,28,21,7,1
SBI85QIS5348083,92,13,11,2,1
SBI68GSL7014295,98,32,28,4,1
SBI30LFI4555609,92,18,12,6,1
SBI15BBA6523232,91,25,14,11,1
SBI11WHW6004784,77,17,10,7,1
SBI66WWT4210809,64,23,12,11,1
SBI08LQF1605950,78,30,17,13,1
SBI18QSO0118696,88,24,14,10,1
SBI96DOT2422992,75,28,19,9,1
SBI53JGG4805104,24,30,20,10,1
SBI40FBU4113701,86,28,19,9,1
SBI20ZAY1937860,91,21,12,9,1
SBI88IGX9559614,21,21,17,4,1
SBI13YNC6856848,18,31,28,3,1
SBI24UKS0617513,85,18,14,4,1
SBI48VPH3310259,63,22,17,5,1
SBI34FEX2242195,70,25,22,3,1
SBI61WWF2244863,64,33,28,5,1
SBI90SPQ3040929,71,25,24,1,1
SBI11FVG6749923,92,26,19,7,1
SBI08HIH8872019,87,17,11,6,1
SBI02LAS5753287,79,24,16,8,1
SBI58TTX3227906,19,28,21,7,1
SBI62MNK8216533,83,30,29,1,1
SBI94ZCK7884072,65,22,20,2,1
SBI95NPJ5741546,97,27,18,9,1
SBI20OEZ2767024,99,30,18,12,1
SBI72FXZ6024436,70,22,12,10,1
SBI74UGP6944950,90,18,11,7,1
SBI99FYN1979433,67,18,16,2,1
SBI02TSY7592461,79,18,12,6,1
SBI87TTD2136163,73,24,13,11,1
SBI90TMK6013463,86,22,18,4,1
SBI38POU2804015,60,16,10,6,1
SBI95VFH1677891,86,27,14,13,1
SBI75UGS3626968,91,23,19,4,1
SBI70ENH5687270,73,25,22,3,1
SBI25MHL5910168,98,29,21,8,1
SBI14TBI8223791,89,30,24,6,1
SBI44SXS0054625,23,16,10,6,1
SBI83KKF7274977,90,28,24,4,1
SBI04VZZ9721765,81,30,26,4,1
SBI01TXR5496614,81,29,20,9,1
SBI48GOF0297585,63,22,13,9,1
SBI78YYT4958926,61,26,18,8,1
SBI56QLD1328946,81,23,17,6,1
SBI61WBU6866003,64,28,18,10,1
SBI08LAB9991674,76,20,16,4,1
SBI11EMJ8367534,79,20,11,9,1
SBI53FMT8260115,64,25,14,11,1
SBI32RED5964510,91,18,12,6,1
SBI25QFW7628214,80,17,14,3,1
SBI08CYJ0752380,94,25,19,6,1
SBI95PUH1448110,73,24,16,8,1
SBI93BAL1832350,80,18,10,8,1
SBI74CSY3947691,72,27,23,4,1
SBI96ORX2567834,89,14,10,4,1
SBI28CXO2143344,25,28,22,6,1
SBI49BOW0874192,62,32,25,7,1
SBI45BEG0764864,74,20,16,4,1
SBI54PMT4414300,68,20,19,1,1
SBI54KQA6014954,90,29,15,14,1
SBI73FIQ3910126,79,18,17,1,1
SBI15DWV1538418,24,20,11,9,1
SBI20DDX1614599,69,25,13,12,1
SBI75UYR7380372,91,18,17,1,1
SBI01LWA8624644,69,27,14,13,1
SBI07XCE5754021,69,21,13,8,1
SBI65VHZ7811212,19,20,12,8,1
SBI03ICE4881573,76,24,14,10,1
SBI06DZH7125508,80,27,23,4,1
SBI25UVA4332933,81,33,25,8,1
SBI65YOJ5815514,24,29,16,13,1
SBI29CRF2788123,85,14,12,2,1
SBI48YPF0415323,84,24,19,5,1
SBI21FWZ9527867,98,23,15,8,1
SBI75RYE1037291,62,18,17,1,1
SBI53WTL3019143,86,26,18,8,1
SBI26RFR0089807,72,22,19,3,1
SBI31JQP3872256,89,20,17,3,1
SBI44RPS6620237,93,28,24,4,1
SBI31JMR5916218,18,22,17,5,1
SBI39VYP8817336,81,31,22,9,1
SBI90PHM7721979,88,22,15,7,1
SBI72GPH5364297,86,20,19,1,1
SBI90DAE5384132,91,20,19,1,1
SBI57RNL8443189,70,26,20,6,1
SBI59INU9681924,21,19,10,9,1
SBI91ATV8835549,95,16,15,1,1
SBI39KIW1801726,95,31,22,9,1
SBI79CYJ5541025,21,21,20,1,1
SBI79AJV0603615,89,24,20,4,1
SBI85MDE7327930,95,19,11,8,1
SBI56UTG4721888,23,25,17,8,1
SBI26CFN5597050,93,33,27,6,1
SBI60GKO1703432,62,18,16,2,1
SBI39BAR1839847,74,26,15,11,1
SBI35ATC1432186,77,22,19,3,1
SBI31NGR4336343,22,32,22,10,1
SBI34XNQ5673118,95,25,21,4,1
SBI54HLW8101277,69,23,19,4,1
SBI20DLU7578732,71,32,28,4,1
SBI15FSA7350524,65,40,33,7,1
SBI93ZBT2149476,96,32,26,6,1
SBI25QRW5250406,73,33,32,1,1
SBI67ALJ0236169,92,23,18,5,1
SBI76DOF3223282,95,23,12,11,1
SBI52CHM2555333,97,23,13,10,1
SBI22NAM7317589,25,29,22,7,1
SBI42NSJ3534716,22,28,24,4,1
SBI63CTU5135502,73,26,17,9,1
SBI49LNV3969752,77,25,18,7,1
SBI24WNX9958152,69,29,23,6,1
SBI84OZX2755456,21,24,16,8,1
SBI16EMH2709292,95,28,20,8,1
SBI86FCD1336272,73,22,19,3,1
SBI38NMO4947669,22,26,25,1,1
SBI98AQT2300412,23,23,16,7,1
SBI16BAE9556320,21,25,14,11,1
SBI65HLM4183812,66,24,19,5,1
SBI20OTJ9514401,66,34,31,3,1
SBI59NNL3980519,75,17,10,7,1
SBI99JJA5709547,87,25,22,3,1
SBI07LKV0403079,97,31,28,3,1
SBI65FNL2895570,88,20,18,2,1
SBI09SCE7522173,91,20,14,6,1
SBI01YGI9235193,24,23,16,7,1
SBI56XNI1285604,67,24,22,2,1
SBI40CXQ9712218,66,17,13,4,1
SBI04FZL3745297,20,21,11,10,1
SBI64OAO5344393,18,21,15,6,1
SBI59PSZ9014834,65,21,16,5,1
SBI50ZDS0524260,75,25,24,1,1
SBI45TUZ8286877,93,23,17,6,1
SBI75QGX1733769,95,20,12,8,1
SBI98ZFO7762707,75,25,23,2,1
SBI41TNG6072558,84,18,11,7,1
SBI35FTP8437974,76,22,18,4,1
SBI84LOW8541019,72,27,25,2,1
SBI25BGT7925367,99,23,20,3,1
SBI74DUT9472482,84,26,22,4,1
SBI17AEL8134532,93,20,12,8,1
SBI05HCQ0947130,87,29,21,8,1
SBI72TLX3523920,69,24,17,7,1
SBI79EFM2006365,21,30,21,9,1
SBI33PVG0148293,87,28,16,12,1
SBI58LBS0966318,22,26,21,5,1
SBI38MJT3899956,91,20,14,6,1
SBI12ZFB5720701,62,29,16,13,1
SBI55EHC7117925,90,21,19,2,1
SBI22HRW6987080,66,26,15,11,1
SBI05QWC7868326,75,21,20,1,1
SBI57IRF4507947,81,21,18,3,1
SBI56MQU9626163,87,33,25,8,1
SBI42LFS0929136,66,31,17,14,1
SBI10VSK9952527,60,32,22,10,1
SBI19HPG3507112,92,32,21,11,1
SBI82UNX8641376,62,29,21,8,1
SBI40YHF1858360,97,33,22,11,1
SBI20YBC9673368,90,17,16,1,1
SBI66MRA1953528,18,26,17,9,1
SBI41CRP4254976,20,28,26,2,1
SBI47MIT3365735,75,26,19,7,1
SBI58DVT6726436,74,22,19,3,1
SBI45DAH3929100,87,18,12,6,1
SBI85VPA2961820,81,25,20,5,1
SBI12LES0384044,64,33,28,5,1
SBI05LYI7145919,25,28,23,5,1
SBI09EDJ1894474,95,21,16,5,1
SBI26FTJ2107394,67,20,12,8,1
SBI41KNB1782727,97,17,9,8,1
SBI68CLA8273236,21,23,15,8,1
SBI84JNC8619853,85,16,12,4,1
SBI10JQF8292663,64,26,21,5,1
SBI78IOA1084052,71,21,13,8,1
SBI99PZR9939542,87,26,15,11,1
SBI84VNE4494194,67,31,24,7,1
SBI04FAH6403134,73,17,10,7,1
SBI00XHM2530429,84,32,18,14,1
SBI61IVD9482550,19,27,14,13,1
SBI01ZSD1120498,20,23,16,7,1
SBI30TZT4604855,18,27,20,7,1
SBI41XVN9708523,60,28,21,7,1
SBI17CXO7590733,63,22,15,7,1
SBI54EIZ1457449,84,32,27,5,1
SBI25QDH8962648,88,27,26,1,1
SBI20UMN5346249,73,21,13,8,1
SBI38QQK4011962,20,23,22,1,1
SBI64YLX4786600,95,26,24,2,1
SBI74UZH9971027,70,19,12,7,1
SBI44USO9769080,79,19,10,9,1
SBI59DOX8109636,61,27,15,12,1
SBI62NYH5310243,95,22,18,4,1
SBI81VCO2153093,81,29,27,2,1
SBI17WZF7418711,80,18,13,5,1
SBI56FNN0925301,60,23,22,1,1
SBI91KEA4522386,62,14,9,5,1
SBI69ARP3068884,24,24,22,2,1
SBI93JDU0175685,92,23,17,6,1
SBI69VIX1519834,65,24,14,10,1
SBI36XTX2389148,96,24,20,4,1
SBI89MLY2701292,93,28,22,6,1
SBI66GGR6303114,62,27,20,7,1
SBI81CTD3630749,71,25,18,7,1
SBI01FJN4933323,99,28,15,13,1
SBI50DOA6146893,62,15,9,6,1
SBI63GXY7359230,19,23,22,1,1
SBI19EOB2212403,23,20,16,4,1
SBI30AQQ0407362,19,22,21,1,1
SBI18FFK7195861,75,26,22,4,1
SBI94EOI5826128,61,17,11,6,1
SBI99QRW7126277,80,29,19,10,1
SBI27XDG9174864,74,18,14,4,1
SBI14GLS7715666,23,21,18,3,1
SBI14CPV6503724,79,24,14,10,1
SBI20QIH9863387,64,18,17,1,1
SBI57FBH1765669,80,13,9,4,1
SBI34OGY8883353,81,24,16,8,1
SBI49KMM3040543,71,20,14,6,1
SBI92BWB3263680,63,17,11,6,1
SBI21ALR3217207,95,27,22,5,1
SBI77XPQ2832709,82,20,12,8,1
SBI87DXG5841815,96,18,16,2,1
SBI14LXY7757457,67,19,11,8,1
SBI90WMI6314296,90,29,26,3,1
SBI18YBH0564070,66,21,11,10,1
SBI93VQV1077897,99,27,16,11,1
SBI76XGY2521306,23,22,21,1,1
SBI72UTX9851849,88,30,18,12,1
SBI54STO2084589,77,27,24,3,1
SBI37XRE2487479,21,19,13,6,1
SBI33BMF6888835,71,31,26,5,1
SBI91BGV7871062,22,25,18,7,1
SBI28ZKX8437813,71,28,24,4,1
SBI84YDQ6910525,86,21,14,7,1
SBI42RKU0879493,68,30,21,9,1
SBI45YBL9571862,64,30,22,8,1
SBI24FDL6579185,22,22,14,8,1
SBI61TWD1635992,83,28,16,12,1
SBI73PNT9067341,79,25,18,7,1
SBI03TEO8334411,75,21,13,8,1
SBI54GVT1807344,91,18,15,3,1
SBI75MLL7686946,62,24,23,1,1
SBI01OHZ7551519,81,27,23,4,1
SBI67QOO5808886,92,26,25,1,1
SBI62UML3838889,65,27,20,7,1
SBI67LUI0108568,73,23,20,3,1
SBI97PUS9729766,81,26,22,4,1
SBI81YNM1302443,85,30,29,1,1
SBI62ONG7479191,94,27,26,1,1
SBI44GUU5590843,81,26,24,2,1
SBI98MGS0578268,61,19,17,2,1
SBI13HTG0847661,22,34,30,4,1
SBI01SNZ9333367,79,18,15,3,1
SBI30SYH0988785,68,25,22,3,1
SBI67TBO7818815,75,34,28,6,1
SBI67XLF0719533,75,17,13,4,1
SBI11LJO5883698,95,24,19,5,1
SBI61RMZ0341268,91,30,18,12,1
SBI72HNW7280624,90,31,19,12,1
SBI60HTH4813795,76,19,13,6,1
SBI68HBS2726729,80,30,18,12,1
SBI22EAY9201779,77,23,21,2,1
SBI33SBJ4463588,90,28,19,9,1
SBI63EAF9046201,65,33,26,7,1
SBI99ISY5445883,20,16,10,6,1
SBI83XSQ8768666,77,27,24,3,1
SBI38IMP0898793,60,22,19,3,1
SBI44KSL2855652,79,25,18,7,1
SBI94WFV2050891,91,25,14,11,1
SBI26IRD7094102,81,16,11,5,1
SBI24WHQ1798062,98,12,9,3,1
SBI08FFW7257157,82,25,14,11,1
SBI92TZL0220821,92,21,20,1,1
SBI35OJU8844275,90,16,10,6,1
SBI73EFN7606225,94,24,17,7,1
SBI26HEQ4636215,82,30,17,13,1
SBI89UKC0926499,80,16,11,5,1
SBI65UNH3031588,24,22,12,10,1
SBI76ISR5718700,22,31,29,2,1
SBI38TOC7145999,90,24,19,5,1
SBI80BVQ5010258,86,21,12,9,1
SBI11QTH0157059,68,25,22,3,1
SBI58IJG0921072,96,21,20,1,1
SBI86YBS7551430,23,23,15,8,1
SBI12XDQ6588616,71,22,18,4,1
SBI03WEM1732997,73,22,14,8,1
SBI97YDC3108481,22,25,14,11,1
SBI37CWM9358587,75,22,20,2,1
SBI12ZJM7206541,84,24,20,4,1
SBI08HLZ8597887,20,28,23,5,1
SBI29LGY6773448,80,35,30,5,1
SBI67CZY4484312,71,23,12,11,1
SBI34XTG4222769,66,13,11,2,1
SBI43WGO6864148,65,28,18,10,1
SBI84GBY1745104,77,25,14,11,1
SBI73IZS7673484,85,25,19,6,1
SBI91UUD3624748,67,20,16,4,1
SBI34KII5452566,66,29,22,7,1
SBI46VLM6648057,76,24,19,5,1
SBI19FVE0960461,82,22,18,4,1
SBI82NQX7247645,80,30,18,12,1
SBI54BCL2925180,91,29,25,4,1
SBI13QIT5324046,63,26,21,5,1
SBI70HJL5448860,21,35,34,1,1
SBI23OLT4018408,74,27,26,1,1
SBI26WDL5536279,93,22,17,5,1
SBI74VSK2115475,65,28,22,6,1
SBI38IVH8847463,76,33,18,15,1
SBI52QYN8901729,86,26,25,1,1
SBI02RRG8073573,18,23,12,11,1
SBI51IRD6901179,77,30,19,11,1
SBI88IXY6168655,73,31,30,1,1
SBI48HKQ1636146,87,33,30,3,1
SBI02SRO3945102,20,24,14,10,1
SBI64AVP8514686,73,28,27,1,1
SBI14ADE5454843,73,26,19,7,1
SBI77SOB3566010,75,32,19,13,1
SBI32AZF5621716,71,26,23,3,1
SBI05JJP1795286,77,28,16,12,1
SBI25NPV4483359,73,31,25,6,1
SBI84GPY3098974,99,30,27,3,1
SBI49DVC2459638,70,21,15,6,1
SBI99HFX6410017,92,26,20,6,1
SBI98FOB1631507,93,17,15,2,1
SBI00BRY2249734,92,23,20,3,1
SBI73JPG9266857,92,23,12,11,1
SBI21AFJ8295793,21,34,33,1,1
SBI80LNT6722910,61,28,21,7,1
SBI62GEM6896467,95,28,25,3,1
SBI07NQH9648124,99,26,25,1,1
SBI34KKG5361994,95,32,31,1,1
SBI22LWA1999224,22,30,29,1,1
SBI98EVB2510355,70,20,11,9,1
SBI12XRW8729332,87,14,12,2,1
SBI52BZA0398752,98,26,16,10,1
SBI95OML8095144,24,24,17,7,1
SBI36UXC1297713,99,27,22,5,1
SBI22HPM0301328,94,23,20,3,1
SBI32RTU4972421,91,29,19,10,1
SBI48JUN3136010,62,17,12,5,1
SBI97CNG0400248,67,29,24,5,1
SBI92TBV6975916,69,23,22,1,1
SBI50TGB1728176,96,29,23,6,1
SBI65EOE9597769,18,21,15,6,1
SBI99SNH0005234,88,15,11,4,1
SBI20CPR3534046,91,31,20,11,1
SBI73ZXE1540311,87,25,15,10,1
SBI89AKQ7465305,91,23,17,6,1
SBI32DFZ4501240,25,18,16,2,1
SBI09HMJ5932806,70,21,20,1,1
SBI41URA3361314,63,26,14,12,1
SBI58MSB6758545,80,18,12,6,1
SBI00PGU8497951,68,22,14,8,1
SBI51KHB3623177,95,24,19,5,1
SBI09CJU1100051,62,30,23,7,1
SBI99KUX6474771,65,25,13,12,1
SBI74WBA9053705,74,28,17,11,1
SBI29ACX0892871,67,31,30,1,1
SBI75THB6755025,70,23,21,2,1
SBI85WKI5085988,87,23,15,8,1
SBI55DAV1194141,94,24,13,11,1
SBI48XVS8274264,76,24,20,4,1
SBI77TMK3810308,73,27,21,6,1
SBI51OCH1234578,19,30,26,4,1
SBI09MHU0706442,94,26,19,7,1
SBI92IMF8681066,64,26,14,12,1
SBI67TPL3448184,85,25,16,9,1
SBI80WTI6005747,94,21,18,3,1
SBI45NQS2882244,78,27,17,10,1
SBI08HVU9402530,20,37,19,18,1
SBI48NVA5033140,81,21,13,8,1
SBI50FIN7937800,64,24,18,6,1
SBI66VOY7216398,83,24,23,1,1
SBI82WES4430191,96,24,23,1,1
SBI93YER7726731,93,27,16,11,1
SBI46YXB3128509,70,35,28,7,1
SBI82LBC1570821,87,25,24,1,1
SBI83FSX5360374,94,26,20,6,1
SBI37QYH4647362,94,23,13,10,1
SBI99KNH9166640,24,18,15,3,1
SBI04JKZ8524841,80,22,17,5,1
SBI70WJH3265421,18,33,28,5,1
SBI53UNS1407244,77,23,21,2,1
SBI35QUO3378156,66,26,19,7,1
SBI57FSA9085088,76,28,25,3,1
SBI87NYV9129624,68,23,17,6,1
SBI01XSX6815228,60,20,17,3,1
SBI81RAF9185440,92,19,18,1,1
SBI53OIQ7616712,20,25,15,10,1
SBI08HBU1505552,88,20,16,4,1
SBI76SQT4934523,82,32,28,4,1
SBI03LLE1319606,90,21,14,7,1
SBI54EJG7326730,23,15,12,3,1
SBI52GCF5973171,24,27,19,8,1
SBI23ZSX4141191,93,28,19,9,1
SBI18CAG8992054,82,27,21,6,1
SBI99LBU2142816,72,25,13,12,1
SBI19WGL8952109,73,19,18,1,1
SBI67RLQ1450219,23,26,20,6,1
SBI36DOB0471193,65,27,26,1,1
SBI98SNH3165600,18,20,14,6,1
SBI17TKV2489642,61,24,23,1,1
SBI62ZCF6330370,94,37,32,5,1
SBI94CRM7558949,71,33,29,4,1
SBI78FMY7508092,19,27,18,9,1
SBI48RDZ3642887,94,17,14,3,1
SBI04SGI7669864,65,19,16,3,1
SBI89UVI7889761,92,17,10,7,1
SBI81XOJ3528934,63,27,22,5,1
SBI45IGM4456050,90,28,22,6,1
SBI75HCN6717128,85,21,12,9,1
SBI82TPK5925633,81,34,21,13,1
SBI61PWI1356338,77,15,12,3,1
SBI45HNN1633368,73,27,20,7,1
SBI40GCV7067423,77,29,24,5,1
SBI87AVI2478019,61,25,16,9,1
SBI39MUE6270098,86,16,14,2,1
SBI33ODR2137025,60,12,11,1,1
SBI71DRS8856349,86,19,16,3,1
SBI64IEP0640789,93,22,19,3,1
SBI16KLJ2216874,75,23,21,2,1
SBI40VYY1291372,62,30,22,8,1
SBI31OMW6513692,65,31,19,12,1
SBI94OIA7665690,18,27,23,4,1
SBI47BWA0756487,88,23,12,11,1
SBI68ZBU4819897,79,19,15,4,1
SBI59PLD4903172,67,23,22,1,1
SBI95SNY2510341,82,28,23,5,1
SBI26QJM1659007,83,20,12,8,1
SBI20ZZN4638028,22,23,15,8,1
SBI99ICP0760770,75,22,19,3,1
SBI66YJY9941910,98,25,24,1,1
SBI74RXA2478010,85,20,13,7,1
SBI28CNU2944407,76,18,17,1,1
SBI62GWK3578073,78,24,21,3,1
SBI07ELO2818927,76,25,19,6,1
SBI02SVM7737959,94,19,12,7,1
SBI12ULX4765189,67,24,15,9,1
SBI21GEQ4396906,24,33,19,14,1
SBI03HPD7984557,66,23,18,5,1
SBI25SWP1611686,81,21,14,7,1
SBI30ABP3805557,72,25,19,6,1
SBI51CDV3928135,88,30,20,10,1
SBI89OTL1955332,21,32,27,5,1
SBI03BOF2886907,79,20,11,9,1
SBI39TVK6687055,74,30,21,9,1
SBI34BGM8906228,79,26,17,9,1
SBI20SFQ4083131,85,17,13,4,1
SBI63RPE4060960,61,27,23,4,1
SBI72ZNV8943670,86,27,20,7,1
SBI16BEE8870432,85,34,27,7,1
SBI51MFF9116044,93,29,16,13,1
SBI75AJS2343659,82,26,18,8,1
SBI37FLR5193663,19,19,15,4,1
SBI54BHL7154479,22,19,15,4,1
SBI00WZQ4580003,69,12,10,2,1
SBI57BSF4968089,99,20,16,4,1
SBI00WRX4314137,24,32,28,4,1
SBI34HEU5355448,21,26,15,11,1
SBI73PMR2726504,77,29,24,5,1
SBI61SZY3920236,81,23,22,1,1
SBI72UDS2484415,98,35,21,14,1
SBI96AXT3944311,98,23,19,4,1
SBI89XRA4722887,24,23,22,1,1
SBI00DFU3534152,77,36,30,6,1
SBI33JHL0178032,60,27,17,10,1
SBI79NHF3036879,63,20,14,6,1
SBI11UNM7772715,86,28,25,3,1
SBI31VBM8411854,20,25,14,11,1
SBI60VTW8545769,81,29,27,2,1
SBI83MNE3458007,98,28,16,12,1
SBI42CQP0066378,60,22,19,3,1
SBI59KHD4689816,19,37,28,9,1
SBI07WYK3667484,93,27,20,7,1
SBI55GOI5977675,81,20,15,5,1
SBI96DQX8051584,90,25,14,11,1
SBI95KSL1055225,63,33,21,12,1
SBI83CRW8991568,19,31,18,13,1
SBI16YLR0959035,60,21,19,2,1
SBI11MBD9881469,72,19,15,4,1
SBI16ARB0403948,87,17,15,2,1
SBI04PCB7519552,96,24,16,8,1
SBI99FUB0980433,91,23,16,7,1
SBI07AMK1714753,67,32,26,6,1
SBI37SVB5772584,76,26,17,9,1
SBI08MOQ6938251,76,31,27,4,1
SBI73HEL9312568,67,27,25,2,1
SBI40YPO1846763,25,21,16,5,1
SBI87KGK6214401,93,15,11,4,1
SBI27NGT8854879,81,24,21,3,1
SBI94IAX6633187,85,21,11,10,1
SBI03YSQ3071898,82,27,24,3,1
SBI80HJI0492461,62,30,26,4,1
SBI14KXQ0798782,92,19,15,4,1
SBI54JFG9590729,64,40,25,15,1
SBI02WWU3757197,68,27,16,11,1
SBI78JWU1514101,62,21,19,2,1
SBI25ANM3649769,95,30,19,11,1
SBI78FHN4235112,93,26,18,8,1
SBI56DZH6369891,90,19,11,8,1
SBI12ERA5205892,98,22,20,2,1
SBI98TYB4295089,67,27,20,7,1
SBI03KTV7395281,76,33,29,4,1
SBI31RDR0850532,65,23,22,1,1
SBI86BMM3354685,95,28,15,13,1
SBI73VBQ0451168,64,27,25,2,1
SBI31GFI1630070,62,22,19,3,1
SBI31JXU2221072,78,32,21,11,1
SBI89COG9458469,95,30,25,5,1
SBI59RSR8598177,94,27,14,13,1
SBI55TED3119869,80,31,24,7,1
SBI82NJD5826067,25,25,18,7,1
SBI11VFN0160056,67,33,25,8,1
SBI52IIX0755681,61,26,22,4,1
SBI42HTI9316462,20,34,30,4,1
SBI81JTM6628717,70,28,17,11,1
SBI01AUD0235964,97,28,18,10,1
SBI97TGN2421721,65,27,26,1,1
SBI20HPB7168836,94,21,17,4,1
SBI15ITV4687266,83,17,10,7,1
SBI26HUS3573477,63,22,18,4,1
SBI48DXD2418288,97,26,20,6,1
SBI98LCL0994109,69,19,16,3,1
SBI14ZXH4272946,82,32,31,1,1
SBI19ITM3973752,25,26,21,5,1
SBI39LCZ0632374,81,21,15,6,1
SBI51FVB8342017,87,36,35,1,1
SBI24JZT9813972,93,19,13,6,1
SBI96PID9990533,21,26,14,12,1
SBI23ACI4989848,84,21,19,2,1
SBI72KRB3958667,77,24,13,11,1
SBI20CMM6941952,73,15,10,5,1
SBI69JYM6191988,18,24,15,9,1
SBI80ITN9058110,20,29,26,3,1
SBI25LCX7407636,77,29,20,9,1
SBI75BVM7501028,20,31,25,6,1
SBI11QTB7697338,92,26,23,3,1
SBI21ZKG3806401,94,32,22,10,1
SBI48WET3989482,80,27,22,5,1
SBI23HUC9938577,77,21,15,6,1
SBI79AVC0832984,19,13,11,2,1
SBI48TJQ0830561,75,30,23,7,1
SBI80JBO0219436,99,29,25,4,1
SBI97NWJ8304569,98,15,9,6,1
SBI44TNC1315183,88,24,23,1,1
SBI72PWP0152758,24,25,18,7,1
SBI70PKM1646270,65,29,26,3,1
SBI91XWA4939902,22,25,23,2,1
SBI60ENJ4711320,66,25,13,12,1
SBI81SPJ6991823,74,23,15,8,1
SBI13FVO7842240,88,21,14,7,1
SBI47YBG9253812,78,27,16,11,1
SBI86MTP4448990,67,28,16,12,1
SBI41HYN2706413,80,25,14,11,1
SBI08YQN1461713,60,36,20,16,1
SBI07SCJ6322879,78,22,12,10,1
SBI91YAP3156345,98,23,21,2,1
SBI22TVK4425597,97,25,19,6,1
SBI51WBS8047902,23,25,21,4,1
SBI72AKC0860442,78,26,15,11,1
SBI71AZJ0544603,83,28,27,1,1
SBI23RAV2496278,60,17,16,1,1
SBI15XWF7289256,95,30,20,10,1
SBI24NSI8185886,63,23,14,9,1
SBI75MDR9300608,66,27,16,11,1
SBI17BGL6966593,82,23,14,9,1
SBI49PQX1905858,67,22,19,3,1
SBI35MFQ4913834,94,18,10,8,1
SBI89VST7427260,69,38,27,11,1
SBI28GCO6453118,75,26,16,10,1
SBI05ODC4321794,71,18,10,8,1
SBI73BDA9862142,19,25,20,5,1
SBI54UQA4212337,71,25,13,12,1
SBI82XQP2806581,86,28,21,7,1
SBI40RDA9396606,96,25,18,7,1
SBI02SWN2380956,96,32,30,2,1
SBI97YVL0725296,83,23,17,6,1
SBI10DOA8455235,86,22,16,6,1
SBI03FKC7682040,86,30,20,10,1
SBI32JEV2027704,76,26,18,8,1
SBI99CDY5835212,83,24,13,11,1
SBI05KFH6838710,75,23,18,5,1
SBI36NFR0338165,65,18,11,7,1
SBI09EHF3214077,89,23,15,8,1
SBI31FWB5914698,69,24,15,9,1
SBI93NSU0648065,85,26,20,6,1
SBI22NBV6067567,77,22,18,4,1
SBI35MRK0929332,66,29,18,11,1
SBI31LFK7960535,87,21,19,2,1
SBI86NKR5450793,86,30,17,13,1
SBI57CYQ6378585,19,28,20,8,1
SBI38WJD0202948,62,27,21,6,1
SBI42GET9341426,70,21,20,1,1
SBI62OYC9316499,64,28,21,7,1
SBI68VIG7209209,22,25,19,6,1
SBI57DHE0937964,76,33,18,15,1
SBI59EBP3577811,86,33,20,13,1
SBI30QCI0990223,81,26,23,3,1
SBI53EDI7494784,78,24,20,4,1
SBI77FMB7248080,61,26,23,3,1
SBI29EZI7851744,71,22,19,3,1
SBI19UER4939524,65,26,19,7,1
SBI63LNJ8226457,89,27,24,3,1
SBI57JSG3636683,99,32,31,1,1
SBI15HAH7090038,69,25,18,7,1
SBI29BNP3241604,20,29,18,11,1
SBI54XAX9730887,20,26,14,12,1
SBI16PXZ9141477,69,23,16,7,1
SBI03QKE3772082,76,22,19,3,1
SBI95SXB1470408,85,26,18,8,1
SBI52POZ6588451,96,24,22,2,1
SBI43UBC3354157,88,14,8,6,1
SBI69NUC8186300,98,26,14,12,1
SBI28HEI1618957,90,22,21,1,1
SBI46SJC3377524,66,21,19,2,1
SBI27DWH3822237,68,40,24,16,1
SBI72DGV4515112,72,17,12,5,1
SBI73QHY4346137,24,23,17,6,1
SBI15OVR1914513,63,27,14,13,1
SBI67OCC8793238,20,26,19,7,1
SBI93MEZ0497226,68,32,31,1,1
SBI03MZR3188574,83,29,24,5,1
SBI56FDG5387635,95,39,31,8,1
SBI98ZPF9707630,78,23,19,4,1
SBI15KMH1368472,25,24,16,8,1
SBI86WTN4917035,18,30,17,13,1
SBI37UCZ8581203,67,18,14,4,1
SBI71FTV9823995,69,27,18,9,1
SBI17UHG3032490,60,17,14,3,1
SBI52DEX1740539,67,15,13,2,1
SBI63FEP6674261,90,13,10,3,1
SBI98GSU3037766,63,26,15,11,1
SBI21XYJ0948978,88,21,13,8,1
SBI61BSH7596236,94,23,22,1,1
SBI87RSG0477301,60,20,12,8,1
SBI92NSS0628816,23,23,18,5,1
SBI14LKS2105007,82,30,25,5,1
SBI46FVC0296429,72,29,24,5,1
SBI40IWI8091216,87,24,15,9,1
SBI77PYC3074723,62,21,17,4,1
SBI48DFV2051533,63,21,20,1,1
SBI36XVU5612049,18,28,16,12,1
SBI97NTQ6369330,80,30,26,4,1
SBI91BIE7159061,66,23,13,10,1
SBI93LVC9543804,89,25,22,3,1
SBI46VYI6526521,64,20,12,8,1
SBI76VQV0722671,94,26,25,1,1
SBI74JBQ6267487,86,22,19,3,1
SBI79KJU3593620,86,25,15,10,1
SBI96SJO2222705,95,28,16,12,1
SBI61CYR2797486,61,29,19,10,1
SBI21KLU2759411,75,24,22,2,1
SBI03IRK7663165,82,21,12,9,1
SBI80HAV2618523,88,20,15,5,1
SBI09LTX0228831,70,27,14,13,1
SBI12ELO1047472,75,22,19,3,1
SBI10PBY2580853,64,28,25,3,1
SBI33KJX6212593,73,31,17,14,1
SBI30MJF1717593,65,26,17,9,1
SBI72KYI5390295,87,18,16,2,1
SBI34VEF2300990,81,28,23,5,1
SBI24PSR8032572,85,26,15,11,1
SBI99NNG9916026,87,31,19,12,1
SBI21ORY3399234,66,29,27,2,1
SBI10TUM8726835,83,22,14,8,1
SBI14CXM6594157,88,21,15,6,1
SBI88OJW7874848,61,22,17,5,1
SBI96RAN2215741,74,23,21,2,1
SBI29AUC7144477,78,25,20,5,1
SBI76UPF1775979,73,28,23,5,1
SBI61TLL1320679,87,25,18,7,1
SBI15VOT0066072,67,33,18,15,1
SBI84HJL7753562,93,22,17,5,1
SBI55DRK6073692,71,27,21,6,1
SBI03MVT4211805,99,24,22,2,1
SBI93VBY2907674,84,22,17,5,1
SBI81SCQ1262073,18,17,9,8,1
SBI33RYH5105075,67,21,12,9,1
SBI55JFN2430733,83,27,25,2,1
SBI57JRG2373102,24,28,16,12,1
SBI21XNC1999493,94,25,23,2,1
SBI06EIT6577084,75,33,21,12,1
SBI55GUT8957744,92,19,15,4,1
SBI03SXM5365314,25,24,15,9,1
SBI97MRP1521547,68,21,17,4,1
SBI67FBR8890052,76,30,24,6,1
SBI83FOI1564158,93,21,18,3,1
SBI88XOS4575506,64,21,18,3,1
SBI96JLJ3419508,95,20,19,1,1
SBI21FON3360478,93,19,18,1,1
SBI26QXM1243151,62,31,27,4,1
SBI00TWX0511436,72,20,13,7,1
SBI18HTS8069934,77,19,14,5,1
SBI78IGS8940461,98,18,16,2,1
SBI38AQZ9224474,91,27,20,7,1
SBI78EVB2438056,21,20,13,7,1
SBI37XNA1009787,63,32,27,5,1
SBI25EIL3922799,68,20,18,2,1
SBI30UXP8621570,87,21,18,3,1
SBI66FGQ3423283,83,22,12,10,1
SBI05LWS2439214,91,36,30,6,1
SBI99XVU9837004,67,20,15,5,1
SBI60MCK1341027,61,29,28,1,1
SBI22WXY7432042,94,28,21,7,1
SBI04WFY3977921,86,28,17,11,1
SBI47YBB8957335,19,26,25,1,1
SBI48AVF9109015,24,29,20,9,1
SBI51YDJ8752490,85,28,23,5,1
SBI61PGA5642035,80,25,23,2,1
SBI85ODR6350937,84,20,15,5,1
SBI99DND8247496,20,18,10,8,1
SBI90NLO2730697,20,23,16,7,1
SBI90QSZ8694780,95,27,22,5,1
SBI32ASE2893389,98,23,17,6,1
SBI42CDT4363486,99,17,12,5,1
SBI79FFP5312897,96,25,23,2,1
SBI88ZKX2551069,73,26,17,9,1
SBI83PAE5836511,24,27,18,9,1
SBI97TTD6331436,66,19,11,8,1
SBI44GHM8303341,85,23,14,9,1
SBI04IBZ4114003,65,21,12,9,1
SBI87HFN2972950,67,27,19,8,1
SBI50XHK5444167,19,26,22,4,1
SBI17ETU4144427,68,25,14,11,1
SBI18UAM1256701,64,29,24,5,1
SBI70JJL7625537,95,30,24,6,1
SBI69TWT8507386,69,21,12,9,1
SBI60WBT0087049,60,20,11,9,1
SBI59MCI7436817,87,25,13,12,1
SBI59WQM8673933,99,35,19,16,1
SBI09PNB1037353,91,20,16,4,1
SBI29UWA4488065,94,25,14,11,1
SBI14FWS7054513,61,22,16,6,1
SBI04YPX6300885,70,18,14,4,1
SBI72TXN3703577,98,16,14,2,1
SBI95TEL9212435,95,22,12,10,1
SBI59MQN3424476,85,17,11,6,1
SBI96YOJ2403989,65,29,18,11,1
SBI25QEM4319480,67,22,16,6,1
SBI51UWN3398217,91,15,14,1,1
SBI62MIE9358535,89,40,22,18,1
SBI05FOT9495612,88,29,27,2,1
SBI42QZH9831665,94,24,22,2,1
SBI65FQW2281570,95,21,12,9,1
SBI40DZY0595780,98,26,21,5,1
SBI47JWX2386559,95,10,8,2,1
SBI40HDD6110051,21,30,17,13,1
SBI95WNS4221554,69,16,15,1,1
SBI52HYS7880022,96,25,23,2,1
SBI15HQG6102955,65,25,23,2,1
SBI99QWN0611335,84,23,17,6,1
SBI32IGQ5925683,77,21,12,9,1
SBI40MTC3404835,67,31,22,9,1
SBI37TZW3256694,82,27,14,13,1
SBI43QLW4872885,94,18,15,3,1
SBI62FIK5246549,64,28,19,9,1
SBI49GRH3540049,84,18,13,5,1
SBI43ORJ6460964,83,21,19,2,1
SBI76PJR8594196,71,17,12,5,1
SBI31PPO3540932,92,21,19,2,1
SBI42NSX4790223,74,31,28,3,1
SBI92JNK8730043,84,17,12,5,1
SBI04OXA0390037,64,21,16,5,1
SBI75GRE0492783,65,32,24,8,1
SBI67PDP8627576,70,24,18,6,1
SBI15ZRQ5379659,22,31,28,3,1
SBI69KGI5124617,62,23,16,7,1
SBI90UXA7490084,93,24,18,6,1
SBI41WJB6517623,65,33,22,11,1
SBI25UDC6636982,65,26,18,8,1
SBI88TOP9699728,99,25,22,3,1
SBI58POT9201627,92,27,23,4,1
SBI55JNQ4679622,91,31,18,13,1
SBI86ZFB8608111,83,28,18,10,1
SBI09ZMD0904431,70,20,19,1,1
SBI19NOF9644365,95,24,20,4,1
SBI71CXK4878207,19,29,24,5,1
SBI28GDU5962404,96,27,26,1,1
SBI93TOK3913430,71,19,18,1,1
SBI32AWA2998190,23,33,32,1,1
SBI89NFB2277123,73,25,13,12,1
SBI21MRS6845149,69,19,17,2,1
SBI82ARN5634947,75,28,24,4,1
SBI95UUO0767542,60,16,10,6,1
SBI06KRO1769501,96,20,11,9,1
SBI89QAX7378674,73,31,16,15,1
SBI45ELV9276392,84,29,17,12,1
SBI08POI8927181,89,20,14,6,1
SBI57TWA6640877,68,15,10,5,1
SBI66FWY5005424,83,23,13,10,1
SBI63WDS3741876,21,19,17,2,1
SBI77SDJ6896574,74,30,17,13,1
SBI48JJV5800073,21,20,13,7,1
SBI90GRZ0563301,99,20,13,7,1
SBI52MRR6377058,67,28,16,12,1
SBI45GLD6523801,23,23,17,6,1
SBI81HBR8164623,92,21,19,2,1
SBI77LYY0106658,85,24,20,4,1
SBI20YSS0764281,20,20,14,6,1
SBI96DTZ5566233,74,31,23,8,1
SBI30TAR4386173,85,25,24,1,1
SBI21OZG4143205,21,21,13,8,1
SBI85JDK0807549,91,26,15,11,1
SBI82EDR1180173,97,16,15,1,1
SBI81HQM1912664,75,24,14,10,1
SBI74ZRR0485332,88,35,32,3,1
SBI46TRD7881147,68,15,8,7,1
SBI76UUK7764112,19,30,27,3,1
SBI93FYY5754118,62,25,14,11,1
SBI07YEE5957453,20,23,14,9,1
SBI04BYO5471846,96,20,17,3,1
SBI32EFR7797041,66,16,10,6,1
SBI76TIO3103197,78,23,15,8,1
SBI08VWG1596406,73,29,18,11,1
SBI57SGX6323311,76,21,16,5,1
SBI25ZRX1474681,61,23,12,11,1
SBI39KIN8200315,25,24,18,6,1
SBI21NCQ6184474,61,26,19,7,1
SBI77WVZ7231755,84,29,27,2,1
SBI20GBC2674047,90,33,23,10,1
SBI29DFO4665182,74,25,23,2,1
SBI63AJC4636192,83,28,19,9,1
SBI21AGK2887741,74,21,19,2,1
SBI38KWH5701074,84,32,23,9,1
SBI21GQK2338359,69,28,20,8,1
SBI05RPA1415722,64,26,14,12,1
SBI41GLY4481494,64,23,14,9,1
SBI70OUC2588632,70,18,14,4,1
SBI66IRA2311533,76,27,22,5,1
SBI71EJA0955899,71,19,12,7,1
SBI29UUL7701117,21,20,17,3,1
SBI07YNR4429785,24,22,16,6,1
SBI69JQT7350360,64,29,25,4,1
SBI11VSS9975899,21,20,15,5,1
SBI33ISB1475291,74,28,15,13,1
SBI14SDB2404768,82,20,13,7,1
SBI47CXS9941012,65,30,24,6,1
SBI81SZP5903613,68,34,25,9,1
SBI21INU1783445,74,27,15,12,1
SBI10QVA9470938,97,19,16,3,1
SBI26KLT5492915,95,28,24,4,1
SBI79IGT1135043,20,26,24,2,1
SBI55HQB6050885,24,31,25,6,1
SBI51HJW0568904,96,24,15,9,1
SBI35KPK6009044,99,20,18,2,1
SBI35FRD0446671,71,26,17,9,1
SBI27KUT2650530,78,37,34,3,1
SBI80YFT2819448,79,16,12,4,1
SBI42NTF1981417,72,19,18,1,1
SBI22HXL5242762,60,28,25,3,1
SBI54XHD1543150,84,26,18,8,1
SBI48ZHM6047008,83,22,19,3,1
SBI82EVJ7783337,94,22,16,6,1
SBI30TWS0026442,83,36,29,7,1
SBI08ZCI9097684,87,17,13,4,1
SBI30BJE7394354,67,24,23,1,1
SBI33TCL7311823,62,35,29,6,1
SBI37SCN1421348,68,28,21,7,1
SBI17HNB4380669,99,21,15,6,1
SBI92JIS0341825,86,23,17,6,1
SBI44GNG1289778,71,28,19,9,1
SBI51BNF8266405,77,20,16,4,1
SBI63GWZ3987574,97,18,10,8,1
SBI77WDF8415403,81,28,16,12,1
SBI79ZVS3654421,85,23,15,8,1
SBI32KEG0766979,25,8,5,3,1
SBI86TWR1707035,60,31,30,1,1
SBI24QGR0665302,74,20,15,5,1
SBI99TZT0680226,97,30,23,7,1
SBI77CBW8528810,92,23,21,2,1
SBI19GKP4614407,90,25,20,5,1
SBI28XKB8087041,89,28,20,8,1
SBI32ABV7891824,21,13,12,1,1
SBI14QIF1334138,89,24,14,10,1
SBI97IBG6120075,65,25,24,1,1
SBI00GSK8226120,75,24,23,1,1
SBI49JJS1369697,95,22,21,1,1
SBI53ETZ1992285,82,27,22,5,1
SBI66EYF2980154,88,21,18,3,1
SBI29MCC7462392,91,28,25,3,1
SBI61GBP2749881,98,19,11,8,1
SBI06ZLH4748713,18,24,13,11,1
SBI70QEA5837133,97,27,26,1,1
SBI04NWD3039461,67,24,22,2,1
SBI08EFP8698976,61,24,15,9,1
SBI56QHO3419038,74,20,12,8,1
SBI70LYF1606654,72,28,15,13,1
SBI83WJE7932910,71,26,22,4,1
SBI58WII7705343,25,28,20,8,1
SBI29XWO9375709,75,20,14,6,1
SBI02KOV8908607,22,27,21,6,1
SBI42XLP4924067,65,36,28,8,1
SBI84ECF6748446,84,25,15,10,1
SBI78HFF1273327,23,34,27,7,1
SBI58UFI1240544,72,22,12,10,1
SBI66LZM3673070,18,26,24,2,1
SBI85JLS3981608,85,26,14,12,1
SBI68UKQ0243361,65,18,10,8,1
SBI61EDG0045704,22,27,16,11,1
SBI52RCD8899684,68,19,12,7,1
SBI77OYH7411921,76,26,22,4,1
SBI98KUE2737789,91,20,12,8,1
SBI94TLT7290378,79,23,21,2,1
SBI08EJR5669722,20,26,24,2,1
SBI62MLW5635215,65,25,23,2,1
SBI88RVD0579849,68,25,23,2,1
SBI30EMJ8013566,75,18,13,5,1
SBI32BNW5551267,98,20,13,7,1
SBI66VLL6324777,78,20,19,1,1
SBI87KWD9229581,67,18,16,2,1
SBI65RCK9395884,89,23,13,10,1
SBI09GSH1689655,25,27,19,8,1
SBI42OSU9139075,61,16,11,5,1
SBI70MIN8199817,97,27,17,10,1
SBI09GVX7776311,91,26,16,10,1
SBI97QHO9785885,25,33,17,16,1
SBI01FKH3833012,67,27,17,10,1
SBI10ADA3606191,21,21,16,5,1
SBI06JAI3649595,81,26,18,8,1
SBI75ZGZ9529263,71,22,20,2,1
SBI42BCN9233650,94,25,13,12,1
SBI39RMX3573580,82,40,30,10,1
SBI16IFL5023481,20,23,21,2,1
SBI13DGQ5845081,25,32,18,14,1
SBI73NRV8861135,87,27,21,6,1
SBI06JAW2403758,91,18,10,8,1
SBI78SSJ0666523,73,17,12,5,1
SBI78UDS8083031,82,18,11,7,1
SBI92BAG8818503,72,26,23,3,1
SBI97KND0969133,76,24,21,3,1
SBI81PVP2386287,67,16,12,4,1
SBI24SNQ9946014,88,30,26,4,1
SBI87RCA0409139,80,15,12,3,1
SBI79ENT8778560,61,31,24,7,1
SBI04AUT0937776,67,23,18,5,1
SBI51FDK5121169,93,25,19,6,1
SBI21KJB9136750,82,25,21,4,1
SBI40UBR6191111,66,29,26,3,1
SBI11LJV2634639,21,16,15,1,1
SBI54NDH4370570,65,20,11,9,1
SBI44JMC6898494,84,20,19,1,1
SBI06KOT0140410,68,27,23,4,1
SBI87ETK8551483,98,21,19,2,1
SBI18JIC5020230,93,30,22,8,1
SBI03TPM4911446,89,24,15,9,1
SBI18GGC4269896,80,30,29,1,1
SBI80QDK4745974,21,21,16,5,1
SBI75OJL8837621,67,30,26,4,1
SBI13IYU3442403,95,27,24,3,1
SBI09XEE2338425,83,24,15,9,1
SBI43FSD7523840,74,20,18,2,1
SBI76UOK0063287,87,29,25,4,1
SBI72DCS9727647,21,20,18,2,1
SBI66QPE4842279,91,19,15,4,1
SBI05PMK7228288,72,24,15,9,1
SBI63MKA4217311,82,18,13,5,1
SBI75AZW7414339,82,36,21,15,1
SBI31EGL8573638,81,22,16,6,1
SBI81ZHA8780191,19,18,17,1,1
SBI66RTE1244875,65,19,13,6,1
SBI92FCO0727406,79,29,24,5,1
SBI60MFZ5967836,79,22,14,8,1
SBI19EXL3647510,19,24,17,7,1
SBI15PTC0593202,87,27,21,6,1
SBI24STW3960427,76,16,14,2,1
SBI53YJN4902733,64,21,12,9,1
SBI51NFZ0329095,76,24,18,6,1
SBI67EBH3987629,64,19,15,4,1
SBI38SVB1617900,22,32,21,11,1
SBI92QIZ4185952,92,17,14,3,1
SBI42IMH8797283,98,27,15,12,1
SBI58QIN6259613,66,28,19,9,1
SBI56AHY0560660,18,22,12,10,1
SBI01YHX5330664,60,27,18,9,1
SBI73NBA6587511,99,26,16,10,1
SBI50TFA7230896,99,25,22,3,1
SBI48WJQ1301504,85,26,23,3,1
SBI48JPR4169512,88,26,21,5,1
SBI97CHJ6143674,95,37,32,5,1
SBI26CVM0712724,62,33,23,10,1
SBI13WLR4310073,99,21,19,2,1
SBI57HLA1428067,72,23,21,2,1
SBI16DKB0175875,66,19,11,8,1
SBI09LNI0017761,97,27,23,4,1
SBI33WEQ9443129,79,19,18,1,1
SBI05GAO2375597,85,37,21,16,1
SBI10JRV6274079,65,21,20,1,1
SBI24MXK9313932,67,28,22,6,1
SBI83HSE9769419,67,26,18,8,1
SBI14YJN2582736,77,23,22,1,1
SBI10KMF4046699,84,32,27,5,1
SBI41HRP6418187,82,26,23,3,1
SBI30DDF6200784,80,23,22,1,1
SBI07EIT2380367,75,22,14,8,1
SBI33PCS3216887,63,27,14,13,1
SBI53YRY6982468,25,23,22,1,1
SBI20ZVG4257247,73,29,17,12,1
SBI07GSW9804734,68,28,24,4,1
SBI84LCC6880694,76,20,14,6,1
SBI90VYF8822424,78,29,17,12,1
SBI16EKC5873108,96,21,17,4,1
SBI95RJN8498790,96,26,18,8,1
SBI14KPS5012724,91,18,14,4,1
SBI60PLX4460969,98,24,14,10,1
SBI72YOE0040288,65,16,13,3,1
SBI99ZOT1352786,73,16,13,3,1
SBI66DAC7607351,97,15,13,2,1
SBI21AQE3125451,20,22,13,9,1
SBI98QPP0379454,19,30,19,11,1
SBI02NYP5091178,66,24,19,5,1
SBI76SSX9035752,71,15,9,6,1
SBI90KEQ6087251,63,19,18,1,1
SBI46TTM9548628,64,31,29,2,1
SBI78OHP7064302,82,28,24,4,1
SBI98PAI5136235,64,23,16,7,1
SBI04RLY9643849,92,21,17,4,1
SBI97OKQ6180046,24,24,21,3,1
SBI03ZIP3837970,24,24,21,3,1
SBI71SGY1955269,87,17,12,5,1
SBI15RCQ3097119,98,18,12,6,1
SBI23OAC1593348,95,30,28,2,1
SBI61LGC3107763,19,12,11,1,1
SBI56LZA8229882,92,14,13,1,1
SBI21CEQ1604348,24,23,15,8,1
SBI49KRJ9417076,96,25,23,2,1
SBI38ASX6768549,79,34,32,2,1
SBI37WGN0272363,75,27,14,13,1
SBI24QNP4016866,89,26,24,2,1
SBI50EWJ9750399,23,22,20,2,1
SBI85JEQ2793126,71,29,24,5,1
SBI43WKY1874158,23,28,20,8,1
SBI64NOG0367703,94,26,18,8,1
SBI06ZPD8711723,83,14,10,4,1
SBI62CAJ0489840,96,15,12,3,1
SBI49ENQ6836151,96,27,24,3,1
SBI10HHY5289764,88,25,14,11,1
SBI20WQQ7089618,94,28,17,11,1
SBI17RLR3751422,78,24,16,8,1
SBI04WMV1413114,70,29,16,13,1
SBI12YHV7506418,18,25,22,3,1
SBI14AMZ6857811,67,34,22,12,1
SBI29MJD8600372,79,32,28,4,1
SBI84YIY6495911,61,24,20,4,1
SBI71QWP5867277,73,27,21,6,1
SBI96HJZ2344954,98,30,20,10,1
SBI76PLY3054312,76,15,13,2,1
SBI24WML5420875,86,18,17,1,1
SBI57GTE9278775,67,25,22,3,1
SBI73UEP7349030,76,23,13,10,1
SBI57WWF7302444,66,27,23,4,1
SBI93YQK5858215,63,24,13,11,1
SBI34UZQ9777660,71,20,11,9,1
SBI04HEY8399370,94,29,22,7,1
SBI87RIW6462057,96,27,22,5,1
SBI39PIV6094780,24,23,20,3,1
SBI74OFZ3030517,88,27,23,4,1
SBI76JJC4790328,77,20,17,3,1
SBI17AVV8091525,70,20,14,6,1
SBI48SRC4213570,71,23,22,1,1
SBI34ORL4092898,87,16,15,1,1
SBI48UPK4037981,73,31,29,2,1
SBI76LMR4093488,95,29,27,2,1
SBI38WWD2776155,76,19,10,9,1
SBI93CKO7525934,24,27,14,13,1
SBI93VJM8912731,25,28,19,9,1
SBI86QYS2309482,90,16,13,3,1
SBI68JNO4560506,66,20,12,8,1
SBI19TBR7595490,94,28,27,1,1
SBI14ZKI0687937,19,24,20,4,1
SBI25HBV2458187,70,24,22,2,1
SBI10FTF8735269,68,23,14,9,1
SBI99WTH3424178,76,16,10,6,1
SBI28BCF0316219,77,30,22,8,1
SBI92EOH7221019,64,20,18,2,1
SBI71HYD2715435,21,25,16,9,1
SBI53DDM0499036,80,12,7,5,1
SBI40IUC4875710,19,28,21,7,1
SBI02HCK3310513,92,30,27,3,1
SBI47CCW4916396,93,16,13,3,1
SBI64FNE4931127,20,21,12,9,1
SBI74MDK3831836,68,32,28,4,1
SBI99AVD6606776,73,18,15,3,1
SBI15LOV6194536,81,21,13,8,1
SBI98JGY3467389,73,24,13,11,1
SBI05LWN3155186,87,30,24,6,1
SBI45HGF2267140,71,18,15,3,1
SBI99GPE6596621,88,27,14,13,1
SBI02WFA6389508,19,29,15,14,1
SBI94VUK5378126,90,25,18,7,1
SBI73PKB5896065,79,29,27,2,1
SBI39UZO6692369,82,25,20,5,1
SBI82EWQ8663587,88,30,16,14,1
SBI85GUG8165176,82,35,23,12,1
SBI84MLC2570334,77,27,17,10,1
SBI38FEP9083418,80,23,13,10,1
SBI80IRW5814768,87,23,20,3,1
SBI23IXT9979574,76,23,18,5,1
SBI36TFW0095460,24,26,24,2,1
SBI48NVI3894953,94,32,24,8,1
SBI22NRI3013912,98,24,20,4,1
SBI13WSA9479081,83,23,21,2,1
SBI12JAK4979875,67,28,25,3,1
SBI89GOX7122344,99,33,26,7,1
SBI97FGH7860133,97,29,25,4,1
SBI79FRE8497712,70,25,22,3,1
SBI50IOO8055115,85,34,28,6,1
SBI94FTK3138803,75,21,11,10,1
SBI61HGW8425851,85,21,16,5,1
SBI22DFW1024577,69,19,12,7,1
SBI70VGA4730531,19,25,15,10,1
SBI25FZX0001378,92,27,19,8,1
SBI15IVJ1703786,82,28,16,12,1
SBI75PZY4351976,78,28,15,13,1
SBI36SFJ8032058,61,20,19,1,1
SBI04HGG5942491,64,14,12,2,1
SBI69AGC4045602,72,24,17,7,1
SBI67ORW0181001,89,24,23,1,1
SBI69LGU8365012,87,25,22,3,1
SBI24BHF2709197,83,24,20,4,1
SBI57PEL1328009,79,24,20,4,1
SBI60BOF3358492,98,28,16,12,1
SBI97KMZ3991341,99,30,16,14,1
SBI20VNM9624953,76,23,20,3,1
SBI90VDL0122217,97,21,12,9,1
SBI41DKR4180199,24,23,16,7,1
SBI94TVL8510380,64,26,15,11,1
SBI37DKV7445814,91,32,26,6,1
SBI53DYV1068786,99,16,11,5,1
SBI15HKJ2004791,89,18,15,3,1
SBI62AKP9733351,71,29,25,4,1
SBI51EWC0047308,82,33,17,16,1
SBI43NRS0443278,18,30,24,6,1
SBI90BTX6189400,78,24,20,4,1
SBI98QIY3219403,20,31,27,4,1
SBI16WUB3361145,67,32,27,5,1
SBI80KNM9511106,71,25,18,7,1
SBI50LDX8197783,98,20,17,3,1
SBI19GTB4056391,62,27,24,3,1
SBI45XKT3969701,61,24,19,5,1
SBI04IJF6362781,66,26,22,4,1
SBI99IPE4807318,72,22,21,1,1
SBI03ZKT5301646,95,23,13,10,1
SBI56APX1862946,19,26,22,4,1
SBI40BZU4804570,78,26,18,8,1
SBI21CBJ3815197,97,25,22,3,1
SBI16LHU0320012,82,19,14,5,1
SBI41BWC0788213,21,32,31,1,1
SBI06KUT9768575,69,21,14,7,1
SBI04OHR5640596,82,17,10,7,1
SBI48EXF4657739,76,20,17,3,1
SBI90GCK9918849,88,27,14,13,1
SBI69ZJZ3922033,22,26,25,1,1
SBI94KJQ8038940,78,26,19,7,1
SBI01DDS5880212,19,25,23,2,1
SBI19NER0429339,62,21,19,2,1
SBI81PTT7850131,82,27,17,10,1
SBI64RDR8435267,77,20,18,2,1
SBI73EDU1610240,85,22,15,7,1
SBI26FCT9191967,87,19,11,8,1
SBI70KIS5195223,78,24,18,6,1
SBI34WNV4879165,18,25,24,1,1
SBI21RVK2816798,65,35,27,8,1
SBI55LQM7057044,19,23,18,5,1
SBI06GQI2974508,84,33,22,11,1
SBI97ECH6480199,73,25,15,10,1
SBI21IFV8420118,96,18,17,1,1
SBI61YRH8119468,73,29,23,6,1
SBI60FYN6362028,25,28,23,5,1
SBI74ANE2003042,85,29,17,12,1
SBI05DGQ8600437,99,14,11,3,1
SBI29KRA8292730,65,31,22,9,1
SBI59VIS7173686,25,29,16,13,1
SBI84OXT9471086,71,23,18,5,1
SBI23HSI5465397,81,24,21,3,1
SBI95ITL0456497,61,26,18,8,1
SBI21XRZ7318595,21,28,20,8,1
SBI75JYH9263135,87,28,16,12,1
SBI58GAF7709486,84,21,11,10,1
SBI91HEA1859714,85,23,15,8,1
SBI11ANS2884622,24,22,16,6,1
SBI62JYB7965405,74,23,17,6,1
SBI34YNI7030804,19,20,19,1,1
SBI07CUX2792346,69,26,18,8,1
SBI88UKO1573748,95,28,17,11,1
SBI09VQF5976238,77,23,12,11,1
SBI60OQA1190268,25,20,16,4,1
SBI52NPO1296906,95,40,35,5,1
SBI83TWG0634325,65,24,23,1,1
SBI02HLA8161991,96,23,16,7,1
SBI87RMM5972336,67,23,22,1,1
SBI26JVG1739384,20,20,15,5,1
SBI78CIR5048730,91,20,19,1,1
SBI17RWN0797223,97,30,17,13,1
SBI53BDE5038094,25,19,13,6,1
SBI55ZHM5810873,63,22,21,1,1
SBI42CVZ0277088,87,28,17,11,1
SBI46OUY8840189,62,25,23,2,1
SBI49VGG9554337,22,20,17,3,1
SBI72GLU4132501,24,24,20,4,1
SBI57DDA1944838,86,24,17,7,1
SBI49RFG9836931,65,29,23,6,1
SBI39UTC2752311,96,32,24,8,1
SBI57ROT7033938,79,23,18,5,1
SBI45IXC1467559,88,22,21,1,1
SBI24TIN1140415,62,17,15,2,1
SBI96OYJ1824959,64,33,24,9,1
SBI47QPQ3306641,69,23,21,2,1
SBI02COM1452951,70,18,12,6,1
SBI87PBV4379152,78,32,25,7,1
SBI95VGB8842661,20,31,23,8,1
SBI60SDQ8281123,78,20,17,3,1
SBI18DBP5825007,83,31,30,1,1
SBI72BBD2921887,68,22,21,1,1
SBI01ZEL8541627,21,28,27,1,1
SBI99ETV9701737,78,19,16,3,1
SBI78WFR5477735,88,25,15,10,1
SBI70CST3535230,62,30,24,6,1
SBI55PAF3262446,64,28,15,13,1
SBI64NCN3547296,18,23,19,4,1
SBI16MKD9085940,62,16,13,3,1
SBI11DEU0981842,69,23,12,11,1
SBI49WUW7449099,18,32,28,4,1
SBI62IZQ8370447,80,22,21,1,1
SBI47NKV6684797,25,32,17,15,1
SBI97VHS6993991,67,29,19,10,1
SBI67YMZ4807320,22,25,23,2,1
SBI68PBA8904328,86,24,14,10,1
SBI76QKD9457345,68,34,26,8,1
SBI86PKZ5362053,20,27,23,4,1
SBI56TZN3182173,77,27,18,9,1
SBI42YDU3470071,61,22,17,5,1
SBI19JTC4610722,66,28,19,9,1
SBI41NIB7430189,86,24,20,4,1
SBI61GJH9769232,92,24,17,7,1
SBI98RKV9436982,67,17,9,8,1
SBI51HFD5347861,66,29,15,14,1
SBI81JMG6525826,86,23,12,11,1
SBI98BGA7226422,70,25,13,12,1
SBI34JYL2472502,19,25,16,9,1
SBI16EAI3248043,68,20,18,2,1
SBI58VJG8579860,65,22,13,9,1
SBI71RPI0919448,91,21,16,5,1
SBI20CJJ2066212,70,26,25,1,1
SBI63KXC0434746,89,27,26,1,1
SBI66HRV0332799,82,30,28,2,1
SBI11BNF1584005,22,23,12,11,1
SBI85WFH8510881,83,19,10,9,1
SBI14KFQ7517610,81,21,13,8,1
SBI21LZZ0997228,93,29,19,10,1
SBI53IKA3368236,84,26,24,2,1
SBI40KSK8315501,60,23,16,7,1
SBI36TVH1444732,78,21,13,8,1
SBI17SDI1094635,75,29,27,2,1
SBI49VSR7113874,85,28,25,3,1
SBI88NFR6532834,98,28,16,12,1
SBI15ABI7349921,84,23,16,7,1
SBI98OKN3381081,80,30,19,11,1
SBI16CGL8799502,70,27,21,6,1
SBI22FJE8861314,61,22,17,5,1
SBI83PVI9097184,74,17,16,1,1
SBI24ZNF9644183,85,23,19,4,1
SBI47EJE4500466,21,26,22,4,1
SBI56UQV8720354,91,24,13,11,1
SBI92FZZ6800338,75,20,16,4,1
SBI80NVH3998307,95,28,15,13,1
SBI16KJG5873442,79,29,27,2,1
SBI39JAV7352457,82,22,14,8,1
SBI22RZO0593267,60,26,24,2,1
SBI23NAF5254431,63,31,24,7,1
SBI19KPL5901252,99,27,22,5,1
SBI98PNF7462377,69,23,20,3,1
SBI37JRA7724497,99,31,28,3,1
SBI67IOD6642960,88,16,12,4,1
SBI07YOU9773164,67,21,15,6,1
SBI97WGN8759871,23,24,21,3,1
SBI89AEG4415546,88,23,13,10,1
SBI90AIR9746062,98,26,18,8,1
SBI94POC0571493,92,29,15,14,1
SBI09EWJ2121504,97,32,23,9,1
SBI41HFT2624376,65,22,19,3,1
SBI99JAA1324958,96,26,15,11,1
SBI76PQP8963244,72,33,31,2,1
SBI54GFK8817996,86,21,13,8,1
SBI36XIK2146615,87,22,13,9,1
SBI41HRF1444474,98,28,21,7,1
SBI18ZCN1177239,71,23,13,10,1
SBI92XEI7898707,71,13,12,1,1
SBI61EKC9781374,23,29,16,13,1
SBI61RDL4589646,19,30,20,10,1
SBI43KQW7165551,22,25,21,4,1
SBI74GFR5050439,64,22,13,9,1
SBI91RSB0500429,66,17,15,2,1
SBI68LQC8064442,88,19,10,9,1
SBI37VLN7206381,84,25,19,6,1
SBI96XYC1835979,20,21,11,10,1
SBI97PHN5602496,19,27,24,3,1
SBI89FZP2749459,86,18,10,8,1
SBI49NPN4500145,24,24,19,5,1
SBI33PJL3332230,18,26,23,3,1
SBI78QSW5488647,93,32,20,12,1
SBI40COH1087075,79,23,19,4,1
SBI97OYT9339530,81,26,18,8,1
SBI99XPY0066290,61,34,21,13,1
SBI05OWK7274904,21,27,21,6,1
SBI59GPG1422583,94,28,18,10,1
SBI52ORN4920596,85,20,11,9,1
SBI33GNN9398723,66,31,16,15,1
SBI70WVY0849239,65,27,14,13,1
SBI37IJD2767581,64,28,15,13,1
SBI94AQG2577005,87,25,17,8,1
SBI87QBW7019307,25,22,17,5,1
SBI43PFN3271604,72,28,24,4,1
SBI91AKG2416658,86,28,24,4,1
SBI83WQO4029148,83,27,15,12,1
SBI74XQY6636146,72,14,8,6,1
SBI83MCK1411940,91,29,27,2,1
SBI88XWX6493312,90,17,12,5,1
SBI81HPP1420846,64,24,14,10,1
SBI75MKW6934047,97,26,21,5,1
SBI92WFN6630046,97,22,21,1,1
SBI61SQS3252704,85,27,24,3,1
SBI29UAY2137004,23,32,22,10,1
SBI13GDT2786129,77,27,24,3,1
SBI96JNK3960167,90,35,26,9,1
SBI72RRL6485163,78,26,19,7,1
SBI07RCI9720531,75,32,20,12,1
SBI11YDM9487522,25,21,16,5,1
SBI08ZOY7504744,88,21,19,2,1
SBI11OSB9001549,95,21,20,1,1
SBI21EWY7993716,20,15,8,7,1
SBI95EBU8706552,67,27,24,3,1
SBI42OJD1682304,68,28,15,13,1
SBI19KLG0649161,80,21,13,8,1
SBI31DZJ2198844,71,31,17,14,1
SBI40EQL8713012,98,25,16,9,1
SBI74UCJ3372851,62,23,14,9,1
SBI35QEI5884545,79,14,12,2,1
SBI90VKR4979436,66,30,28,2,1
SBI40WDM5605740,76,21,16,5,1
SBI92LGO7364988,78,20,18,2,1
SBI50AIC4286441,98,21,15,6,1
SBI54SNC7179232,97,22,15,7,1
SBI52VTR4555104,92,15,14,1,1
SBI28BYH2667145,66,19,11,8,1
SBI79XJS3471555,24,21,11,10,1
SBI72BSG0941383,20,16,13,3,1
SBI55JHT3754627,72,30,21,9,1
SBI55XBS3582561,68,22,16,6,1
SBI87OSU3984070,96,25,18,7,1
SBI44EBS7172972,93,13,8,5,1
SBI77FLE2010419,63,24,20,4,1
SBI56IHS9119046,94,32,25,7,1
SBI70ZPV1330829,68,17,16,1,1
SBI94DSD5231436,66,24,16,8,1
SBI50HRT5340986,76,21,17,4,1
SBI25XQM3317625,76,20,17,3,1
SBI81EVG3681407,88,21,20,1,1
SBI55GXE7420654,76,30,28,2,1
SBI81CBB6879440,95,23,20,3,1
SBI85SJA5991049,73,34,21,13,1
SBI71LNN6622897,67,17,15,2,1
SBI98OZR1006914,92,19,12,7,1
SBI78EJZ5731119,94,23,17,6,1
SBI80OBJ3883612,73,24,17,7,1
SBI21XTH5052382,89,19,13,6,1
SBI70KJO2286790,65,31,18,13,1
SBI09VNH8075244,64,27,19,8,1
SBI48JLH8775501,63,24,22,2,1
SBI32RVB3432479,71,25,19,6,1
SBI78FIS4567184,66,23,17,6,1
SBI01IJU3661002,62,23,20,3,1
SBI60CFQ1807089,97,28,21,7,1
SBI27EYD4868036,25,21,11,10,1
SBI40EKO9819191,90,20,14,6,1
SBI21YTK1525320,22,25,14,11,1
SBI72ZTW8501272,21,20,13,7,1
SBI41AYR7474576,98,21,19,2,1
SBI52MCS5724757,18,33,26,7,1
SBI13VKL3411255,73,30,21,9,1
SBI98DOM9093720,98,19,18,1,1
SBI38RSX9226710,76,26,22,4,1
SBI01CGD6982548,61,24,23,1,1
SBI41VYU5282820,19,20,15,5,1
SBI45LGT7545619,75,36,32,4,1
SBI58QAV1211327,68,23,17,6,1
SBI66OWY3101086,99,26,17,9,1
SBI37DPC1168474,66,32,22,10,1
SBI19MOY7928948,72,25,21,4,1
SBI27FBO4275867,68,36,20,16,1
SBI98YWA4235837,99,31,19,12,1
SBI75JBK5570663,19,24,23,1,1
SBI20PAQ9238078,92,25,21,4,1
SBI53AUC1418544,67,33,21,12,1
SBI47BRW9833489,91,27,14,13,1
SBI36YPA1113709,96,31,24,7,1
SBI66MCW9985480,85,23,21,2,1
SBI91NKG6593123,63,23,17,6,1
SBI35IXR4656493,72,30,25,5,1
SBI71WIV5669574,94,28,20,8,1
SBI65LFK4523768,66,33,20,13,1
SBI59YHL1396071,97,30,28,2,1
SBI22HWQ5430397,61,17,12,5,1
SBI49FQD4058038,63,26,17,9,1
SBI88KFN2158958,72,22,17,5,1
SBI75WSA8302970,98,22,19,3,1
SBI24KDW1940246,82,27,20,7,1
SBI38ZVP9485654,87,24,19,5,1
SBI18OGX2941662,65,19,17,2,1
SBI92UTG8449826,84,19,14,5,1
SBI43QDE1486182,79,25,15,10,1
SBI85TKI7508921,74,28,15,13,1
SBI39YUK9866724,60,19,12,7,1
SBI15BNG5748589,81,26,14,12,1
SBI33BVW8478768,83,29,26,3,1
SBI22UMX3295230,69,25,21,4,1
SBI02QPQ8366197,71,30,22,8,1
SBI11QNY6668398,22,25,21,4,1
SBI81URI3542049,25,32,21,11,1
SBI74ZLE5762740,22,27,16,11,1
SBI47WCO8629258,18,22,17,5,1
SBI79LBK5535760,61,21,16,5,1
SBI51HUW2511134,84,22,16,6,1
SBI85EJD4427033,80,21,15,6,1
SBI17MNE4869983,76,17,12,5,1
SBI77COT9242973,97,27,26,1,1
SBI68GAB8796561,63,24,20,4,1
SBI60LQD8778740,77,20,12,8,1
SBI46SKD3521450,18,24,23,1,1
SBI01CGF1474056,63,28,16,12,1
SBI56AOK9080813,98,31,24,7,1
SBI08YFJ3548251,89,17,14,3,1
SBI61OMI6820212,79,30,19,11,1
SBI46GKL8462461,69,33,32,1,1
SBI61SNV5671093,92,29,26,3,1
SBI81ZOG5858708,73,28,18,10,1
SBI48WUO2883078,78,28,22,6,1
SBI82HCE9149881,87,22,13,9,1
SBI44OQY5133806,64,30,27,3,1
SBI81BZB8829724,73,32,24,8,1
SBI41OBX8457079,83,16,11,5,1
SBI27KLB0171942,74,30,23,7,1
SBI60CDA4432560,74,26,20,6,1
SBI95VNU2673538,70,20,11,9,1
SBI47NUU6138302,19,20,19,1,1
SBI27SXA2174290,66,25,14,11,1
SBI83MMQ2806904,82,29,21,8,1
SBI33RYK7554999,19,25,13,12,1
SBI49SZZ9582881,61,22,12,10,1
SBI80DMB6263048,71,27,15,12,1
SBI78ZQZ8924448,77,14,11,3,1
SBI69GRY9646573,65,29,19,10,1
SBI74JXW2134989,77,34,19,15,1
SBI13XMS4344982,18,26,19,7,1
SBI92TVI1437471,69,21,18,3,1
SBI36SWT5256019,82,25,14,11,1
SBI89EET7954462,18,24,18,6,1
SBI23EII9508782,76,34,25,9,1
SBI86EZK0566629,75,27,24,3,1
SBI96TLM1318596,81,18,10,8,1
SBI09MRK4955667,72,17,12,5,1
SBI70BCZ7543747,63,24,15,9,1
SBI87WIC7125322,24,34,32,2,1
SBI29JJR2909334,92,33,28,5,1
SBI58MSO6307899,92,24,16,8,1
SBI95LNQ1873146,23,19,14,5,1
SBI03OVP5526756,83,31,18,13,1
SBI87IZH9512781,99,35,29,6,1
SBI22DLN3353524,19,19,17,2,1
SBI45OJI7564495,65,21,14,7,1
SBI17LRY2347185,63,25,23,2,1
SBI19CDT9211219,82,22,16,6,1
SBI82KIJ7529220,68,25,13,12,1
SBI70RVB7884064,75,22,14,8,1
SBI71IDN2457450,77,35,24,11,1
SBI73FIV6481724,23,14,11,3,1
SBI57WQM4044451,79,21,11,10,1
SBI55SXW4840722,87,22,21,1,1
SBI89SFX9669216,82,28,17,11,1
SBI82NZY3227029,88,14,8,6,1
SBI03DOQ4224362,98,29,15,14,1
SBI87STT1367722,19,14,12,2,1
SBI50LTS8547119,70,32,23,9,1
SBI94KFW1035605,25,22,12,10,1
SBI31HOO7437850,96,24,13,11,1
SBI03FYP6042313,93,32,25,7,1
SBI26LCW0431522,88,25,20,5,1
SBI46NZD0243114,71,24,13,11,1
SBI73EFV2133615,83,29,26,3,1
SBI51FYQ6368867,88,36,31,5,1
SBI71VRE3639424,79,30,19,11,1
SBI30ALC1398326,80,25,13,12,1
SBI73NYA6580796,98,30,28,2,1
SBI17DPS2493138,92,21,17,4,1
SBI98FMA3325459,96,17,16,1,1
SBI95GXY2553294,85,24,18,6,1
SBI73ECU4799588,24,24,21,3,1
SBI31FMY7397569,79,28,15,13,1
SBI98CXL5992268,69,16,14,2,1
SBI27QEB3858088,21,23,15,8,1
SBI30AWJ1693702,76,22,14,8,1
SBI73OES6546885,69,19,18,1,1
SBI92IGB7651434,77,15,10,5,1
SBI53GRA8293395,93,24,13,11,1
SBI34BBH7524593,87,26,19,7,1
SBI79XIT0563043,23,21,20,1,1
SBI99BBL6528044,92,24,14,10,1
SBI95XSO7916505,61,27,17,10,1
SBI70BFE3266850,85,25,21,4,1
SBI50WSD8378233,83,25,22,3,1
SBI99RZP8215772,74,25,22,3,1
SBI53CFX7546372,22,18,13,5,1
SBI38LDR5287516,71,19,17,2,1
SBI61WKC7820411,23,24,19,5,1
SBI25DJS7872964,24,30,23,7,1
SBI83FJU0899909,18,21,14,7,1
SBI29LKJ1289026,25,23,15,8,1
SBI24JAP1255943,76,26,16,10,1
SBI27XWS6068546,98,27,23,4,1
SBI21DLT7547272,24,29,26,3,1
SBI66LHB8460103,64,33,23,10,1
SBI67POP9915602,22,28,19,9,1
SBI70MMU8566090,94,34,33,1,1
SBI19SMW6188292,70,27,19,8,1
SBI99MFM0688487,94,28,18,10,1
SBI56PTH8713341,86,18,14,4,1
SBI59ODY1093085,67,27,15,12,1
SBI30MLJ8967419,71,25,19,6,1
SBI80NDM7993135,83,14,12,2,1
SBI06JFI5597766,95,25,17,8,1
SBI56AIS7144527,72,20,17,3,1
SBI82PHU0395367,68,25,20,5,1
SBI48OHT0037680,20,27,14,13,1
SBI58LBG8154168,79,22,18,4,1
SBI90GMC5984764,91,19,13,6,1
SBI21SGB7167883,60,16,11,5,1
SBI19NDX4824739,65,28,27,1,1
SBI17ATF2184008,68,26,25,1,1
SBI95PLF1095794,96,22,17,5,1
SBI04JTH4148426,90,29,19,10,1
SBI47VJW9897626,62,31,27,4,1
SBI43PZP7710700,76,21,20,1,1
SBI34LTG4356002,99,24,15,9,1
SBI10TFU5833818,99,30,16,14,1
SBI53TIW1840053,63,19,14,5,1
SBI97JFU9323139,99,25,16,9,1
SBI97EKO0968796,73,22,18,4,1
SBI17MYE5001081,76,27,25,2,1
SBI85PUJ9894213,24,32,31,1,1
SBI66ZZH5293742,80,25,23,2,1
SBI30BQX4559390,75,26,24,2,1
SBI57ITZ4765031,77,22,18,4,1
SBI98BWX8476052,98,23,21,2,1
SBI48KEM1676902,78,29,28,1,1
SBI60TCI1231144,23,25,22,3,1
SBI16PNQ4217268,98,28,19,9,1
SBI43CMB9030421,61,16,12,4,1
SBI45CDD5342108,83,26,21,5,1
SBI82CGY4710793,90,24,21,3,1
SBI15AVU0711221,20,25,14,11,1
SBI36YDX9850482,79,26,23,3,1
SBI80PZI9833798,85,25,21,4,1
SBI45JUQ0774110,84,31,24,7,1
SBI53NWX4331758,21,23,21,2,1
SBI29XXD1101371,22,26,20,6,1
SBI40JTH7769689,78,28,16,12,1
SBI84WJF4480112,92,17,16,1,1
SBI63TRF3436523,84,30,17,13,1
SBI93LBY5984872,87,22,20,2,1
SBI36XXL0497716,18,26,19,7,1
SBI89BOJ2931515,93,31,27,4,1
SBI96UUN6295807,97,21,15,6,1
SBI70AMU8402234,76,29,24,5,1
SBI77LCR6325888,71,19,16,3,1
SBI79GBB8645623,19,18,12,6,1
SBI06HRI2550931,70,23,19,4,1
SBI41KJJ9816366,61,27,19,8,1
SBI86EET3402680,69,23,15,8,1
SBI25LND2274196,81,26,14,12,1
SBI60EHZ9797200,19,16,10,6,1
SBI21FGP9155194,85,16,12,4,1
SBI44OPK0341918,75,23,18,5,1
SBI18SJZ1184316,98,29,26,3,1
SBI23TCQ5388044,98,28,21,7,1
SBI73SIX7858747,78,22,14,8,1
SBI35KUJ7201916,22,21,15,6,1
SBI17SOS3361368,88,27,23,4,1
SBI72OCC9134604,75,17,10,7,1
SBI65NSV0849677,90,27,22,5,1
SBI87FAM5461355,96,22,12,10,1
SBI17GVM5769211,79,24,14,10,1
SBI44VEI1574507,70,23,22,1,1
SBI71MOD8806140,86,19,17,2,1
SBI89LTW2368278,80,25,16,9,1
SBI39QAG9112695,85,29,27,2,1
SBI92AHD7674931,23,20,15,5,1
SBI54QLP9242619,67,25,14,11,1
SBI14KGX0408405,18,29,26,3,1
SBI60RCW3014539,85,26,25,1,1
SBI47USH6603664,24,26,17,9,1
SBI05VAU1261542,23,26,24,2,1
SBI44UFT9486302,72,19,13,6,1
SBI11TMW6721955,19,26,20,6,1
SBI31UVC2270530,24,31,29,2,1
SBI78YSA3927656,60,25,17,8,1
SBI49AUZ2560669,68,24,14,10,1
SBI07ICG1910152,76,27,16,11,1
SBI80RQT7204567,94,28,24,4,1
SBI30TCF2906291,70,20,12,8,1
SBI73HLD1907911,68,33,31,2,1
SBI35DXP9998533,80,30,16,14,1
SBI71RFW5003111,82,17,10,7,1
SBI08HLL4134773,18,31,26,5,1
SBI65HVM8280172,65,22,18,4,1
SBI12PWM5317512,70,25,17,8,1
SBI08SKH9352132,79,23,22,1,1
SBI60IJY5170258,19,21,13,8,1
SBI15BUM7423207,61,21,11,10,1
SBI61XUP3214056,66,19,14,5,1
SBI79EWC4573604,21,33,19,14,1
SBI75TDF1403123,95,32,31,1,1
SBI00KSR6030813,94,23,22,1,1
SBI33THT5265527,63,24,22,2,1
SBI93LTX4166277,19,29,17,12,1
SBI37ZXB6327433,74,21,11,10,1
SBI71QSA1861134,71,23,20,3,1
SBI82BSH1905597,21,21,19,2,1
SBI26TYF1727918,73,36,28,8,1
SBI71EIK6968819,73,18,13,5,1
SBI66PFA9256577,73,24,15,9,1
SBI63SDR0537985,60,34,27,7,1
SBI66KBR3355779,77,31,20,11,1
SBI51QJI9495904,66,27,26,1,1
SBI42PXJ0935048,71,17,15,2,1
SBI07PFC4932032,71,22,13,9,1
SBI22ZTW5521875,74,24,17,7,1
SBI43NRF1449924,72,29,18,11,1
SBI55YSQ6906948,87,30,16,14,1
SBI71KCO4893506,77,19,15,4,1
SBI28MKN0478900,98,27,16,11,1
SBI22QOM1702224,18,24,19,5,1
SBI84FFL2945890,97,20,11,9,1
SBI33BWX1150278,90,27,23,4,1
SBI64OVO3329816,81,22,14,8,1
SBI05OCT1900511,68,23,13,10,1
SBI71INK7701889,75,27,19,8,1
SBI66EEA4314975,25,32,26,6,1
SBI72IEG4003628,74,24,22,2,1
SBI02HMZ6406461,75,22,16,6,1
SBI05AOD8919724,69,22,16,6,1
SBI27CGM3915449,95,26,17,9,1
SBI11KJD4363434,83,21,17,4,1
SBI22GHR8116381,21,27,19,8,1
SBI20LLU9906186,69,24,21,3,1
SBI96BMG3269603,99,25,20,5,1
SBI36ADD0029178,93,23,17,6,1
SBI06APD8078695,93,29,18,11,1
SBI97CRJ6884907,25,19,11,8,1
SBI94AZQ4224776,73,30,16,14,1
SBI80LDI9542474,74,30,27,3,1
SBI44XGE9859596,78,30,23,7,1
SBI00TKE8359915,88,26,21,5,1
SBI87FRR4119628,77,31,19,12,1
SBI68HPQ4164030,19,22,15,7,1
SBI87PGA7022667,88,31,23,8,1
SBI23XYQ4998740,69,23,14,9,1
SBI76HWW1202366,77,32,22,10,1
SBI32IMJ3070006,90,28,20,8,1
SBI01BZK8321590,22,26,16,10,1
SBI67DIQ4380089,24,19,12,7,1
SBI59FPE7129940,62,25,17,8,1
SBI52JUO5160896,25,27,17,10,1
SBI27JBZ5837290,62,24,19,5,1
SBI01WLL0428553,19,33,31,2,1
SBI55RBK6697850,22,33,32,1,1
SBI56LBC1784143,85,42,27,15,1
SBI63BZU3425200,98,38,36,2,1
SBI19JRA3608473,67,14,8,6,1
SBI53OTR1100101,90,26,14,12,1
SBI74QZX7717619,80,26,19,7,1
SBI46GDB2844710,81,26,15,11,1
SBI14VWX6182090,69,31,16,15,1
SBI49ZSJ8050909,75,19,17,2,1
SBI59KKD8962787,63,27,18,9,1
SBI55ZSX2457676,77,22,17,5,1
SBI23WYS7887496,70,24,15,9,1
SBI94WQO6686698,86,21,16,5,1
SBI37KCR0954070,84,25,21,4,1
SBI19KTM0695272,76,29,21,8,1
SBI91GZS4557492,91,25,15,10,1
SBI13LXS1612138,24,23,17,6,1
SBI32EYO2954244,19,25,18,7,1
SBI44OOR0800001,24,27,17,10,1
SBI03TTF7713199,60,21,12,9,1
SBI16UOH8695368,25,22,20,2,1
SBI38BHQ4446103,82,31,23,8,1
SBI58OHA5136329,22,18,10,8,1
SBI76EHG4524844,91,24,15,9,1
SBI63HHZ1359838,65,25,17,8,1
SBI81EZU7863072,24,23,19,4,1
SBI65JVP6486120,18,29,26,3,1
SBI97EGT1001540,69,25,23,2,1
SBI35ESM2313994,99,27,20,7,1
SBI63ORR1068133,83,23,14,9,1
SBI43YQK4491122,80,27,21,6,1
SBI22DYS5382966,68,24,23,1,1
SBI10LFC8569377,72,28,24,4,1
SBI34YTZ7104356,87,18,11,7,1
SBI34RWL3851241,24,34,25,9,1
SBI64HZQ7571886,86,21,14,7,1
SBI30YXG9264968,83,23,20,3,1
SBI81CXM5068004,24,19,10,9,1
SBI80KIL7080670,66,22,15,7,1
SBI20DRN6149546,62,24,14,10,1
SBI69ACP8811052,79,10,9,1,1
SBI01JWN2202726,61,28,17,11,1
SBI77LTL3290118,74,18,11,7,1
SBI19DUR7477369,77,22,20,2,1
SBI09NUV4861402,63,23,15,8,1
SBI54OKG1802832,85,15,10,5,1
SBI01NUQ5581884,82,25,18,7,1
SBI31RDW7259020,64,23,17,6,1
SBI27GMN9853479,24,22,19,3,1
SBI71LOL2643465,70,28,16,12,1
SBI29RID4238750,20,30,19,11,1
SBI16SMR5667547,20,32,17,15,1
SBI03PLD2787860,75,20,11,9,1
SBI87FVO3084064,94,35,21,14,1
SBI20LSI1629334,69,21,20,1,1
SBI06XYO1468149,70,20,19,1,1
SBI03AXV6619127,94,24,20,4,1
SBI66MNP0532294,93,29,17,12,1
SBI63ACV1281073,20,31,18,13,1
SBI63NWQ8045308,75,25,14,11,1
SBI24MYN7056455,24,33,22,11,1
SBI02ONM7661236,20,20,11,9,1
SBI90JTO9063043,63,27,17,10,1
SBI18HNL9781546,89,27,15,12,1
SBI31FTP2682414,96,25,19,6,1
SBI51SSS8272171,22,29,19,10,1
SBI78LYO5685218,61,20,13,7,1
SBI81BKI7449956,68,19,12,7,1
SBI60PIL2016959,25,20,16,4,1
SBI03QOQ2310653,62,24,23,1,1
SBI16TPO7134606,24,21,12,9,1
SBI61SQR2257106,23,26,24,2,1
SBI69QQP6254430,69,29,15,14,1
SBI07NMS6663351,77,20,17,3,1
SBI87ABV8271162,67,23,14,9,1
SBI02OKW4141318,20,27,23,4,1
SBI83TIB0288759,70,29,19,10,1
SBI79VPS1510154,67,13,9,4,1
SBI87KXP0326768,62,32,27,5,1
SBI08WFL3543415,85,35,34,1,1
SBI27UPX7789313,92,27,24,3,1
SBI18ITH8900781,66,27,26,1,1
SBI02NMM6748233,92,27,18,9,1
SBI22YOB0215160,19,21,13,8,1
SBI66WCQ3662495,24,26,25,1,1
SBI46HQX5081635,82,34,18,16,1
SBI16SEH4398921,74,26,25,1,1
SBI70KXX9959874,20,26,14,12,1
SBI44XIL9636795,97,24,15,9,1
SBI39UJD3607624,80,25,13,12,1
SBI48JUL3224986,72,26,17,9,1
SBI21CFS2439801,81,23,16,7,1
SBI20WYJ9006881,99,29,18,11,1
SBI60LEA5914419,60,28,27,1,1
SBI54RLP4653070,71,13,9,4,1
SBI84BPP8049332,77,25,21,4,1
SBI68HAV3690996,93,21,11,10,1
SBI05VKV0375193,64,27,22,5,1
SBI30EER0103397,68,28,24,4,1
SBI63POD6826768,24,31,28,3,1
SBI77PMD7259644,78,13,7,6,1
SBI96RYD7231887,74,15,9,6,1
SBI68WUD5118240,93,14,13,1,1
SBI28PAQ9842703,84,32,27,5,1
SBI07NXM5535451,21,25,24,1,1
SBI93BHS7906795,99,27,20,7,1
SBI06JUV4430723,82,28,22,6,1
SBI62QSS1724704,68,30,19,11,1
SBI00JNJ7101749,64,26,16,10,1
SBI92NDS1430522,68,22,19,3,1
SBI99DAG3915888,76,20,14,6,1
SBI96NBK1786866,90,22,13,9,1
SBI16OZW1872176,19,24,18,6,1
SBI58WCA2871699,70,29,18,11,1
SBI53OYU9427437,68,20,14,6,1
SBI87FKD4360930,21,30,29,1,1
SBI35EQY2882538,75,34,28,6,1
SBI11WON4441775,99,23,21,2,1
SBI83ETE7602539,71,24,21,3,1
SBI40HRC6360220,61,26,19,7,1
SBI30JZC4624118,60,15,8,7,1
SBI39XKS6435420,94,27,25,2,1
SBI73SUV1949425,93,22,12,10,1
SBI60EET2582846,99,20,11,9,1
SBI09XAN4469715,25,32,17,15,1
SBI47JXF2171948,87,15,14,1,1
SBI45KPY9057267,87,19,16,3,1
SBI67RPJ0888813,25,29,26,3,1
SBI23OWJ1410867,84,23,19,4,1
SBI46UWG5615920,23,29,27,2,1
SBI18ZSJ9347895,75,33,18,15,1
SBI74BTE8635641,69,28,23,5,1
SBI54WYK1943976,92,36,34,2,1
SBI55RCF1303983,98,20,14,6,1
SBI01TCM5546409,85,25,14,11,1
SBI06WID9845242,82,19,11,8,1
SBI59IPG7784524,18,19,18,1,1
SBI04WKS9230191,79,32,30,2,1
SBI68BTD8126349,66,24,13,11,1
SBI68MKI1471361,95,26,15,11,1
SBI60ZWN0970125,99,26,20,6,1
SBI51KPW5152285,18,32,24,8,1
SBI66LDC0368267,70,23,16,7,1
SBI84XFL2427296,92,26,23,3,1
SBI89NLK6845151,79,25,22,3,1
SBI81OXS1795287,98,27,21,6,1
SBI64PWX0763684,68,23,14,9,1
SBI05VVF9829260,71,19,13,6,1
SBI37VSR0356172,20,25,21,4,1
SBI58TAF1663442,67,23,22,1,1
SBI54BCS1137007,68,23,16,7,1
SBI73JMU1011238,71,17,14,3,1
SBI93DIC6147949,18,20,12,8,1
SBI13UCY7393385,76,19,12,7,1
SBI93RKD6459909,94,31,16,15,1
SBI00YZF6013733,97,39,20,19,1
SBI34OOL4999611,71,23,20,3,1
SBI88LUH6248565,82,22,17,5,1
SBI61SFD0783178,21,32,24,8,1
SBI73RCY1421927,82,24,16,8,1
SBI30VMC0729890,90,25,19,6,1
SBI63XSD8449274,74,31,18,13,1
SBI08ZAQ7751394,98,15,9,6,1
SBI92LSF4502560,22,22,14,8,1
SBI09ZIL5099369,92,29,28,1,1
SBI84SXF9011960,95,25,20,5,1
SBI17RWC4562247,67,20,11,9,1
SBI39DRC9597499,23,29,17,12,1
SBI86ZXG9508435,22,23,14,9,1
SBI49TNC3299928,77,20,13,7,1
SBI45DOQ3161341,24,26,20,6,1
SBI89EHX5668479,61,19,15,4,1
SBI10LQG0645013,64,13,7,6,1
SBI80PMR0778620,71,30,20,10,1
SBI26DPI2419025,20,21,17,4,1
SBI75FWU5513004,90,19,14,5,1
SBI18YVT6159938,93,23,22,1,1
SBI58IQP4303052,25,22,12,10,1
SBI54FPL2785233,75,25,18,7,1
SBI60GVZ3187926,90,20,12,8,1
SBI26CIF7980837,97,30,25,5,1
SBI30HFX0280773,67,23,15,8,1
SBI92TES1487865,93,21,17,4,1
SBI71RUX6592378,71,22,16,6,1
SBI65PFP7279819,81,16,15,1,1
SBI21YBC3383820,95,34,32,2,1
SBI06ECT9405358,65,27,20,7,1
SBI16XGN6832489,20,30,26,4,1
SBI08RVG9908285,74,17,10,7,1
SBI18URZ4656065,80,25,15,10,1
SBI41NDT6201552,67,21,14,7,1
SBI55KAJ2424904,71,23,19,4,1
SBI66XXR0483809,19,21,17,4,1
SBI84DXZ7988286,79,21,13,8,1
SBI16ENM2453356,74,25,14,11,1
SBI77AGK0286328,65,24,16,8,1
SBI43FGU7542953,83,23,18,5,1
SBI15NGZ4366927,92,30,28,2,1
SBI78GKN0818631,96,22,15,7,1
SBI12XCY5316860,70,22,16,6,1
SBI16EQQ9513737,74,25,18,7,1
SBI55IPA3526361,96,28,22,6,1
SBI07NTF7648533,66,18,15,3,1
SBI93NTF6842590,84,27,21,6,1
SBI24ZJS8163683,24,28,24,4,1
SBI43JFV4162077,24,25,20,5,1
SBI43FHE7344527,20,17,16,1,1
SBI52KGC9851469,71,17,9,8,1
SBI61YLU4882987,89,20,13,7,1
SBI75QNB0290366,22,29,26,3,1
SBI22IUI7892077,94,26,19,7,1
SBI81BBC0447533,19,29,22,7,1
SBI09BDF7341062,69,15,8,7,1
SBI13LDM1388219,82,16,11,5,1
SBI58HUU7697143,73,19,16,3,1
SBI62EZO7492880,67,18,11,7,1
SBI18ISY6129061,98,24,19,5,1
SBI01APQ6037008,23,25,17,8,1
SBI41GDN3259507,71,27,19,8,1
SBI15BZH4618288,68,18,15,3,1
SBI28FCH8584115,90,19,15,4,1
SBI87WEK7843721,65,23,21,2,1
SBI54GJW5602708,64,24,13,11,1
SBI63GMW0229838,92,30,17,13,1
SBI74JFQ3704383,62,29,23,6,1
SBI70OCK0554963,89,25,19,6,1
SBI30VTV2911970,61,28,18,10,1
SBI88JCH6640140,80,28,26,2,1
SBI41OGY7188642,20,35,20,15,1
SBI29SPE2526617,90,22,20,2,1
SBI89QSG9310246,65,20,17,3,1
SBI84KLD0776244,71,27,22,5,1
SBI39CDV3313113,66,23,19,4,1
SBI19FHO4441416,73,25,13,12,1
SBI07UWM9293424,92,19,12,7,1
SBI49DIS1459657,81,27,26,1,1
SBI78ERY1630150,80,25,20,5,1
SBI91YLH6675742,93,25,15,10,1
SBI40UDJ8663795,23,17,14,3,1
SBI48PWD2102199,77,24,17,7,1
SBI05DEM7649209,88,23,21,2,1
SBI59NBT0050843,84,30,25,5,1
SBI34QCC0719882,66,31,18,13,1
SBI97XUM6532908,65,20,19,1,1
SBI92FZQ4400881,95,30,29,1,1
SBI70LAO3202946,98,30,26,4,1
SBI69OJQ0354545,93,20,19,1,1
SBI15ABR6957879,97,21,19,2,1
SBI98KQH2697808,20,17,9,8,1
SBI03SMS6438713,72,18,14,4,1
SBI44HFG7375744,24,31,23,8,1
SBI09EPD5167786,24,30,28,2,1
SBI15CZS8149039,84,20,12,8,1
SBI93CZG9483406,60,33,19,14,1
SBI06DKR6594503,94,33,17,16,1
SBI35KPX7127363,87,28,17,11,1
SBI86JWH6147437,62,30,28,2,1
SBI30AQH4286971,94,32,28,4,1
SBI48KYR1277318,69,29,27,2,1
SBI99MGL8076173,74,35,34,1,1
SBI15MIJ0958081,19,19,16,3,1
SBI58OFE3256942,79,26,17,9,1
SBI93IAT5970444,97,30,17,13,1
SBI38DQU1901166,90,36,26,10,1
SBI85EQM8517715,88,23,15,8,1
SBI96PUM7544207,99,28,18,10,1
SBI52XYC4438639,88,27,21,6,1
SBI74OST1986571,67,30,27,3,1
SBI62XME0223281,97,22,15,7,1
SBI04WWH4371244,94,27,15,12,1
SBI29NSC4429420,90,25,16,9,1
SBI13FZQ4459955,72,15,14,1,1
SBI44ANM3680256,97,27,14,13,1
SBI95DMU4771218,73,24,23,1,1
SBI33DLP5251590,82,28,21,7,1
SBI02TLS0484581,62,17,13,4,1
SBI13XGW1194686,22,32,18,14,1
SBI07MIM7568484,85,27,25,2,1
SBI33MGD9090602,22,26,19,7,1
SBI75BFV0874772,18,24,13,11,1
SBI12CSD9104115,89,28,16,12,1
SBI32SGE2608447,89,16,11,5,1
SBI70LAK8793143,73,31,19,12,1
SBI92HSP3654424,74,19,18,1,1
SBI91ZBQ6808117,61,23,19,4,1
SBI09QKA4521161,85,26,25,1,1
SBI77YES2487139,67,27,15,12,1
SBI82MPQ3674191,87,21,19,2,1
SBI33HSC4528698,94,28,17,11,1
SBI91JAK0531943,77,25,18,7,1
SBI57RGW3661714,77,23,18,5,1
SBI26AGP7961308,60,29,22,7,1
SBI06SQX4584834,75,26,21,5,1
SBI31BTZ9449261,72,32,26,6,1
SBI29NWT5591695,80,22,17,5,1
SBI60ECS6922508,69,19,17,2,1
SBI70TNN7841223,72,25,22,3,1
SBI40IJJ9817784,25,25,23,2,1
SBI69DPP1177922,78,27,21,6,1
SBI90SYE2308291,83,8,5,3,1
SBI51TQC0045799,61,23,13,10,1
SBI38SLX5535164,75,24,20,4,1
SBI67SQA8550911,90,25,18,7,1
SBI75BBZ2696887,68,28,20,8,1
SBI62NWA9850266,19,32,18,14,1
SBI16III8343092,63,18,14,4,1
SBI96TLS2348566,87,20,18,2,1
SBI88SRN1238108,79,28,16,12,1
SBI66WEW8456477,79,19,15,4,1
SBI43WCM4741365,80,25,16,9,1
SBI33XLX2159446,65,28,22,6,1
SBI89FFO3688911,79,29,16,13,1
SBI45QSP7027660,64,23,22,1,1
SBI49FMA1372874,66,22,15,7,1
SBI02GFY4047971,80,23,13,10,1
SBI20TIL3387327,98,33,28,5,1
SBI84UCZ5514755,99,26,23,3,1
SBI94VZH9788049,60,22,21,1,1
SBI04OFC0077910,19,24,16,8,1
SBI62RLY0054539,23,25,14,11,1
SBI03NSN7229049,84,28,24,4,1
SBI99FYH5973534,88,15,8,7,1
SBI10QWW5960037,62,26,24,2,1
SBI37KPE8935874,87,35,23,12,1
SBI89SCN5233503,20,32,24,8,1
SBI35AUE3771304,93,20,18,2,1
SBI63NHL4906576,99,20,18,2,1
SBI36TII9581202,80,18,14,4,1
SBI28VCZ6848781,86,30,24,6,1
SBI25VAZ3545736,65,22,19,3,1
SBI70ZDO7088247,81,25,15,10,1
SBI32FGJ4614037,25,22,13,9,1
SBI25OFC1287948,21,22,15,7,1
SBI55ORL1557956,96,25,16,9,1
SBI81JEG5524847,87,21,13,8,1
SBI15MPL5546587,21,31,18,13,1
SBI76GJD4693513,25,19,16,3,1
SBI25BNR5969279,24,39,35,4,1
SBI07ZXU8059784,97,25,17,8,1
SBI97TWM1226105,92,30,19,11,1
SBI06GHZ1349000,25,22,18,4,1
SBI26FGL6753388,88,32,21,11,1
SBI80CHX7243180,62,23,22,1,1
SBI75JUT1554640,77,24,19,5,1
SBI30XJO8459788,19,25,18,7,1
SBI28WMD4541465,94,36,27,9,1
SBI78NCC7205509,75,26,14,12,1
SBI30XNO0782222,94,28,25,3,1
SBI18XCR3685963,60,30,21,9,1
SBI24QKM8094707,94,17,14,3,1
SBI91WKC8751801,76,31,28,3,1
SBI28PMC2386268,95,22,17,5,1
SBI87YPO8207313,18,21,19,2,1
SBI57KTG3692143,61,26,21,5,1
SBI13GQE9161829,71,25,18,7,1
SBI90HJX8197727,63,23,16,7,1
SBI49BZB5221444,75,35,29,6,1
SBI97HLO6089582,78,16,14,2,1
SBI58ITP7090482,80,22,15,7,1
SBI16YBX2457762,22,18,10,8,1
SBI20UXZ7432667,83,29,28,1,1
SBI67TKD7354450,93,22,21,1,1
SBI01BIY5793088,80,26,18,8,1
SBI34VJK5795876,19,30,29,1,1
SBI05BSR6228499,77,25,20,5,1
SBI31DMS9130834,67,24,15,9,1
SBI43DAZ8841996,63,29,28,1,1
SBI44JIX4093440,69,25,24,1,1
SBI90MGY7196581,93,18,16,2,1
SBI07HXD8079632,20,23,16,7,1
SBI11MMH0504954,68,18,11,7,1
SBI62ZVV0415661,89,23,14,9,1
SBI09LVL5530449,88,29,17,12,1
SBI48MXG4499135,79,28,23,5,1
SBI94NHH0499605,24,21,15,6,1
SBI32PZS5964187,19,27,15,12,1
SBI81ESZ6619368,21,26,24,2,1
SBI16VUY6179629,72,35,33,2,1
SBI55PEU2646492,61,22,13,9,1
SBI86OQU8206802,86,25,14,11,1
SBI20TQO6298489,83,30,28,2,1
SBI20TTJ5601106,98,29,24,5,1
SBI68CHZ9214806,99,30,26,4,1
SBI89KGW1526934,93,19,16,3,1
SBI57AAR7465567,21,27,16,11,1
SBI21IRV5422889,60,18,11,7,1
SBI90ITH4824404,72,25,19,6,1
SBI90IOI8216978,93,39,33,6,1
SBI70ECK2494115,22,30,26,4,1
SBI25JBB6754596,66,27,16,11,1
SBI34JTJ2408287,95,25,16,9,1
SBI91VJB5888919,73,20,17,3,1
SBI00DJT5189500,99,24,23,1,1
SBI02MUP1837784,97,20,15,5,1
SBI33ZRG2139978,93,21,17,4,1
SBI89GDK3773164,74,19,15,4,1
SBI70CHO3107528,73,17,13,4,1
SBI18DYN0319946,96,23,20,3,1
SBI12BBB8935815,99,32,24,8,1
SBI47LTD5207181,93,19,16,3,1
SBI29DKL9340517,84,30,22,8,1
SBI00LCQ3123163,94,29,27,2,1
SBI51NHT9265497,65,29,15,14,1
SBI50XRF7633071,72,23,22,1,1
SBI29FCO9407597,97,17,13,4,1
SBI83NKE7081245,18,24,15,9,1
SBI33NFZ8977668,91,27,18,9,1
SBI93PSX5022684,81,21,16,5,1
SBI27WIO2661014,72,23,20,3,1
SBI08OAO8526246,72,28,16,12,1
SBI84FVH7329719,97,15,9,6,1
SBI61WBX0377980,74,33,28,5,1
SBI73KSJ1256473,64,26,19,7,1
SBI25FLY6172295,67,18,16,2,1
SBI45XQO7601930,72,25,16,9,1
SBI36JKF9227792,73,26,25,1,1
SBI96UQL7762897,74,33,24,9,1
SBI48NYR5387054,22,26,15,11,1
SBI90CMN9248962,71,24,15,9,1
SBI31LBU2160065,71,19,13,6,1
SBI51COA3112085,61,26,24,2,1
SBI32EOY9885972,89,15,10,5,1
SBI07VMS9181622,72,21,17,4,1
SBI47QFJ1140557,68,21,14,7,1
SBI21UZC5160861,99,19,17,2,1
SBI73OHD5018636,22,27,20,7,1
SBI88YNV4638338,19,23,12,11,1
SBI64MQT5838466,25,30,16,14,1
SBI93COW5093200,80,27,19,8,1
SBI42CER8289350,23,25,13,12,1
SBI05BTF1827737,21,24,21,3,1
SBI18KQT3975795,22,20,18,2,1
SBI68TOA9079006,89,28,22,6,1
SBI90CGA8758037,79,23,13,10,1
SBI33YTR5799872,94,20,11,9,1
SBI43ISM0742117,94,30,23,7,1
SBI15OWI0896504,23,12,11,1,1
SBI53YPG6619912,67,24,16,8,1
SBI38SZT6424339,85,26,21,5,1
SBI01FMH3357431,74,32,23,9,1
SBI18RUK7501568,23,26,23,3,1
SBI71DYU8111420,87,24,18,6,1
SBI89WKI6007813,62,24,22,2,1
SBI67BHW0264270,80,24,19,5,1
SBI20DKP8482855,77,27,14,13,1
SBI75OMA1926355,74,32,23,9,1
SBI12MNP0047441,77,27,24,3,1
SBI50XDD6403935,83,32,31,1,1
SBI48WTD3420539,23,30,17,13,1
SBI53RDQ1594569,18,29,19,10,1
SBI05PDM0950116,18,27,16,11,1
SBI23JXA9492428,83,19,12,7,1
SBI55EEI9382810,23,24,17,7,1
SBI05YAK1594081,98,27,19,8,1
SBI70RPS9353721,85,28,25,3,1
SBI58JDJ7660033,64,23,14,9,1
SBI32PZS7362121,88,26,16,10,1
SBI85NZP6631256,71,44,40,4,1
SBI99ROQ6917637,22,26,25,1,1
SBI75EZZ6192411,70,31,25,6,1
SBI48WRD7944338,65,11,9,2,1
SBI82FPP9813493,73,26,20,6,1
SBI55FRV3303000,60,24,23,1,1
SBI06IDM9240451,76,28,18,10,1
SBI49PPS7487521,19,23,17,6,1
SBI65CQT4623558,86,30,21,9,1
SBI64NAF4041702,76,18,10,8,1
SBI91QJQ7330315,60,22,17,5,1
SBI31EYV0385140,76,36,22,14,1
SBI82OLE7991117,65,24,16,8,1
SBI58XOO0695487,73,32,26,6,1
SBI76HKE5951197,95,24,15,9,1
SBI20ZKS8986931,78,17,10,7,1
SBI15QXA5651385,90,32,20,12,1
SBI05VLB5253710,92,24,19,5,1
SBI56SJS0840129,65,27,19,8,1
SBI23COE0851518,81,25,18,7,1
SBI58SLR0321845,94,23,20,3,1
SBI12EBO8697233,20,23,15,8,1
SBI17DRR3273776,63,27,14,13,1
SBI76RZI5355154,22,29,18,11,1
SBI99OZJ1483409,79,30,24,6,1
SBI26RXK0982095,61,22,18,4,1
SBI16XEL7475932,90,25,20,5,1
SBI73XYO2464089,77,21,13,8,1
SBI99GIG9078829,98,27,22,5,1
SBI07SVV9674274,81,23,16,7,1
SBI06NMY0089818,20,25,18,7,1
SBI02VYJ6573590,98,18,11,7,1
SBI99VYO7028787,70,18,10,8,1
SBI03UYE2384887,62,16,9,7,1
SBI05BTO0764840,79,10,6,4,1
SBI10UIJ3249452,70,30,16,14,1
SBI26UHT7441166,66,29,24,5,1
SBI14BPT2317680,98,27,16,11,1
SBI25PAU8722609,70,28,21,7,1
SBI45PKG4500111,23,18,12,6,1
SBI40NKJ4235102,61,24,15,9,1
SBI40HOJ2952754,76,26,23,3,1
SBI03ACD5650402,73,26,15,11,1
SBI15YAA6701126,80,25,22,3,1
SBI53OYX3632487,90,19,18,1,1
SBI52QHB4587289,21,27,20,7,1
SBI62DAO2885276,23,25,13,12,1
SBI30NOW6365527,20,27,14,13,1
SBI34TMW2111319,22,22,17,5,1
SBI81AYL3428542,64,9,7,2,1
SBI45CPL3057772,62,31,27,4,1
SBI47XGB0659192,21,18,10,8,1
SBI07CFW3119423,99,24,20,4,1
SBI55WPF4617216,19,28,18,10,1
SBI30IKC6971992,78,24,23,1,1
SBI20XQZ3596112,97,32,29,3,1
SBI36IJO8653093,62,27,20,7,1
SBI94PCN5799074,19,19,16,3,1
SBI60GMP2577742,24,27,21,6,1
SBI42UNV4314773,98,19,10,9,1
SBI89VBK6297588,77,18,11,7,1
SBI90HPY4545689,91,31,25,6,1
SBI43VYA0174848,78,28,27,1,1
SBI01BFN4689630,60,18,15,3,1
SBI08DLC3288117,99,23,12,11,1
SBI35TGM9976860,24,31,18,13,1
SBI08GWC1363873,86,22,17,5,1
SBI22VDI1981345,24,25,17,8,1
SBI83ICS8259543,19,19,14,5,1
SBI87LYZ0335307,68,27,26,1,1
SBI16YXO5775107,92,24,14,10,1
SBI39OTZ7158596,85,10,9,1,1
SBI57ZPU3741642,68,29,21,8,1
SBI99AIH5264772,72,19,18,1,1
SBI55ZRG4352396,96,18,15,3,1
SBI81XYB4687727,69,22,14,8,1
SBI31HMH9909489,99,36,24,12,1
SBI68EUJ7587954,70,24,15,9,1
SBI74QJN8919027,90,29,22,7,1
SBI48JQH4870707,87,30,23,7,1
SBI96ADL9760431,84,21,19,2,1
SBI62ZNB3219097,22,18,17,1,1
SBI28QSM9877129,60,27,16,11,1
SBI55RYR7282503,21,31,20,11,1
SBI22QFC6150629,72,18,16,2,1
SBI58MTG8851498,85,28,26,2,1
SBI50YCT9918150,91,14,13,1,1
SBI63CSX9993737,19,24,13,11,1
SBI55LMV6963806,90,28,15,13,1
SBI39RAW7730308,22,30,24,6,1
SBI93CFF9857343,60,23,22,1,1
SBI98FWW8587152,72,20,11,9,1
SBI14CKU6272250,94,30,23,7,1
SBI92RLX0996860,79,23,22,1,1
SBI12EBC1701887,21,23,17,6,1
SBI76DQZ3029635,79,25,19,6,1
SBI67XKY2896524,78,27,21,6,1
SBI44SBL8306469,81,15,10,5,1
SBI79EQL6513076,25,25,16,9,1
SBI58VIT3271936,99,24,19,5,1
SBI61UBR6052053,64,25,13,12,1
SBI99YTD6007292,66,23,13,10,1
SBI19AOS1587827,21,25,14,11,1
SBI52OSF0140595,62,24,15,9,1
SBI86VNC7868082,21,20,19,1,1
SBI39DPB4749456,78,24,15,9,1
SBI91WQO0193526,71,26,18,8,1
SBI26IBB5021133,19,22,19,3,1
SBI87YKM0722805,98,18,12,6,1
SBI76BMY9604091,74,17,12,5,1
SBI11YRK5264597,94,30,22,8,1
SBI39HZF6245091,86,36,23,13,1
SBI04REX7102255,83,24,20,4,1
SBI88ADK1967026,81,30,19,11,1
SBI87AWO8543549,78,20,14,6,1
SBI26BWQ6553392,60,27,26,1,1
SBI42RBM3791888,67,22,21,1,1
SBI59PEQ1611213,71,21,19,2,1
SBI83WGM3123838,78,26,22,4,1
SBI36OTV8584795,71,23,18,5,1
SBI97YZV4126420,71,28,17,11,1
SBI63EBB7178245,75,15,13,2,1
SBI00UXK6394246,22,21,13,8,1
SBI15IDU9507953,74,20,14,6,1
SBI32WNR1631457,70,17,13,4,1
SBI68SRC1390517,82,28,21,7,1
SBI79QFQ4025992,21,28,18,10,1
SBI59VQF6416330,81,21,18,3,1
SBI27VBR6121307,76,29,23,6,1
SBI18BIZ9617940,70,19,15,4,1
SBI20ZHC4844038,22,29,20,9,1
SBI51PCU5839806,85,17,13,4,1
SBI80EOX5920086,80,25,17,8,1
SBI82RQL2691651,63,32,18,14,1
SBI49XMQ7251844,88,20,19,1,1
SBI70ZAK7189041,73,22,13,9,1
SBI17PSM1763258,96,22,14,8,1
SBI78YKS5403511,60,25,19,6,1
SBI87XXT1175262,85,24,18,6,1
SBI99FXP1157674,96,26,25,1,1
SBI17RPK9094311,82,30,18,12,1
SBI42MDD5435278,63,24,13,11,1
SBI15EUE0747393,61,16,13,3,1
SBI07RFF6538749,75,22,14,8,1
SBI51BCL2658379,95,23,14,9,1
SBI45GZK7751935,84,27,25,2,1
SBI76FIH8273437,18,29,19,10,1
SBI95BBH6924964,68,26,16,10,1
SBI70MXN2299195,24,20,14,6,1
SBI46TEL3555282,95,19,10,9,1
SBI67CJJ8191929,80,23,21,2,1
SBI65HCX2685653,69,26,17,9,1
SBI69DBM1989062,81,28,15,13,1
SBI30ZYD7220886,76,33,24,9,1
SBI50ONB3394692,24,27,21,6,1
SBI47GBH7092558,74,25,19,6,1
SBI74PXZ3831022,75,19,12,7,1
SBI44ZNF7042778,67,14,8,6,1
SBI14QNP9841963,19,28,23,5,1
SBI86JRS4358934,86,24,21,3,1
SBI78MAP9024219,25,28,15,13,1
SBI00NTL5815738,20,31,17,14,1
SBI08LSG8231974,22,24,14,10,1
SBI48BSU7694934,77,31,27,4,1
SBI34BNH7371302,68,25,21,4,1
SBI52PMG8784179,98,24,20,4,1
SBI96ACV3917405,95,11,6,5,1
SBI41ZGB9629562,95,23,16,7,1
SBI36VQO8205230,96,17,16,1,1
SBI29YCG3112805,68,27,18,9,1
SBI43GTX4745840,68,28,19,9,1
SBI50UKB4519125,62,19,18,1,1
SBI37BVJ0477426,65,29,22,7,1
SBI05UFN3283028,90,23,15,8,1
SBI79GRC3384696,67,30,22,8,1
SBI11IRJ0299516,79,27,14,13,1
SBI83QTZ2937887,93,26,24,2,1
SBI84ICP4159170,66,29,17,12,1
SBI90TCQ6565568,78,24,15,9,1
SBI03TGQ0090337,99,25,23,2,1
SBI07ZVH3930462,93,23,15,8,1
SBI28ZMN0613873,64,35,18,17,1
SBI71WAO0093336,90,19,17,2,1
SBI70LAF3018008,68,24,15,9,1
SBI00MCN0260393,24,21,20,1,1
SBI12XRQ6712824,23,26,20,6,1
SBI99LDP9309090,18,30,20,10,1
SBI40UFJ0884172,21,17,9,8,1
SBI09SHJ6393923,83,21,16,5,1
SBI94NQH0867257,61,24,17,7,1
SBI85ZGS6563424,72,17,12,5,1
SBI06IIU8471959,20,25,15,10,1
SBI73ZDX1181266,60,16,15,1,1
SBI40AQL5786034,97,23,22,1,1
SBI99ANI9627114,88,31,21,10,1
SBI26MPQ0122118,73,23,18,5,1
SBI23UGL2903058,78,27,14,13,1
SBI68IXZ8392507,61,21,15,6,1
SBI84KSH9036087,66,24,13,11,1
SBI79XDD9194384,87,24,23,1,1
SBI70YQS9896643,19,27,21,6,1
SBI66MBI0951847,76,31,19,12,1
SBI29CLN0108561,71,21,16,5,1
SBI40WLG2618882,93,15,11,4,1
SBI47HEF4405291,22,22,12,10,1
SBI00ATY0159041,67,24,19,5,1
SBI05JLT4843588,87,33,25,8,1
SBI64OOG7774092,66,29,27,2,1
SBI47ECE2064247,63,29,28,1,1
SBI12JXU5430918,96,24,20,4,1
SBI63NCJ1643923,83,26,18,8,1
SBI06XNU5154635,25,31,27,4,1
SBI36SMG6026693,21,25,21,4,1
SBI42HEB5804819,82,27,16,11,1
SBI23XOO8058708,90,26,25,1,1
SBI03TXN7086679,63,27,14,13,1
SBI80VGP8352530,83,29,22,7,1
SBI53RBP6447721,20,19,18,1,1
SBI47PIZ0765791,79,23,15,8,1
SBI95ZTE6808073,25,22,19,3,1
SBI96VVK1630874,19,19,17,2,1
SBI48FAG4616089,67,30,20,10,1
SBI74HQA2470750,75,25,22,3,1
SBI37YOF5158335,65,20,17,3,1
SBI05JSB6164417,60,18,12,6,1
SBI04DRU1644185,70,18,10,8,1
SBI11EQH3482937,64,36,31,5,1
SBI26GDJ9115289,99,25,19,6,1
SBI53CGQ0454176,62,25,14,11,1
SBI97FBC5055854,72,13,10,3,1
SBI54GAY8283656,18,26,19,7,1
SBI87NMN5357990,61,35,31,4,1
SBI31BLH2291847,21,24,15,9,1
SBI38JAJ5700303,89,30,25,5,1
SBI97PCH5618887,78,12,9,3,1
SBI71GCQ5544711,93,22,17,5,1
SBI25XCI2475390,64,33,31,2,1
SBI62GPW8235803,65,30,26,4,1
SBI36FYP9449916,78,37,22,15,1
SBI28WAB3727389,68,28,20,8,1
SBI89CID5695678,88,12,11,1,1
SBI50ZPL7634690,97,29,28,1,1
SBI19XLO4476733,85,32,23,9,1
SBI94XAJ7644677,71,24,14,10,1
SBI60ZEZ1986717,70,22,20,2,1
SBI28EGI9618982,86,28,22,6,1
SBI62FHM7525141,92,27,15,12,1
SBI38QWV2997762,71,25,19,6,1
SBI14LHN8860569,91,24,21,3,1
SBI17AVI3446434,65,15,9,6,1
SBI56XEE7317071,69,23,17,6,1
SBI77PSC8708786,72,21,12,9,1
SBI52DUH6991140,86,16,9,7,1
SBI49JWH0909559,80,22,20,2,1
SBI36PKM7326930,73,32,28,4,1
SBI58ZQQ8563082,66,30,21,9,1
SBI69JDC9344595,93,25,20,5,1
SBI96JXJ4534531,72,12,7,5,1
SBI01JPX4083740,88,29,20,9,1
SBI36MVW4233433,21,22,16,6,1
SBI28QUM0274251,63,16,12,4,1
SBI24YKQ8258871,79,25,22,3,1
SBI11FRQ3797983,60,21,16,5,1
SBI04TZB6762992,73,21,18,3,1
SBI68NEN2533185,24,21,18,3,1
SBI65XSF7930418,61,21,20,1,1
SBI72BVY6510665,64,12,7,5,1
SBI26OYM1073467,60,18,16,2,1
SBI51XRP7533472,81,22,18,4,1
SBI28VEW0052418,78,26,17,9,1
SBI74ETT4274835,61,27,16,11,1
SBI27DAN0142232,18,18,17,1,1
SBI81TBA3015011,81,21,12,9,1
SBI06LBI3164186,97,29,23,6,1
SBI79QGX4719162,82,22,17,5,1
SBI78XIF7866590,69,30,21,9,1
SBI63NRX3387413,83,30,23,7,1
SBI64UXB6938984,89,26,22,4,1
SBI28ZVL1757463,78,25,15,10,1
SBI05JQA6019631,23,24,23,1,1
SBI12GIV9868919,19,26,18,8,1
SBI19VHO7669534,93,21,18,3,1
SBI02FLR9742718,91,28,16,12,1
SBI02KWC6262420,70,28,21,7,1
SBI12VPN8435160,68,21,15,6,1
SBI15RAB2438364,67,27,17,10,1
SBI66XTA6850744,24,15,13,2,1
SBI02IPV3663651,89,28,15,13,1
SBI39EEX1748588,74,25,23,2,1
SBI34REI6132546,92,26,25,1,1
SBI60RDS6126778,97,27,26,1,1
SBI21JVX6017848,70,21,19,2,1
SBI27NPC4879440,61,26,23,3,1
SBI47JZM0237492,23,26,18,8,1
SBI21GWU3995352,78,27,26,1,1
SBI94SNI8065756,66,26,24,2,1
SBI06QMP8645609,84,28,17,11,1
SBI32KIE1029937,23,18,16,2,1
SBI00REY8987457,22,16,15,1,1
SBI41BDZ5744193,95,29,17,12,1
SBI99MMI7810285,79,19,10,9,1
SBI98AMV8812187,85,28,23,5,1
SBI37YOI7868364,99,17,9,8,1
SBI34LRM0576924,76,29,15,14,1
SBI38QDO9929080,87,25,20,5,1
SBI12SCF6675180,83,26,23,3,1
SBI92PGH9673880,77,29,18,11,1
SBI85MRB6758463,21,30,25,5,1
SBI07GGI7831108,62,18,12,6,1
SBI84WJP8617796,24,20,16,4,1
SBI74OUJ2722110,97,19,13,6,1
SBI96NDR4679222,91,26,24,2,1
SBI47XTO8271961,83,29,26,3,1
SBI15SNQ1609103,93,19,10,9,1
SBI61SDK2342228,65,23,22,1,1
SBI61NMW2167790,20,26,25,1,1
SBI57TPW7326773,88,20,11,9,1
SBI42YLO4217342,97,14,11,3,1
SBI35JYG2626239,63,30,18,12,1
SBI31LKG3267963,62,23,16,7,1
SBI83SEP8359797,85,21,15,6,1
SBI98GAS2448147,63,19,16,3,1
SBI53WHX7815252,92,28,26,2,1
SBI76VKU6621737,93,23,20,3,1
SBI90BVZ1322312,70,21,20,1,1
SBI04AFG4388354,81,35,26,9,1
SBI71FIM1434179,72,24,14,10,1
SBI52OGJ7062264,73,28,27,1,1
SBI20VTH6483392,87,22,14,8,1
SBI65PEG4185681,85,24,20,4,1
SBI91UTB0308502,87,22,20,2,1
SBI80AMQ2710835,64,26,22,4,1
SBI73SCY7885967,79,27,14,13,1
SBI27DDI4132279,96,23,13,10,1
SBI52NUG7754583,24,24,18,6,1
SBI26SZQ5236672,92,26,25,1,1
SBI90KCU0483965,81,30,17,13,1
SBI53HZP9730279,72,25,18,7,1
SBI40UCP6128682,86,30,26,4,1
SBI94SKC9194178,74,22,13,9,1
SBI72MZU8000840,66,25,14,11,1
SBI27FAS8741515,23,30,28,2,1
SBI35YCH9109244,66,26,23,3,1
SBI83MZB8863768,93,26,20,6,1
SBI84AYK4061524,74,29,25,4,1
SBI73PQI1954186,90,24,17,7,1
SBI20YDF3138938,82,23,14,9,1
SBI80GXT6786127,62,19,11,8,1
SBI20XJE1199550,74,23,14,9,1
SBI04OFT0378610,22,23,13,10,1
SBI75XJT3180637,23,21,13,8,1
SBI15CCD0690805,71,21,16,5,1
SBI43NCX4738404,65,29,15,14,1
SBI81JBG8177419,25,20,14,6,1
SBI49BTQ0183585,72,25,19,6,1
SBI31YLA9775239,68,25,22,3,1
SBI07AZS5838858,77,25,19,6,1
SBI87AXV2109590,91,29,19,10,1
SBI07ZDB4225989,99,20,16,4,1
SBI68FXM6487919,92,32,23,9,1
SBI07HFS3624645,81,22,13,9,1
SBI98EWV8451576,23,19,16,3,1
SBI97ZYT6219952,71,29,26,3,1
SBI50IWC4147959,98,25,23,2,1
SBI54QRR3303722,89,28,17,11,1
SBI11IRU5417088,74,31,28,3,1
SBI57JOY8887135,76,25,14,11,1
SBI99PFF2883336,24,29,23,6,1
SBI19LNZ6768842,84,31,20,11,1
SBI96TZG3861332,22,25,21,4,1
SBI45ZIA3470233,67,25,23,2,1
SBI72MAW9367259,60,20,19,1,1
SBI87HUX1607351,75,28,20,8,1
SBI21MRL5149041,25,22,16,6,1
SBI48KKW3943892,70,28,19,9,1
SBI91VWJ3506528,82,21,15,6,1
SBI67OWX2089326,99,20,14,6,1
SBI55LRH2770698,68,35,34,1,1
SBI25CFS2943350,92,25,16,9,1
SBI22JXI0924903,63,27,24,3,1
SBI05UUI8540123,63,28,27,1,1
SBI56KOJ7652945,90,15,13,2,1
SBI22TSD6994611,92,22,14,8,1
SBI15YKI1146421,19,30,28,2,1
SBI00KFP0827567,98,29,18,11,1
SBI23UZZ1358576,80,25,16,9,1
SBI57AVO2130518,60,23,14,9,1
SBI42LWQ6949673,84,22,18,4,1
SBI04UJE0982141,70,32,19,13,1
SBI33QHI2707037,20,25,14,11,1
SBI34PZG1677992,94,24,17,7,1
SBI26MLN7181157,63,28,15,13,1
SBI95ZIV1080488,63,25,23,2,1
SBI87RLW2029420,95,32,22,10,1
SBI38RNK0119527,79,17,11,6,1
SBI84VEJ5987340,20,27,17,10,1
SBI20VNS0399447,85,30,19,11,1
SBI81SWN0002045,18,24,19,5,1
SBI72IML8612554,85,32,24,8,1
SBI46SBK0673783,79,21,14,7,1
SBI31BCL1968997,67,22,16,6,1
SBI25VLC8120726,82,19,18,1,1
SBI74HND8615423,92,27,14,13,1
SBI31JAI2849771,99,29,16,13,1
SBI49GWH2339900,20,23,20,3,1
SBI93HBJ9971412,75,26,15,11,1
SBI44MEH7666868,21,23,13,10,1
SBI52JFL5663143,96,29,25,4,1
SBI67FTW5659129,20,25,19,6,1
SBI08QIT1066906,88,22,21,1,1
SBI79JQD0449298,69,31,25,6,1
SBI23DAF8663280,76,25,13,12,1
SBI27YPJ2536767,95,19,14,5,1
SBI62NEP3244468,79,29,27,2,1
SBI50RTV5118030,91,17,11,6,1
SBI01IWX8744674,97,22,13,9,1
SBI13KGP0773117,22,21,11,10,1
SBI66XLE0805638,87,17,15,2,1
SBI19EFV4608213,91,27,26,1,1
SBI22PYX7368265,65,21,17,4,1
SBI56YHY6606125,63,22,20,2,1
SBI15HEE3389014,60,22,18,4,1
SBI20LTZ6785616,68,24,22,2,1
SBI71RUT2764177,73,28,24,4,1
SBI92FAQ2194410,66,19,16,3,1
SBI15KCK1386685,65,26,19,7,1
SBI40DES7355030,74,34,26,8,1
SBI32NNQ7460416,85,21,20,1,1
SBI85ZDK7641700,94,24,20,4,1
SBI79HJA6304608,66,25,16,9,1
SBI19VMQ0181635,89,25,17,8,1
SBI02EMY9933430,23,20,11,9,1
SBI02GAP4817808,68,22,15,7,1
SBI54FAH0387359,73,22,15,7,1
SBI36RDR2463933,88,20,11,9,1
SBI07OUM3961567,97,30,28,2,1
SBI09XMR2793166,91,17,13,4,1
SBI53RQO8027037,60,31,27,4,1
SBI38ICA6502679,19,24,14,10,1
SBI72MGQ1542832,90,14,10,4,1
SBI58LES1779672,90,24,14,10,1
SBI92UJM4833259,99,18,16,2,1
SBI91CRD0334801,89,22,18,4,1
SBI72FOM2850543,68,27,17,10,1
SBI00XYM3060883,23,28,27,1,1
SBI25FVT1149552,92,31,28,3,1
SBI95RRE3452995,65,30,16,14,1
SBI09MWL8369551,79,27,20,7,1
SBI89BDS4053505,79,24,14,10,1
SBI93NSS6059924,75,27,21,6,1
SBI73HBQ0568796,64,17,12,5,1
SBI67XDJ1231575,72,29,24,5,1
SBI59OPU8462367,79,26,19,7,1
SBI08TPZ9041911,72,28,25,3,1
SBI72XQH6424902,20,30,17,13,1
SBI97SVF7276588,20,21,16,5,1
SBI30XHY9511378,77,27,17,10,1
SBI52BLT3647930,98,25,14,11,1
SBI72QFQ7161234,24,18,13,5,1
SBI71MYU0273561,73,23,20,3,1
SBI96GSJ7817785,77,23,21,2,1
SBI07BEQ5354098,77,25,19,6,1
SBI86NER4533040,73,27,25,2,1
SBI70ZDW7251240,89,33,27,6,1
SBI60QZI0909001,66,26,15,11,1
SBI24UHE3479079,79,22,16,6,1
SBI11ELO6652129,24,18,16,2,1
SBI66KPE3682393,84,26,21,5,1
SBI00HMX3696940,85,30,25,5,1
SBI09CVH1569963,72,25,19,6,1
SBI34DQA8777994,83,19,15,4,1
SBI19STX9273088,96,23,12,11,1
SBI70NJX4222292,62,31,18,13,1
SBI01IPE0091887,90,29,15,14,1
SBI86SFQ0249125,78,19,10,9,1
SBI19OIZ8053298,80,34,23,11,1
SBI16YNG5135003,90,29,24,5,1
SBI55XST4775319,63,29,22,7,1
SBI84VQD0557398,22,32,17,15,1
SBI31IVJ6209641,69,28,20,8,1
SBI96ZUP5463501,91,31,19,12,1
SBI97HYT7304135,72,22,19,3,1
SBI16PZK7352898,82,29,20,9,1
SBI96IVN5432092,23,20,14,6,1
SBI56NMP2071560,20,19,11,8,1
SBI18REK6016838,81,28,22,6,1
SBI60WQX9301852,68,29,17,12,1
SBI06UIU8882043,64,27,21,6,1
SBI75ERR4349620,88,26,21,5,1
SBI48BCE3310667,89,13,11,2,1
SBI00UCR8253992,79,25,18,7,1
SBI92BDD4084480,96,23,19,4,1
SBI55PCP1417403,66,28,20,8,1
SBI15CKB9370772,87,31,27,4,1
SBI97TUB0367055,63,18,13,5,1
SBI57AKU9567367,64,23,12,11,1
SBI92UYP0627111,75,29,26,3,1
SBI54ARN9871910,97,28,22,6,1
SBI48JMM1695456,61,24,14,10,1
SBI80DQD6313569,92,25,18,7,1
SBI20WOT0155289,76,29,19,10,1
SBI77FTF1369379,71,22,18,4,1
SBI57HCY1446698,78,22,15,7,1
SBI33QTV0151282,61,20,18,2,1
SBI47FKH5487730,22,24,15,9,1
SBI08NES4206772,93,23,22,1,1
SBI29PTZ6356056,19,25,23,2,1
SBI63GAX0676666,73,18,17,1,1
SBI26DKJ0784835,70,23,13,10,1
SBI20UTF6978080,77,39,34,5,1
SBI88ZZJ4976691,76,18,10,8,1
SBI06BBA9002983,91,20,13,7,1
SBI51ZCV8876231,97,27,15,12,1
SBI75YYC2856459,20,29,20,9,1
SBI06TDO6990348,71,22,15,7,1
SBI64KIU0846827,23,20,19,1,1
SBI52YHG4839471,85,20,13,7,1
SBI67KRR3236462,88,33,22,11,1
SBI11KIT2230472,19,21,11,10,1
SBI70BYS2030418,60,29,20,9,1
SBI16ZXL3536870,63,29,22,7,1
SBI30NWH5937161,63,30,20,10,1
SBI54PRP6659004,88,30,21,9,1
SBI64WDP1194294,82,20,13,7,1
SBI37HOO6469949,82,27,17,10,1
SBI55MHV0037470,96,27,25,2,1
SBI76PLH3934244,61,17,15,2,1
SBI17QBF6738704,86,22,15,7,1
SBI82JXW8585776,99,20,14,6,1
SBI22MNA3545858,90,16,15,1,1
SBI97TQG9492117,71,20,11,9,1
SBI48MVF3525061,86,19,18,1,1
SBI89NJH4754678,23,28,16,12,1
SBI59YVI0437943,18,36,23,13,1
SBI19PFR3985364,79,29,20,9,1
SBI11LIT7492299,95,17,10,7,1
SBI44EQY2822817,78,20,14,6,1
SBI72VAM2947962,88,23,22,1,1
SBI74NZJ3797747,60,25,23,2,1
SBI21PEN0128553,66,25,22,3,1
SBI07JMV6101387,19,29,19,10,1
SBI22AZL5569607,24,11,7,4,1
SBI92LXN1881726,86,33,32,1,1
SBI20SPT5038245,84,28,26,2,1
SBI28IRM2614589,19,24,15,9,1
SBI83WNJ7822128,92,19,14,5,1
SBI20WER9815330,63,27,22,5,1
SBI32BWV0272953,73,24,23,1,1
SBI70PRN0040880,71,24,22,2,1
SBI23YAJ9310813,68,27,21,6,1
SBI08CAB0952790,81,23,15,8,1
SBI95KIW9604143,25,22,19,3,1
SBI73PSV7092840,23,35,33,2,1
SBI86LGS8351979,83,24,17,7,1
SBI06LRF1555875,61,19,12,7,1
SBI90FBF6652375,77,25,13,12,1
SBI27FQF3973093,68,16,15,1,1
SBI40MPO1973337,88,19,17,2,1
SBI10BRF5567429,77,22,18,4,1
SBI27XBY9696207,68,28,20,8,1
SBI28LJE7371810,89,30,22,8,1
SBI68PAB4746065,18,25,16,9,1
SBI22CXH6632115,70,29,23,6,1
SBI82TDK8010570,60,30,27,3,1
SBI98GPU3612443,89,23,18,5,1
SBI50OXC2921320,24,29,20,9,1
SBI52ZTW9012805,18,27,18,9,1
SBI91YQP5006280,77,20,17,3,1
SBI24FCG1385299,91,29,28,1,1
SBI74XZO8440941,99,26,18,8,1
SBI79FQY4095601,72,24,15,9,1
SBI51OLU0633340,60,33,32,1,1
SBI92JIH9288118,25,11,10,1,1
SBI75CPL9436808,60,24,18,6,1
SBI83PJL0871354,63,32,29,3,1
SBI26TJE5648127,62,20,15,5,1
SBI86UAT5269145,70,23,21,2,1
SBI07NBK2314882,84,15,12,3,1
SBI07XEM7032407,81,29,24,5,1
SBI73BOA6796981,95,30,23,7,1
SBI65JMT5296337,73,21,16,5,1
SBI22OMR3099769,61,18,11,7,1
SBI75QWU4562907,60,20,18,2,1
SBI85SMB7863346,89,26,20,6,1
SBI09ECV5886482,72,31,17,14,1
SBI07NZD3093935,97,29,24,5,1
SBI03AUZ0277097,67,28,23,5,1
SBI11ITL0377836,22,23,20,3,1
SBI78EII1306373,24,21,12,9,1
SBI13TIL1942561,74,21,11,10,1
SBI11SGU5942535,94,25,13,12,1
SBI57SGD1357063,68,21,12,9,1
SBI94IVI0725269,93,23,21,2,1
SBI94DSE0194671,77,38,26,12,1
SBI67HZH8500777,88,27,19,8,1
SBI71NGD7607775,93,14,9,5,1
SBI72KUE0404711,96,19,14,5,1
SBI09VIV1291107,65,21,19,2,1
SBI92EAJ0207024,18,27,20,7,1
SBI16TLM4084504,79,28,17,11,1
SBI77TCX8709187,62,19,18,1,1
SBI27QHQ1711776,85,28,22,6,1
SBI58SUO6419740,97,36,28,8,1
SBI67KRK2294494,18,21,19,2,1
SBI26UZE4309876,80,25,13,12,1
SBI89ETP0620064,70,23,16,7,1
SBI85KOG6473725,62,23,19,4,1
SBI87QHP8606598,84,31,17,14,1
SBI25XCW2258483,80,23,16,7,1
SBI81MFS1692125,78,37,30,7,1
SBI39ICV2215457,85,21,15,6,1
SBI40AXE6034129,93,24,22,2,1
SBI34JVA5200850,86,24,22,2,1
SBI02BTC8575447,82,20,19,1,1
SBI53SHR9390825,78,28,24,4,1
SBI53XSN4146048,76,38,24,14,1
SBI13HWK2793807,78,18,17,1,1
SBI88MEA3006182,84,27,22,5,1
SBI41SBI1185017,87,20,15,5,1
SBI19VCI9617925,61,18,13,5,1
SBI76ZBA5691225,91,18,12,6,1
SBI15THQ4414448,79,23,12,11,1
SBI64LWM0971983,76,30,17,13,1
SBI99OEI8809427,97,21,13,8,1
SBI91VLC5748111,97,30,24,6,1
SBI29BCI3157458,65,29,21,8,1
SBI60WMM0951329,91,25,17,8,1
SBI90BIF5974261,61,19,15,4,1
SBI80JVQ0604890,70,26,19,7,1
SBI87DRG9357034,86,27,23,4,1
SBI39USB4004117,85,26,15,11,1
SBI02YDI7481927,83,37,30,7,1
SBI62OYW7337784,61,21,13,8,1
SBI46NSK7519798,78,24,23,1,1
SBI60GCZ7930566,23,26,23,3,1
SBI98HPR8595180,24,33,25,8,1
SBI50ZYA6219878,60,25,14,11,1
SBI42XZF7088124,71,27,23,4,1
SBI60IOV2217341,82,31,26,5,1
SBI56UKH9480614,62,34,32,2,1
SBI44YBW8354270,91,18,10,8,1
SBI06TDM1069018,66,14,9,5,1
SBI73PLI6983310,89,22,20,2,1
SBI43EJR1299950,71,32,31,1,1
SBI80RVV0948319,74,24,13,11,1
SBI58AUI2442010,90,26,22,4,1
SBI82XZD9047146,87,26,17,9,1
SBI83KFC0233153,77,25,20,5,1
SBI29IUR5489963,77,18,13,5,1
SBI32ITJ9514611,25,24,20,4,1
SBI16IWM4738808,78,20,11,9,1
SBI38JZG3905361,87,26,18,8,1
SBI75FKN5875672,73,23,19,4,1
SBI69SMU6982652,19,23,20,3,1
SBI79GAH7899851,85,23,14,9,1
SBI41RAV4665009,98,21,20,1,1
SBI07PLK7508173,80,27,23,4,1
SBI41FBT0547091,77,34,26,8,1
SBI07NFO0233245,72,28,23,5,1
SBI55DBE3636977,99,26,20,6,1
SBI83VBA5003998,64,23,14,9,1
SBI47NSJ4899443,77,33,30,3,1
SBI60FJG3625893,99,24,13,11,1
SBI06RXK5750175,76,28,17,11,1
SBI06SKQ8056228,96,26,16,10,1
SBI44AGJ9445698,61,26,25,1,1
SBI07AAD5992943,70,24,23,1,1
SBI84SCV8006361,72,31,25,6,1
SBI46VPM0897925,81,24,18,6,1
SBI85OTA8934716,93,20,14,6,1
SBI04TKH8198004,23,33,18,15,1
SBI21QDE2671353,70,20,14,6,1
SBI86GIK6585315,69,29,15,14,1
SBI20TPW8844028,68,28,15,13,1
SBI44OXD3187889,73,32,29,3,1
SBI63ROX6627347,75,18,12,6,1
SBI07GXR6394479,78,24,23,1,1
SBI53GZZ9186115,84,27,14,13,1
SBI55XJX7566739,71,21,11,10,1
SBI83HYU0143281,88,28,23,5,1
SBI43TXD1775706,90,28,19,9,1
SBI15SRA2256826,85,32,30,2,1
SBI26MSB4913398,20,21,12,9,1
SBI51MMW2268603,80,34,25,9,1
SBI35NHS0761272,83,32,25,7,1
SBI65YMV5034177,79,30,18,12,1
SBI18XHT2960079,79,22,13,9,1
SBI60OZI9406461,91,28,25,3,1
SBI58WFB3136225,25,21,16,5,1
SBI30SEC7675086,79,28,15,13,1
SBI36KED2645905,64,24,18,6,1
SBI79FES4383499,93,24,20,4,1
SBI77WNW0951341,66,20,15,5,1
SBI96ZMB7305431,73,29,21,8,1
SBI89COI0418348,73,20,19,1,1
SBI46SDN4109517,88,18,11,7,1
SBI28TXB3967652,91,23,20,3,1
SBI15MVY0782414,21,22,17,5,1
SBI98BHT0044708,83,29,23,6,1
SBI35MZW3264112,88,29,28,1,1
SBI22RCV6793649,68,27,23,4,1
SBI16XNT7444553,85,25,17,8,1
SBI66WZZ7889841,84,28,22,6,1
SBI87RLC7257320,68,28,15,13,1
SBI94GCU8024513,23,25,13,12,1
SBI89UYV0211137,73,22,15,7,1
SBI38WMD1383800,99,22,12,10,1
SBI86MTR8880686,67,15,8,7,1
SBI34HBR2251661,83,21,12,9,1
SBI04MJZ3186155,86,18,11,7,1
SBI68FAZ1638036,82,15,13,2,1
SBI77ZTM4255811,75,23,15,8,1
SBI07ESZ3489133,83,19,15,4,1
SBI98EAY6747061,90,26,15,11,1
SBI78BGQ8564559,87,25,22,3,1
SBI19LHH4601518,83,20,14,6,1
SBI52XTO6850988,74,30,18,12,1
SBI61VBN4347153,96,20,13,7,1
SBI72QXT4358476,73,19,14,5,1
SBI93YWE3913000,85,22,18,4,1
SBI00ZDQ5152839,99,32,19,13,1
SBI81WBR3711767,85,29,17,12,1
SBI36IIB9761261,93,14,13,1,1
SBI26DZV7859152,24,26,23,3,1
SBI88AXJ6107899,24,31,23,8,1
SBI16GGO8957292,65,28,15,13,1
SBI88YBF4948191,77,20,12,8,1
SBI06WMZ2309698,72,30,25,5,1
SBI27ZGD0103361,64,31,25,6,1
SBI82JIL8847863,94,26,22,4,1
SBI39QAE9206136,99,24,18,6,1
SBI79RNU6068239,87,23,13,10,1
SBI10PEO5286606,22,27,24,3,1
SBI00VNE7139575,85,27,25,2,1
SBI18ELL6753134,24,25,14,11,1
SBI21BGF8039866,69,12,10,2,1
SBI37UZU1458375,21,26,20,6,1
SBI34HMO0187592,81,26,24,2,1
SBI40HGD1367248,97,22,12,10,1
SBI32XTH6063292,85,27,14,13,1
SBI79OSU5451993,97,24,14,10,1
SBI27PTJ3367268,95,22,12,10,1
SBI57JKE8998364,93,25,22,3,1
SBI87QON4695210,96,22,20,2,1
SBI60BWI5950518,73,30,23,7,1
SBI95MMD3159159,20,30,16,14,1
SBI73PZW4532411,92,30,28,2,1
SBI49NUB9948391,76,31,16,15,1
SBI05ACR2445397,64,26,21,5,1
SBI53GDW6424260,60,22,20,2,1
SBI46PSW4457736,22,29,21,8,1
SBI60UNE1705151,75,29,23,6,1
SBI31JKW8097306,71,24,16,8,1
SBI86JVB9177994,66,31,20,11,1
SBI66LSX5184669,19,28,22,6,1
SBI61QNZ6465022,72,20,13,7,1
SBI36XAD5643863,87,17,9,8,1
SBI48LMH7755925,75,20,13,7,1
SBI57ZTP2049147,97,23,21,2,1
SBI30LAD8917832,69,18,16,2,1
SBI99BHK0834416,60,29,20,9,1
SBI84SBV1245607,66,29,21,8,1
SBI08HUM9631379,19,27,18,9,1
SBI20AOO6302599,75,27,14,13,1
SBI44KUE9379864,69,17,11,6,1
SBI73RXI5973527,86,30,20,10,1
SBI03RSS5285191,69,24,19,5,1
SBI16EHI2153302,87,16,12,4,1
SBI03GBG6290765,64,29,25,4,1
SBI38EAF9820513,62,19,12,7,1
SBI76SNW5978190,98,13,10,3,1
SBI59IAG1162637,18,19,18,1,1
SBI40XCT3163080,18,18,13,5,1
SBI76CCZ8306162,93,24,13,11,1
SBI10YVX4603680,19,26,21,5,1
SBI86ZUY2830290,65,22,18,4,1
SBI94OHJ5511277,21,19,14,5,1
SBI66BTX0680679,66,20,13,7,1
SBI57EOU5875868,77,24,15,9,1
SBI59PHV0503681,65,24,22,2,1
SBI77HFK8183947,81,29,23,6,1
SBI63WTJ3262711,97,20,18,2,1
SBI68CEO1242704,67,15,14,1,1
SBI03AYO1169758,63,28,22,6,1
SBI83CBI5058818,98,27,21,6,1
SBI09YTV8896818,78,37,27,10,1
SBI18ZLM5471788,18,21,13,8,1
SBI11UDX1938384,66,22,13,9,1
SBI77ZGD8906560,25,33,30,3,1
SBI97DVJ2100522,85,28,25,3,1
SBI10YEU4942162,84,30,21,9,1
SBI98YGJ6204639,98,25,24,1,1
SBI37EWE7476635,88,19,10,9,1
SBI20AIB4284413,67,21,15,6,1
SBI07BDX3829739,82,18,16,2,1
SBI55CPQ9592900,23,23,17,6,1
SBI41TTT1669709,83,31,23,8,1
SBI25GBL3405103,64,23,19,4,1
SBI83WPE4354585,62,28,15,13,1
SBI74SSV1834185,95,16,13,3,1
SBI44DKY0804825,79,27,21,6,1
SBI73LIL5908942,19,23,16,7,1
SBI82UAG1266537,71,28,27,1,1
SBI03CYT5285091,82,23,19,4,1
SBI86ENU3777063,89,33,31,2,1
SBI69WSO2819281,89,22,13,9,1
SBI52RRI4360641,63,21,18,3,1
SBI95VOY0283084,60,18,13,5,1
SBI93SJM9015454,71,18,15,3,1
SBI40TXA7895966,72,26,14,12,1
SBI64GNX1029084,92,29,24,5,1
SBI15TXY4021181,88,26,19,7,1
SBI76AUB7950330,83,28,27,1,1
SBI10KKV2032739,64,26,20,6,1
SBI42DXC9871407,62,18,14,4,1
SBI14MXL4827216,97,30,25,5,1
SBI39RYH0707764,65,19,10,9,1
SBI87XBI3895523,67,20,13,7,1
SBI14JFZ5921958,94,27,24,3,1
SBI78YTA7102903,63,31,26,5,1
SBI49PTU6779433,93,19,16,3,1
SBI51VTO9285880,72,22,21,1,1
SBI20NOU6785032,84,27,25,2,1
SBI56JMX9043045,24,29,26,3,1
SBI00NEF2335250,25,27,26,1,1
SBI06SQE6153959,92,17,13,4,1
SBI13YOQ2117050,79,21,14,7,1
SBI50PDV7722900,92,24,13,11,1
SBI99JQO0369982,23,21,16,5,1
SBI11JRD7817745,72,23,15,8,1
SBI00HPT2732358,71,25,18,7,1
SBI61KTA7846245,67,29,27,2,1
SBI55QED2157645,72,26,21,5,1
SBI37WGN0727988,81,23,19,4,1
SBI03YOF1880324,64,20,18,2,1
SBI53AHM4469557,99,22,20,2,1
SBI12IJZ9169557,20,31,25,6,1
SBI52VER5284394,19,32,17,15,1
SBI85EDF7383717,90,28,20,8,1
SBI71EDZ9102543,60,21,20,1,1
SBI21UNY9104276,91,21,11,10,1
SBI01TZS0259791,67,22,16,6,1
SBI18OLK2297093,79,26,25,1,1
SBI28PLM4846617,98,24,19,5,1
SBI77XFQ1546154,25,29,26,3,1
SBI68JMK3074012,66,25,17,8,1
SBI91EGB8166636,80,26,15,11,1
SBI59UKO1500829,97,23,16,7,1
SBI42JVJ3189362,60,25,14,11,1
SBI37CRH6710451,63,18,11,7,1
SBI85DFN3262740,76,27,17,10,1
SBI64GNL5431328,79,28,21,7,1
SBI71HLR3434487,73,19,15,4,1
SBI99FGN9798923,18,23,14,9,1
SBI40KLQ8680986,77,24,14,10,1
SBI11ALQ3718201,18,24,19,5,1
SBI04GCC8160394,88,17,14,3,1
SBI96GQJ7413116,67,24,20,4,1
SBI14TPW5548076,67,21,14,7,1
SBI22UDK1807362,90,31,19,12,1
SBI79THI7958949,86,33,31,2,1
SBI18YCG3852576,19,28,20,8,1
SBI58LEN6865663,95,36,35,1,1
SBI20KSU7676105,83,18,11,7,1
SBI65EWR4946340,64,22,14,8,1
SBI23PIX1369746,65,23,19,4,1
SBI56GJV1928050,75,25,24,1,1
SBI99QRY5937509,18,27,20,7,1
SBI08PYL6087948,86,21,20,1,1
SBI02JXM3640271,86,27,16,11,1
SBI75SUB7980040,84,23,12,11,1
SBI05MJT6511296,99,20,16,4,1
SBI70GIF9468537,67,25,19,6,1
SBI86WOW9220016,81,25,15,10,1
SBI54ISP0070660,22,27,19,8,1
SBI75UDQ4573916,76,20,16,4,1
SBI44SDW2708437,91,31,29,2,1
SBI86FWP9999894,90,33,29,4,1
SBI68EDW6098072,95,16,13,3,1
SBI81SRU7836132,86,23,12,11,1
SBI54FDJ5228364,21,22,18,4,1
SBI63FYZ4164401,89,24,18,6,1
SBI55ASW3734680,61,34,26,8,1
SBI23JCL8862587,84,24,14,10,1
SBI48FNT2699004,93,17,11,6,1
SBI73SHQ6389062,18,18,10,8,1
SBI94HSE0384807,98,15,14,1,1
SBI46LGX2173810,21,33,25,8,1
SBI54JUH7175265,83,24,19,5,1
SBI39WOJ3502281,84,26,19,7,1
SBI46WCC9307193,84,22,17,5,1
SBI84HPI3075822,25,36,32,4,1
SBI00EGF0568861,23,24,15,9,1
SBI76WUA3880079,84,31,19,12,1
SBI72ZLM1545764,20,19,17,2,1
SBI69DHT7123757,93,34,26,8,1
SBI27JXH5858749,69,15,12,3,1
SBI84QBU5400180,79,25,13,12,1
SBI97GTS3742277,67,17,12,5,1
SBI59BIT1476773,83,27,19,8,1
SBI19FTD1632364,61,20,15,5,1
SBI48PEB4740315,80,18,13,5,1
SBI88XBF2825008,83,32,28,4,1
SBI90TOK0127914,70,27,23,4,1
SBI32CSK4637546,73,23,21,2,1
SBI17NZF1614897,77,12,10,2,1
SBI90QKR0148560,73,30,16,14,1
SBI34VMP1953833,24,25,17,8,1
SBI11FAP1512370,79,22,15,7,1
SBI50BZF7810599,20,21,18,3,1
SBI75YDB8688858,74,35,28,7,1
SBI81TYD4948671,93,34,31,3,1
SBI40DCH6162566,24,17,9,8,1
SBI07BKV9535592,67,14,9,5,1
SBI49XEQ6712958,62,32,24,8,1
SBI03NEB9070305,77,20,17,3,1
SBI72WFJ0551962,70,20,18,2,1
SBI46RBE3061014,67,22,13,9,1
SBI03YWH0273584,22,27,19,8,1
SBI63RRG5065430,86,28,26,2,1
SBI76KBN2125504,22,22,13,9,1
SBI66LLZ5886315,74,39,37,2,1
SBI36URY1171330,80,19,17,2,1
SBI73PQH3342343,81,26,14,12,1
SBI46YUU1435502,80,20,18,2,1
SBI65TVW2113603,18,26,20,6,1
SBI29CUQ7060960,80,30,27,3,1
SBI35KTK7473195,98,31,17,14,1
SBI81HWR3090000,78,22,14,8,1
SBI85MYO7469432,94,24,22,2,1
SBI95JWY2494494,74,32,31,1,1
SBI20EET5844211,63,39,29,10,1
SBI68QQO8450969,79,25,24,1,1
SBI93SVU8076667,70,22,20,2,1
SBI24UIV0611040,84,20,12,8,1
SBI61MMR0791168,19,33,28,5,1
SBI17IXD4482596,60,31,20,11,1
SBI55OAY6073609,84,21,12,9,1
SBI80RMW2535521,91,21,13,8,1
SBI34ICX4965294,67,22,16,6,1
SBI91MVG7184909,65,22,17,5,1
SBI27OGR8357228,76,30,17,13,1
SBI14WRB5445610,69,31,26,5,1
SBI47CAS5270726,70,33,26,7,1
SBI22QNP6019478,75,16,9,7,1
SBI10MPJ6703107,19,28,22,6,1
SBI71NPX5394301,60,18,17,1,1
SBI91MRO4128421,93,28,16,12,1
SBI60OHG9756700,19,12,10,2,1
SBI72KBU5653683,90,21,17,4,1
SBI21GYQ2281908,64,21,15,6,1
SBI75OGA8133547,80,17,12,5,1
SBI32FLZ1641354,69,29,24,5,1
SBI36ZXG1593196,69,18,17,1,1
SBI75XZP9916788,88,20,11,9,1
SBI00DJQ1335617,91,28,24,4,1
SBI58UVS8107023,72,25,15,10,1
SBI41NQL0073481,88,19,16,3,1
SBI02RCO1263529,21,20,17,3,1
SBI45HKV8738400,19,23,15,8,1
SBI76XRY1422804,85,21,14,7,1
SBI77SBY0680393,92,20,15,5,1
SBI40MQM4291292,73,30,20,10,1
SBI93BXZ0964704,71,35,22,13,1
SBI73OLX6102570,77,21,19,2,1
SBI70WSN4198753,87,19,12,7,1
SBI53POG1129007,94,30,18,12,1
SBI17DFV8308616,61,17,10,7,1
SBI43WSG4993385,79,15,9,6,1
SBI19CXV9342579,93,25,13,12,1
SBI10IUJ8441937,91,24,21,3,1
SBI64ICM3000598,63,27,16,11,1
SBI39WQM4147656,66,24,15,9,1
SBI86KIP4408002,98,27,22,5,1
SBI42UMO6012467,91,26,20,6,1
SBI93AKE6088984,95,19,14,5,1
SBI41BQN0592452,66,26,22,4,1
SBI42AJF8211037,65,28,26,2,1
SBI39IPX2298026,87,30,17,13,1
SBI71TAH0098134,69,17,11,6,1
SBI29JDB4908675,78,34,30,4,1
SBI84ZGJ3810691,64,24,23,1,1
SBI46WVJ5344430,68,29,22,7,1
SBI65LYQ0096041,86,31,28,3,1
SBI15UNO7360969,20,23,18,5,1
SBI94HYJ0857591,89,29,20,9,1
SBI21GYT2558979,96,29,22,7,1
SBI91XKU1396764,81,17,14,3,1
SBI64YIK4457519,97,24,19,5,1
SBI72TJK4165259,19,25,21,4,1
SBI25FJZ3207832,89,23,16,7,1
SBI13CDB0214664,70,20,17,3,1
SBI70SRF6030908,88,26,24,2,1
SBI61SMP0492308,95,25,13,12,1
SBI79EFA8076533,73,26,21,5,1
SBI66ITU1353462,20,24,15,9,1
SBI88HFP0651350,99,32,23,9,1
SBI61SPD1141938,94,17,13,4,1
SBI30JPC3925000,64,24,14,10,1
SBI84TYM1854771,24,24,15,9,1
SBI52QHU5190362,89,30,21,9,1
SBI29IRI8219980,64,22,18,4,1
SBI63WHH6962396,95,24,18,6,1
SBI88KJP5069607,81,25,21,4,1
SBI48HXG7969482,69,31,24,7,1
SBI20EHS8843348,76,27,18,9,1
SBI36VQI3350295,18,28,21,7,1
SBI90BCX3513549,94,24,22,2,1
SBI29KYB5824875,90,27,14,13,1
SBI90YQL4630731,20,18,15,3,1
SBI60JSQ3392081,97,24,13,11,1
SBI96ZUG4297466,99,22,13,9,1
SBI00JFN6084168,75,28,21,7,1
SBI92PBQ5811020,86,20,19,1,1
SBI83POE8548046,24,31,19,12,1
SBI39SGP2163887,21,20,16,4,1
SBI76GEU2825280,60,29,19,10,1
SBI99TDS4247955,24,32,25,7,1
SBI04VXV1816739,89,23,12,11,1
SBI14IRU0510147,22,24,14,10,1
SBI85NTQ1800365,68,27,23,4,1
SBI95XKW4540628,99,28,24,4,1
SBI46QVD0797141,90,25,20,5,1
SBI08LGT5204241,23,19,17,2,1
SBI35NCF8425043,22,25,24,1,1
SBI99SRK0889628,74,23,20,3,1
SBI88UTD3583619,77,30,26,4,1
SBI72DTE9858727,83,28,18,10,1
SBI06WSO8041916,78,22,19,3,1
SBI55YMS7878040,63,23,13,10,1
SBI01CQQ1853918,87,23,21,2,1
SBI93PDU5597198,66,27,22,5,1
SBI61XTU7895771,21,36,31,5,1
SBI00ZJH1684308,23,28,20,8,1
SBI66AFP8232064,60,29,15,14,1
SBI12UPB4891210,90,19,13,6,1
SBI10EKJ4842050,68,26,25,1,1
SBI53NZT8251719,85,21,16,5,1
SBI84IPZ5485123,75,26,14,12,1
SBI05BLX8922065,25,23,12,11,1
SBI88PLD4405143,83,22,13,9,1
SBI60FEF7118205,89,19,18,1,1
SBI82DQV5721582,18,29,18,11,1
SBI31ZWX1435732,65,29,16,13,1
SBI11BYN3601063,67,18,11,7,1
SBI26JRT6895266,19,25,21,4,1
SBI09YQV2626743,61,37,32,5,1
SBI94IKR4454467,91,22,17,5,1
SBI64LKD7721373,60,20,11,9,1
SBI52KNF7292717,64,21,16,5,1
SBI34CGJ7951365,70,28,15,13,1
SBI84FGK8792273,89,27,19,8,1
SBI12ELR3636036,22,17,15,2,1
SBI30HHN3537375,65,22,21,1,1
SBI09VGY0041617,87,24,18,6,1
SBI72NEN6550890,85,31,17,14,1
SBI75YSQ3371847,79,23,16,7,1
SBI21JYV3146046,71,29,28,1,1
SBI86LKT4293037,75,22,16,6,1
SBI21QXB1249254,21,16,10,6,1
SBI56HJJ2120546,90,33,26,7,1
SBI03BJA4395109,75,25,18,7,1
SBI82DZR1737572,93,25,14,11,1
SBI91CYV3163341,66,27,21,6,1
SBI80CTZ3113198,89,27,24,3,1
SBI02DQJ1448342,73,24,16,8,1
SBI95JNS8947321,98,25,17,8,1
SBI68MKA9292985,71,25,23,2,1
SBI75GSK4500872,67,21,17,4,1
SBI06MQA9071218,18,24,19,5,1
SBI41BEA8978475,84,19,14,5,1
SBI43UHC5599346,61,25,16,9,1
SBI06EHV0414097,85,30,23,7,1
SBI61ELB3777849,61,39,31,8,1
SBI34OQX1035591,67,26,20,6,1
SBI88HLY3070901,78,24,13,11,1
SBI63NIT9050106,60,29,23,6,1
SBI38TSZ5237056,85,23,13,10,1
SBI52LUX1267622,82,26,16,10,1
SBI28ELX9014556,61,27,14,13,1
SBI22RTB1286965,62,27,14,13,1
SBI34XRE5948219,87,19,12,7,1
SBI98VVL6428547,98,23,19,4,1
SBI65HBP4756108,65,23,13,10,1
SBI11ZKE3729606,23,26,17,9,1
SBI80QUR4741522,20,28,26,2,1
SBI21QNU0218071,99,30,21,9,1
SBI70DZN2446535,77,23,15,8,1
SBI96TGC1690584,70,16,11,5,1
SBI46KLT9590134,92,29,21,8,1
SBI64IEV0848383,85,28,22,6,1
SBI59RSA7903852,83,25,20,5,1
SBI36JDF1818588,84,18,17,1,1
SBI85UOY0779346,67,27,24,3,1
SBI88ZTJ8432888,22,23,22,1,1
SBI84ALC5370133,64,15,8,7,1
SBI63VTK5863308,72,16,11,5,1
SBI11YRB4019143,77,24,16,8,1
SBI16VMD1713120,85,22,19,3,1
SBI33CJE1667687,99,21,20,1,1
SBI51RFV8157589,61,27,19,8,1
SBI13YGD0907686,25,20,14,6,1
SBI29AYX2534093,89,23,19,4,1
SBI02DSW2563630,82,22,14,8,1
SBI11BHS8166226,24,29,25,4,1
SBI43MIC1472387,89,23,16,7,1
SBI35HBD8829930,82,20,16,4,1
SBI21NPC9744621,66,32,25,7,1
SBI81KFU1169728,18,24,19,5,1
SBI46YXO7933368,63,21,15,6,1
SBI54LID4807034,95,33,21,12,1
SBI86HMO4428015,60,32,23,9,1
SBI00RQH2282629,70,17,9,8,1
SBI20NCK5921235,81,22,16,6,1
SBI57EFQ7398939,91,31,18,13,1
SBI07UZH9202411,18,27,21,6,1
SBI64KES4048681,89,18,17,1,1
SBI18FQO8479469,86,25,16,9,1
SBI35LDR2916949,79,27,25,2,1
SBI70CRA3402863,60,20,14,6,1
SBI32WPB1845595,64,32,22,10,1
SBI13NOK0564450,65,28,18,10,1
SBI00HSZ9418358,62,29,18,11,1
SBI03FGD2510945,83,21,19,2,1
SBI00NCL9889817,88,30,20,10,1
SBI66OEX0860440,87,32,23,9,1
SBI07SKL5320411,80,18,17,1,1
SBI99XVU7978883,69,25,16,9,1
SBI34TXW0850393,88,15,13,2,1
SBI59RRD4287861,22,14,10,4,1
SBI89OEY1221393,60,22,21,1,1
SBI40GMF7625704,20,20,17,3,1
SBI13WKE6482136,84,41,28,13,1
SBI12PXL3247380,86,27,16,11,1
SBI34LDD8038410,80,23,17,6,1
SBI86VNY9425247,73,26,14,12,1
SBI98XTF4245847,72,28,24,4,1
SBI75IXN4401164,88,25,22,3,1
SBI88QHH0077598,83,25,18,7,1
SBI89AJG4304465,62,29,28,1,1
SBI94NVG1511688,97,25,21,4,1
SBI42OKL0319715,18,22,20,2,1
SBI81ZXF9660415,25,31,26,5,1
SBI41MBC0004740,78,30,18,12,1
SBI42IEQ3040905,20,30,21,9,1
SBI56DTA9289942,24,23,19,4,1
SBI51OUA8482672,81,20,15,5,1
SBI68TVL6529318,19,27,21,6,1
SBI00TAP2599419,68,29,21,8,1
SBI72EVH0910639,70,19,12,7,1
SBI05YHN5415201,93,33,31,2,1
SBI37CTV7734096,87,31,29,2,1
SBI07JAF6727848,94,28,26,2,1
SBI56OLS8380802,94,23,17,6,1
SBI28TNX7432580,87,21,17,4,1
SBI00MFN5460610,22,30,29,1,1
SBI43ABB7308650,79,22,19,3,1
SBI77AAT8913797,90,25,17,8,1
SBI81WYZ9056482,93,14,13,1,1
SBI55TSL8635927,79,29,18,11,1
SBI82PXY0924869,67,20,11,9,1
SBI24LTX6862586,62,19,18,1,1
SBI55FNU2454743,78,28,18,10,1
SBI48IJA3128300,80,19,16,3,1
SBI16BBC6654203,25,26,16,10,1
SBI41EHR3050718,24,21,20,1,1
SBI02QAD5814893,96,25,22,3,1
SBI34BVV0469703,63,25,19,6,1
SBI21BTX9942404,98,31,26,5,1
SBI14MEJ8374151,60,25,13,12,1
SBI35AWS3108885,98,15,11,4,1
SBI53QWY8058700,78,29,24,5,1
SBI85QMR6566824,81,23,22,1,1
SBI18KLA2783479,21,27,14,13,1
SBI47EYK5040643,80,21,15,6,1
SBI14RKM2469900,69,27,26,1,1
SBI76SLY0885978,96,33,25,8,1
SBI33XEN5893387,79,20,12,8,1
SBI27FID4345211,80,19,18,1,1
SBI67FYS2242053,75,23,20,3,1
SBI41TWG2334350,19,25,14,11,1
SBI70MWU2143642,90,28,17,11,1
SBI44CNV6773635,91,23,17,6,1
SBI39MGM6079236,70,19,12,7,1
SBI54AJS9577567,19,19,10,9,1
SBI99GCJ0491105,82,16,9,7,1
SBI74UXL9609674,84,39,31,8,1
SBI71JTX7135842,60,26,25,1,1
SBI13ZRJ8610228,74,23,21,2,1
SBI16WQH6502447,73,29,24,5,1
SBI69ITY1846281,72,23,15,8,1
SBI77ZLO9591519,89,23,18,5,1
SBI88RFF6414493,74,18,16,2,1
SBI97ZDY2557522,19,21,20,1,1
SBI04YMP1513719,62,19,18,1,1
SBI91KDN7082185,92,23,13,10,1
SBI87PIN5267915,90,27,17,10,1
SBI90VJE0115418,75,23,16,7,1
SBI61LZN7419758,87,19,10,9,1
SBI56KVO9558996,83,17,16,1,1
SBI79BFO1750034,85,26,25,1,1
SBI36QNS7494114,70,28,27,1,1
SBI03ZFB7982001,61,25,15,10,1
SBI50JTF2715059,73,17,11,6,1
SBI29HVX2060073,62,34,28,6,1
SBI95UOH9428550,96,20,19,1,1
SBI96JWQ4589626,75,23,17,6,1
SBI91GAW9759226,24,23,22,1,1
SBI78OGW8351685,73,19,13,6,1
SBI93ZKF4872287,85,32,30,2,1
SBI71OQR1709439,96,14,12,2,1
SBI63VBZ5106034,91,28,16,12,1
SBI57YUL8582508,85,20,13,7,1
SBI41REY7535845,73,23,14,9,1
SBI99ZEI3329377,74,25,16,9,1
SBI43JCH9149428,95,31,25,6,1
SBI09IFV1587659,64,25,20,5,1
SBI68YJK2345063,88,14,10,4,1
SBI41BIV8002993,18,24,15,9,1
SBI97TSC7191014,95,29,23,6,1
SBI93ESF5560893,73,28,25,3,1
SBI66CXG3664022,92,18,16,2,1
SBI07VUF7355670,79,21,12,9,1
SBI12WDC9776885,82,24,19,5,1
SBI71BDX6702128,98,29,25,4,1
SBI77AQZ6867528,69,14,13,1,1
SBI24BRG4015976,67,23,15,8,1
SBI80QRT2762390,95,20,15,5,1
SBI89CTB6660197,87,21,14,7,1
SBI47IJR7679073,65,25,22,3,1
SBI65HUP5362811,87,21,12,9,1
SBI55URZ8788580,67,31,23,8,1
SBI13CND7649926,92,23,16,7,1
SBI60JPJ9711361,61,18,17,1,1
SBI92ACV9244493,78,33,20,13,1
SBI99MMC2906561,93,23,19,4,1
SBI99FZR4937068,75,17,9,8,1
SBI88GHW6079625,70,19,15,4,1
SBI02EFT0651839,90,22,18,4,1
SBI69MRD1089539,19,16,12,4,1
SBI80ISS6210922,23,21,16,5,1
SBI15LMM1867116,19,16,13,3,1
SBI22WNN9647066,73,24,17,7,1
SBI46ZCM3283360,73,24,20,4,1
SBI23ACU2827786,86,26,18,8,1
SBI65UEQ8646151,75,25,18,7,1
SBI76HEU6715670,95,22,20,2,1
SBI27MUQ3249116,62,15,12,3,1
SBI66SPJ6104265,78,19,18,1,1
SBI89VYD8885851,79,29,23,6,1
SBI79QKF1680055,73,35,25,10,1
SBI62CWZ1999142,71,27,19,8,1
SBI56YCD9478444,66,34,24,10,1
SBI96WEL6436729,73,20,14,6,1
SBI11LWU1176542,80,25,24,1,1
SBI29BGZ9403604,88,27,14,13,1
SBI69OXO7613558,72,22,17,5,1
SBI27FAN5011482,98,20,16,4,1
SBI75AOB6957706,24,32,31,1,1
SBI72NTM8848876,91,22,20,2,1
SBI84AJX6681387,65,17,12,5,1
SBI05ZLW1314601,67,28,23,5,1
SBI87PNW1570351,74,25,17,8,1
SBI76YEZ5011281,66,25,17,8,1
SBI34BCA1587833,92,20,15,5,1
SBI85KNU1542098,89,24,17,7,1
SBI94VME6571319,87,16,11,5,1
SBI96ZGT7968427,74,28,17,11,1
SBI81DEE5600887,75,27,25,2,1
SBI64RYA1156813,18,28,21,7,1
SBI96AXS7514678,24,24,21,3,1
SBI46EMZ7364149,81,23,16,7,1
SBI49EVW2075257,88,26,18,8,1
SBI06PKT8979433,63,29,26,3,1
SBI88WKV0294953,91,26,25,1,1
SBI10MIQ0875675,84,26,15,11,1
SBI32PPN4271912,69,18,13,5,1
SBI24DIH1298515,87,25,13,12,1
SBI05BLK9956211,88,28,20,8,1
SBI71NGF5855657,19,26,23,3,1
SBI16PUX1734536,84,23,14,9,1
SBI16RQN7830690,83,23,16,7,1
SBI96XAR3278679,94,29,27,2,1
SBI13GBS4497480,22,24,23,1,1
SBI97XEP4073794,20,18,11,7,1
SBI81OXA0541715,80,33,24,9,1
SBI15GVI0921490,67,26,15,11,1
SBI34VDW8770484,98,19,17,2,1
SBI65JBX2578965,89,18,14,4,1
SBI32RVF9978757,96,26,19,7,1
SBI88QEB8316102,84,17,11,6,1
SBI88EKE5371273,81,28,22,6,1
SBI17VZU0994236,80,29,18,11,1
SBI04ZJM2990235,87,23,22,1,1
SBI76SHQ8577885,70,26,20,6,1
SBI00KDN9311555,74,29,24,5,1
SBI52KEF9582269,70,21,14,7,1
SBI27OES8206953,90,29,28,1,1
SBI51MFW2851943,95,26,15,11,1
SBI59TIK3425364,82,28,26,2,1
SBI63TXH0071703,68,25,20,5,1
SBI28HBR3265449,25,21,13,8,1
SBI16GSZ3119236,76,25,15,10,1
SBI23KJN6564913,19,27,22,5,1
SBI38GUL1791467,70,26,23,3,1
SBI48XKC1085527,69,23,18,5,1
SBI81KST8903255,93,22,20,2,1
SBI06HII7348747,67,28,21,7,1
SBI89EJW8330129,63,33,19,14,1
SBI22OKJ8844510,22,17,16,1,1
SBI52QXT2320263,21,27,23,4,1
SBI48QZO1093616,98,23,13,10,1
SBI12IHJ9096497,80,26,15,11,1
SBI25HNA2634353,63,22,19,3,1
SBI52AQE4499144,95,29,15,14,1
SBI87XXU7094575,69,28,24,4,1
SBI23NPG8683092,83,31,17,14,1
SBI21AOU2177539,70,23,19,4,1
SBI27FJI9463691,85,31,29,2,1
SBI57GKV4651796,99,17,13,4,1
SBI89LVK6794219,21,32,30,2,1
SBI75HEI4344348,85,26,20,6,1
SBI49ROW4136728,80,26,22,4,1
SBI99QVQ7254452,71,18,16,2,1
SBI36NOX0456701,88,20,16,4,1
SBI01TGD2585117,74,27,19,8,1
SBI10ZEN2796962,74,24,22,2,1
SBI84GIF1990018,96,22,14,8,1
SBI43QAZ6503365,24,19,10,9,1
SBI28VXM7792077,21,27,26,1,1
SBI77TKT0551864,23,25,23,2,1
SBI26FZC1857929,81,22,13,9,1
SBI59ZLE2158902,84,16,15,1,1
SBI82SGI8909487,24,23,22,1,1
SBI00SRQ9970401,74,19,13,6,1
SBI53COR7541846,81,31,18,13,1
SBI33TMN9938623,80,25,16,9,1
SBI30NRC6055149,61,26,17,9,1
SBI87UWF1209143,24,25,21,4,1
SBI29RFC2796137,72,32,30,2,1
SBI21BMJ2665662,93,26,14,12,1
SBI73FYW1425868,99,22,13,9,1
SBI35KEA0191675,81,17,14,3,1
SBI82JFO6632342,73,21,14,7,1
SBI54FUD0107147,83,26,22,4,1
SBI56VDJ0692066,61,28,23,5,1
SBI04OSM1786801,99,24,14,10,1
SBI89BHV0233318,75,30,26,4,1
SBI23LAG2840401,18,31,27,4,1
SBI08VVV2681408,62,17,11,6,1
SBI72IHR2681176,67,20,15,5,1
SBI69HYY5038283,81,31,23,8,1
SBI36EBM8823511,62,31,30,1,1
SBI39VNJ0533154,95,17,11,6,1
SBI77XSW7541725,96,30,29,1,1
SBI84OEJ5121785,68,27,21,6,1
SBI19WJH1478765,82,26,23,3,1
SBI52HLK7317054,86,23,13,10,1
SBI57KGR9574122,88,21,15,6,1
SBI30UAF3799846,84,24,13,11,1
SBI57TDM8985949,67,32,27,5,1
SBI80RJS4423583,88,34,26,8,1
SBI43OZF3230825,93,19,11,8,1
SBI83MTK9257602,71,25,13,12,1
SBI75XBR6476187,84,34,30,4,1
SBI09UAF6078892,97,15,9,6,1
SBI87ZZE1662418,63,20,14,6,1
SBI56RMI9627776,86,23,18,5,1
SBI69HSO9064775,20,28,23,5,1
SBI38DEI3279506,68,23,15,8,1
SBI49ZZA1314452,85,19,18,1,1
SBI79MUD1152900,84,19,16,3,1
SBI50HHV3784720,80,23,19,4,1
SBI45YIC2552168,65,17,13,4,1
SBI52EGC4001859,61,34,32,2,1
SBI04IBP5776688,19,21,16,5,1
SBI04IHL6781842,77,21,15,6,1
SBI50VCI0062367,22,20,19,1,1
SBI52MXQ5537836,99,31,16,15,1
SBI62CMM5674255,70,20,11,9,1
SBI53TWI7934049,67,25,24,1,1
SBI51DXC9923280,23,22,14,8,1
SBI28ZVA9023376,74,16,10,6,1
SBI85DBD9050956,85,20,14,6,1
SBI21PDR9283858,94,27,25,2,1
SBI57CNH1868611,23,20,16,4,1
SBI37LVK8183106,78,30,25,5,1
SBI81CDN8688268,90,25,18,7,1
SBI40AQQ0423913,86,26,16,10,1
SBI92SDP6687676,66,22,19,3,1
SBI30EEA8528380,73,24,23,1,1
SBI89IRC4466561,78,28,27,1,1
SBI17TRD6489474,77,19,17,2,1
SBI53ISV8032678,18,22,16,6,1
SBI34MVD6365565,69,28,21,7,1
SBI12IWJ3112411,21,15,9,6,1
SBI53BYB0647973,92,26,21,5,1
SBI03LIJ1136088,87,26,25,1,1
SBI63XNA8908677,65,31,23,8,1
SBI34JWN4533367,96,20,18,2,1
SBI21LUM1565014,62,26,21,5,1
SBI78EOL7448597,82,26,14,12,1
SBI92YSV1538924,73,27,25,2,1
SBI23BGF5465404,95,26,16,10,1
SBI01ZBD4024604,89,28,25,3,1
SBI99GUH8974505,85,29,19,10,1
SBI73HCE2724254,82,13,7,6,1
SBI60ZRZ2917799,70,20,11,9,1
SBI01KMT9612353,66,28,16,12,1
SBI62MEV6256272,82,28,16,12,1
SBI48XAR7889147,93,36,34,2,1
SBI85HQW9495806,98,31,18,13,1
SBI99ZCR9909310,23,26,23,3,1
SBI64GCT9569814,66,15,8,7,1
SBI25MNI7921440,62,24,14,10,1
SBI36DEF1513281,65,21,18,3,1
SBI14AWN5669368,71,28,27,1,1
SBI92KOU2543954,85,30,27,3,1
SBI49EQY7693028,79,21,18,3,1
SBI88XCO8139194,24,25,13,12,1
SBI71SDN6791547,67,34,33,1,1
SBI78QSS7412647,75,25,21,4,1
SBI86OYE8904496,67,25,21,4,1
SBI74JJG5588846,91,13,12,1,1
SBI71NMZ7868525,24,29,24,5,1
SBI95NHC8265484,70,19,18,1,1
SBI08PGP8117442,93,17,12,5,1
SBI13THG2499369,94,26,16,10,1
SBI29ZYF3897902,81,37,24,13,1
SBI20TRU0752299,72,26,24,2,1
SBI43DAB4462012,79,22,13,9,1
SBI14QAQ4518469,24,20,17,3,1
SBI73WIP5311724,68,26,21,5,1
SBI24GBA3592305,84,25,15,10,1
SBI05WGL7818890,91,28,24,4,1
SBI68QOV2324721,78,23,12,11,1
SBI64UKA8281131,66,23,15,8,1
SBI74EEG1059021,68,22,14,8,1
SBI09SNP5440551,92,26,18,8,1
SBI13RTF2157392,88,20,18,2,1
SBI75LKL6353678,63,17,11,6,1
SBI32DPX7821633,66,13,11,2,1
SBI74CYA8736945,66,25,17,8,1
SBI41JJG7147466,86,33,20,13,1
SBI42YOY8759243,23,22,14,8,1
SBI33UOI9592181,63,21,14,7,1
SBI31JWG7464986,90,32,31,1,1
SBI00EKF1842646,81,26,15,11,1
SBI71FJN9571568,24,13,7,6,1
SBI12XYE5607164,70,24,22,2,1
SBI03SRK9309938,81,27,20,7,1
SBI03DGZ0452369,79,30,21,9,1
SBI38DIC4016759,93,26,22,4,1
SBI67HVL3844204,92,18,11,7,1
SBI29QQG5377944,80,19,12,7,1
SBI81TIB6542252,77,26,20,6,1
SBI98TGO6667120,88,20,13,7,1
SBI84PWI2255243,98,24,19,5,1
SBI99NAT4097670,78,28,25,3,1
SBI31KUA7724150,71,20,11,9,1
SBI68BRB8690582,98,29,28,1,1
SBI96SCH4636696,91,20,13,7,1
SBI51LZL7657256,82,18,13,5,1
SBI26VWF6621005,19,23,12,11,1
SBI02VVQ1821543,87,15,11,4,1
SBI23YBN2072671,88,26,16,10,1
SBI92RTS5712902,99,27,23,4,1
SBI00TUH7503523,80,22,15,7,1
SBI86JYG5948623,91,30,27,3,1
SBI95GRB1378451,98,23,16,7,1
SBI56OJE6861260,72,19,11,8,1
SBI83TUF4952067,96,31,21,10,1
SBI75STH7858791,60,26,24,2,1
SBI63BOW0142527,18,30,26,4,1
SBI90FYF9092641,80,30,18,12,1
SBI90VAR3768043,74,24,21,3,1
SBI59BTU5188988,82,19,18,1,1
SBI81EFK6648286,85,25,14,11,1
SBI56PBC9313822,21,23,21,2,1
SBI19JFX2855670,96,16,9,7,1
SBI81UEA7966649,79,25,16,9,1
SBI93EYW1478983,78,23,20,3,1
SBI55WHF5314237,87,20,13,7,1
SBI10DYR9025762,90,33,22,11,1
SBI50CLM5889646,77,21,20,1,1
SBI25CAH7816771,84,15,8,7,1
SBI32QDL7344337,87,24,13,11,1
SBI07VYS0309527,24,23,19,4,1
SBI36ZWP9333108,71,18,10,8,1
SBI52LPG6693666,76,23,22,1,1
SBI51DUP1302189,99,21,20,1,1
SBI66HUU8371379,98,24,21,3,1
SBI30GUD4407900,70,30,22,8,1
SBI59QGJ5862066,63,34,33,1,1
SBI86QBU1286788,69,27,23,4,1
SBI26RLQ3144990,21,17,13,4,1
SBI43TIW3094987,76,19,17,2,1
SBI56KDZ2452862,81,28,23,5,1
SBI61LDF6533630,98,25,13,12,1
SBI23TSC8798770,74,31,27,4,1
SBI28QUJ9602811,62,21,14,7,1
SBI07RPB9233982,67,17,16,1,1
SBI41EBU0222514,97,29,15,14,1
SBI53VBY7749892,91,20,15,5,1
SBI37GRW2934948,80,19,16,3,1
SBI12NGZ9489430,81,26,24,2,1
SBI30JTC4110461,66,24,23,1,1
SBI71DZJ8751811,76,24,18,6,1
SBI04VZN7731082,64,37,25,12,1
SBI20TRY0959050,79,20,15,5,1
SBI96GAE9250083,94,25,13,12,1
SBI42CVX3150578,93,14,10,4,1
SBI83XWT4759170,95,31,28,3,1
SBI42ZRC3848079,67,23,16,7,1
SBI94PRY1174899,99,28,27,1,1
SBI63QZZ3511485,68,24,17,7,1
SBI50IFF9743236,72,19,11,8,1
SBI37CUG5383062,63,25,23,2,1
SBI13UMU9857323,60,31,21,10,1
SBI29IZD0535221,62,23,16,7,1
SBI34YEM8903285,75,25,16,9,1
SBI70AAL1355581,85,27,16,11,1
SBI88ENG9583173,95,22,17,5,1
SBI21PFY3203068,78,20,15,5,1
SBI05PAK1239661,22,27,26,1,1
SBI00YDB4568185,99,17,15,2,1
SBI83JLE8017404,62,22,20,2,1
SBI92PTV7851914,87,24,13,11,1
SBI67LNV9481699,60,20,11,9,1
SBI53AID0838050,90,30,27,3,1
SBI46ZGX7946371,91,28,27,1,1
SBI62ZRJ4351424,77,26,25,1,1
SBI97TYX1470668,89,23,22,1,1
SBI01SCJ3146527,18,31,20,11,1
SBI18VGE0572053,82,22,17,5,1
SBI27FFB7096499,78,24,18,6,1
SBI38OKZ8650636,91,25,19,6,1
SBI22JDM7242211,72,14,8,6,1
SBI20VXP0387488,96,30,23,7,1
SBI50MNV8544504,60,22,17,5,1
SBI59OAT2865687,23,29,25,4,1
SBI06WMS0603027,65,22,20,2,1
SBI14ZIX4102862,63,34,22,12,1
SBI18TFG1339014,82,23,19,4,1
SBI71MJZ0643632,84,12,8,4,1
SBI20SGA4456201,79,21,15,6,1
SBI98KOV8644615,97,24,14,10,1
SBI12NKE8127413,79,27,25,2,1
SBI54WGP3515974,60,28,16,12,1
SBI25LNK7926757,95,29,21,8,1
SBI62PZI0324490,62,24,23,1,1
SBI15ZLG5825415,68,19,13,6,1
SBI66LCR7334519,93,24,23,1,1
SBI27HJE7786129,90,22,15,7,1
SBI25CUI0539637,68,27,23,4,1
SBI01QYR1143797,98,26,15,11,1
SBI59ECU5165204,91,23,12,11,1
SBI74KUA1100854,85,21,13,8,1
SBI81KGD8327269,89,21,15,6,1
SBI77MTV2146634,95,13,7,6,1
SBI70NGP2949483,70,27,16,11,1
SBI70DBC3596301,77,27,22,5,1
SBI97QEE9974297,74,22,21,1,1
SBI16VNQ3942340,82,16,14,2,1
SBI02RTC0547407,72,20,18,2,1
SBI78QQX7964947,67,26,24,2,1
SBI96ARS8935946,61,20,18,2,1
SBI31PWL6723869,81,26,21,5,1
SBI70VMA1119094,93,27,18,9,1
SBI37UGU4309714,78,30,21,9,1
SBI31DZM7801701,94,27,14,13,1
SBI80HFZ3032403,71,28,17,11,1
SBI31KVM8114061,88,29,28,1,1
SBI15CCA0397751,94,23,12,11,1
SBI60BZV6516876,96,34,23,11,1
SBI24YHX8113309,25,14,12,2,1
SBI11TAX2138023,20,19,16,3,1
SBI41HMC0420991,67,27,16,11,1
SBI49WSI0495212,80,23,21,2,1
SBI62XVR0416264,99,24,21,3,1
SBI63RGT1710299,98,21,14,7,1
SBI35DLW2704535,84,19,16,3,1
SBI65UPW5550070,61,22,18,4,1
SBI72OSH8637234,67,23,17,6,1
SBI43GGY5114886,60,19,10,9,1
SBI81DPR9266951,98,26,17,9,1
SBI56UIO1758486,96,18,16,2,1
SBI00LSK8301908,25,28,24,4,1
SBI05MGA5359917,89,25,23,2,1
SBI62MNU9201868,93,22,17,5,1
SBI50JJR8834293,80,20,19,1,1
SBI79TXR4123436,75,32,30,2,1
SBI47ZYE0922588,62,20,11,9,1
SBI19RFU7161075,68,21,19,2,1
SBI77AGC8556790,72,32,29,3,1
SBI15CSV6672287,90,26,21,5,1
SBI03SQW8638956,83,31,28,3,1
SBI26GCH8204729,74,26,14,12,1
SBI09JNN2774482,84,22,21,1,1
SBI58KKF6188374,73,17,14,3,1
SBI47UXS8532607,65,34,18,16,1
SBI88HDE8276915,22,31,23,8,1
SBI28DSF5445072,21,20,14,6,1
SBI56NES9120843,77,27,16,11,1
SBI20HPQ2564501,86,25,14,11,1
SBI52YNP8610208,78,18,10,8,1
SBI51WVX3097032,67,26,23,3,1
SBI75HUD7067852,79,22,20,2,1
SBI72JAF5756389,22,31,21,10,1
SBI30FJO3798320,88,24,13,11,1
SBI45TTM5059346,84,20,18,2,1
SBI34EXM8169883,91,26,17,9,1
SBI26FGX9268209,63,17,9,8,1
SBI56AKA1119832,86,18,12,6,1
SBI60LIZ2078949,80,15,9,6,1
SBI76DZY1247917,77,29,23,6,1
SBI32ZQL2041871,69,17,16,1,1
SBI40EMF6357471,91,34,23,11,1
SBI99RBN4357064,76,25,19,6,1
SBI83KFW4258779,75,25,16,9,1
SBI74BUH1826413,60,28,16,12,1
SBI91VEY2957934,60,16,15,1,1
SBI78RAH5372294,70,17,10,7,1
SBI92VLV7357485,65,23,12,11,1
SBI38APM0194533,73,16,15,1,1
SBI82WIB2074677,80,17,9,8,1
SBI90PLY5012988,82,21,20,1,1
SBI94TYE5810150,94,24,20,4,1
SBI63ITE2420133,65,21,12,9,1
SBI11FVB1549405,72,19,14,5,1
SBI47QCM2145342,93,31,25,6,1
SBI81ITQ7686631,91,21,20,1,1
SBI18LXE4040704,24,21,14,7,1
SBI37ORF3922074,61,19,15,4,1
SBI87UKC0771492,97,26,15,11,1
SBI72EDN5722698,61,27,24,3,1
SBI38DNJ3484139,61,25,19,6,1
SBI18OWY1982379,97,24,19,5,1
SBI08ZCH5398016,71,28,23,5,1
SBI79FBU8183127,70,39,24,15,1
SBI84ZTJ9200711,97,30,18,12,1
SBI54HFV3719170,71,30,21,9,1
SBI93RZH9752946,88,28,25,3,1
SBI31XEQ4575045,85,23,14,9,1
SBI52XGE7721238,19,22,20,2,1
SBI19IDT7885940,70,19,18,1,1
SBI20AMB8187165,89,24,21,3,1
SBI70TCI2945465,64,25,21,4,1
SBI54JWO8872137,64,27,16,11,1
SBI98LLT8223662,93,27,19,8,1
SBI94HLS9558250,65,22,18,4,1
SBI48HOB5133426,63,32,17,15,1
SBI41UOG6916420,73,30,21,9,1
SBI80XRS6756973,82,24,16,8,1
SBI63XSE8572227,89,26,18,8,1
SBI40YJB1613530,64,25,21,4,1
SBI97SJL2109838,95,17,13,4,1
SBI61LVQ7586445,61,18,11,7,1
SBI79YQT7807062,96,26,22,4,1
SBI79LJW8152860,24,25,19,6,1
SBI81RYE0136195,97,23,18,5,1
SBI11LEQ7439477,80,18,16,2,1
SBI48WNI2031503,87,26,25,1,1
SBI41VGJ8656124,73,23,12,11,1
SBI64GVD8959035,68,31,19,12,1
SBI26NOK8673089,20,24,23,1,1
SBI95HRE5563915,89,18,12,6,1
SBI77CFT6541571,88,24,18,6,1
SBI60EMC0772490,94,15,14,1,1
SBI59NRY7546895,77,29,23,6,1
SBI90YMB7440926,89,21,19,2,1
SBI14LFE9466297,88,18,11,7,1
SBI09GKE1171858,84,21,19,2,1
SBI89NNL7207562,74,27,23,4,1
SBI76DTZ3625877,84,28,17,11,1
SBI75VQL5767790,25,28,20,8,1
SBI67KKH0963560,89,25,16,9,1
SBI86QHE6386097,99,22,17,5,1
SBI83YDW1600370,94,23,22,1,1
SBI52HQT7291729,88,20,14,6,1
SBI51ORJ3637113,87,28,24,4,1
SBI10WBS4664345,19,30,19,11,1
SBI82LKK8252048,25,28,18,10,1
SBI58VDX3260295,72,26,25,1,1
SBI50IUY3105531,96,25,14,11,1
SBI82SJN5680387,90,31,21,10,1
SBI65NLC3634883,85,35,18,17,1
SBI58XGN3182995,91,26,19,7,1
SBI86UYZ7049975,72,19,16,3,1
SBI00DQB5367865,81,20,17,3,1
SBI87TJZ1928649,69,22,17,5,1
SBI10YII4490655,61,27,16,11,1
SBI78OMY0619307,65,27,16,11,1
SBI72FXX5350340,80,33,28,5,1
SBI29PMZ1498998,87,25,16,9,1
SBI28OCR5501531,81,21,19,2,1
SBI33MUP9183868,83,19,10,9,1
SBI28QBY1226634,73,24,23,1,1
SBI71PVU6051557,78,17,9,8,1
SBI32CYG0399242,89,31,29,2,1
SBI37DKL1701274,62,35,21,14,1
SBI33VHP7811987,75,39,22,17,1
SBI80UUD5142740,94,26,22,4,1
SBI24FKQ2515432,77,24,20,4,1
SBI14PKT9743307,90,29,20,9,1
SBI82QXJ2836369,87,35,31,4,1
SBI98ZOL0328348,72,21,12,9,1
SBI45MQC4065294,65,22,20,2,1
SBI87EPF9984858,76,24,15,9,1
SBI46JWF0768579,60,18,11,7,1
SBI46IKU0017781,77,28,18,10,1
SBI55MOB5461240,76,33,30,3,1
SBI01MRN8827393,96,23,21,2,1
SBI47USA9535105,70,30,24,6,1
SBI62JRQ6699492,98,16,12,4,1
SBI51VLC9224635,95,27,18,9,1
SBI84KWP5627998,18,22,14,8,1
SBI78NEI8826186,82,19,15,4,1
SBI02HZQ4034006,25,33,18,15,1
SBI89GCD7190376,85,29,22,7,1
SBI84PPA6132418,24,26,16,10,1
SBI00XGT1653193,91,28,26,2,1
SBI07JOU4233237,87,23,15,8,1
SBI30GPT3417051,73,23,20,3,1
SBI81RCJ7939976,18,23,17,6,1
SBI69URK6584597,82,30,24,6,1
SBI94GDP1183479,66,30,16,14,1
SBI14VWF3532999,76,18,17,1,1
SBI93JPB4877239,67,27,25,2,1
SBI17AOG5811873,76,30,21,9,1
SBI98DLT7071760,71,24,20,4,1
SBI92SMF1816971,67,23,17,6,1
SBI84FVD7584778,88,25,23,2,1
SBI97ZIE8036951,63,33,24,9,1
SBI38RZH5428564,87,26,19,7,1
SBI39UTW4108613,77,25,20,5,1
SBI04WPQ7108178,62,29,15,14,1
SBI53ECF1650020,87,16,13,3,1
SBI46QUT1796350,87,23,14,9,1
SBI80SFS7314204,95,31,18,13,1
SBI08ISC4091573,92,13,7,6,1
SBI89ZTK8631098,60,30,17,13,1
SBI41QBN3060226,81,26,15,11,1
SBI80VJJ0889506,95,19,12,7,1
SBI39FJR0014583,65,22,19,3,1
SBI83THL1299795,88,27,16,11,1
SBI89ICK8429166,76,35,34,1,1
SBI23UDW6851202,63,19,12,7,1
SBI36SJA1588625,73,22,16,6,1
SBI96NXL3640659,70,31,27,4,1
SBI73JVR7560836,63,32,28,4,1
SBI31TCV2052002,86,25,23,2,1
SBI61UDS4101986,19,33,25,8,1
SBI51HNS4894306,21,37,26,11,1
SBI52BNL6664054,80,30,29,1,1
SBI45ETB2846604,71,23,20,3,1
SBI08LDN2328611,25,24,22,2,1
SBI35IOJ9786785,72,27,16,11,1
SBI49JAV1096844,19,17,16,1,1
SBI07DRX2273577,92,26,18,8,1
SBI64IXL1953456,83,20,12,8,1
SBI28MXJ1502302,25,29,15,14,1
SBI91WZO7312276,23,21,19,2,1
SBI29RGI8435660,78,25,23,2,1
SBI44RBF2940804,23,25,17,8,1
SBI12XDP5688751,63,17,12,5,1
SBI61VGT3031207,60,36,33,3,1
SBI82KKT2670723,23,17,9,8,1
SBI99DKR8100962,64,28,20,8,1
SBI59DAO2598051,71,16,9,7,1
SBI02PHZ7490550,96,28,16,12,1
SBI55IBQ1104491,76,15,10,5,1
SBI57RJM6423571,20,30,29,1,1
SBI85LFA0068645,83,24,21,3,1
SBI60RYA8987724,68,27,24,3,1
SBI17TVS1598036,61,28,20,8,1
SBI00JOA8392472,95,18,14,4,1
SBI24JEJ1784992,90,29,22,7,1
SBI15IEB5914277,69,22,15,7,1
SBI18JUE5781462,62,36,29,7,1
SBI86OBC9675923,95,18,12,6,1
SBI82FIM4362078,69,27,26,1,1
SBI51HNN0055880,20,19,14,5,1
SBI16EMQ3222993,91,23,20,3,1
SBI73XYW5090481,69,28,23,5,1
SBI50MNR6994501,93,29,20,9,1
SBI15KFA5953335,71,25,24,1,1
SBI93QMV5566629,83,21,16,5,1
SBI00LER4999496,75,18,14,4,1
SBI34GRU7137442,96,20,15,5,1
SBI76QTR9999892,62,14,11,3,1
SBI42UWU0108770,69,20,14,6,1
SBI71CDC6107973,20,28,16,12,1
SBI85WHZ4573021,83,30,23,7,1
SBI52OZT0270382,76,19,12,7,1
SBI52GGL4313119,89,20,16,4,1
SBI43CWB6820742,83,23,16,7,1
SBI54PND7679089,75,22,20,2,1
SBI14TIL4761265,65,34,23,11,1
SBI13TGG8831418,95,15,12,3,1
SBI39OSO9721468,68,29,20,9,1
SBI18VCV2455127,98,25,18,7,1
SBI18PFV8273495,73,18,14,4,1
SBI94WBQ2537757,24,18,17,1,1
SBI65DYH7670534,86,34,33,1,1
SBI53EHD1481062,76,26,22,4,1
SBI29ANZ6241629,75,23,22,1,1
SBI18KHI0036501,91,34,27,7,1
SBI96KJE4507175,65,27,14,13,1
SBI15GOX4545976,25,28,26,2,1
SBI98XSJ1010055,85,22,12,10,1
SBI29ZYD6285032,23,20,15,5,1
SBI29NYE8860283,64,19,11,8,1
SBI07MGX4722729,99,24,17,7,1
SBI30DYC5407303,89,33,30,3,1
SBI24GLO7791122,96,26,22,4,1
SBI12LKP5614119,23,21,17,4,1
SBI06RJE7975191,91,26,25,1,1
SBI85YYQ1039983,97,17,14,3,1
SBI54XZK7008425,82,23,21,2,1
SBI00OUJ1390304,73,28,22,6,1
SBI14QZQ0243722,63,26,16,10,1
SBI08XGJ5928143,86,14,9,5,1
SBI44FZJ4024003,96,21,17,4,1
SBI43PYB6503169,88,17,15,2,1
SBI51FJK5340669,23,28,26,2,1
SBI13GFO2313571,69,25,19,6,1
SBI38EBA7180247,74,21,17,4,1
SBI75EYD2078543,22,28,25,3,1
SBI91YVX8283162,62,31,22,9,1
SBI97OVZ6781068,21,26,18,8,1
SBI93PQR9873561,86,32,25,7,1
SBI36ILZ1503028,60,21,19,2,1
SBI82FWX8607397,68,26,21,5,1
SBI89HLE4762563,79,20,16,4,1
SBI51RWB4817273,76,31,24,7,1
SBI16RHX3591256,83,31,16,15,1
SBI04IHG8272886,23,27,16,11,1
SBI44LXF1751603,97,24,13,11,1
SBI90LBR9587869,97,28,20,8,1
SBI31FYY7612141,93,26,17,9,1
SBI15OOI1166900,78,28,17,11,1
SBI04WCI5943719,75,22,14,8,1
SBI24XBN5448679,61,24,23,1,1
SBI66YVR4118538,21,29,20,9,1
SBI13TYD4942884,82,24,21,3,1
SBI62LHI1300594,82,31,18,13,1
SBI49WFH6731378,80,22,16,6,1
SBI51GXM3059723,82,33,31,2,1
SBI28SDP9689801,76,33,18,15,1
SBI27PUN0040716,92,19,13,6,1
SBI79TXH0061078,67,27,26,1,1
SBI94SNL7873565,62,23,18,5,1
SBI52ANM0882215,71,24,15,9,1
SBI12DEJ2310082,25,24,20,4,1
SBI86VXD7157583,97,27,19,8,1
SBI54REZ6160908,61,26,25,1,1
SBI48TWJ4930227,71,19,10,9,1
SBI06OGT0292636,60,24,18,6,1
SBI53YQR1130099,83,27,23,4,1
SBI81JXL1756305,79,24,19,5,1
SBI69VAW6934498,87,22,17,5,1
SBI51XRL3358495,81,17,11,6,1
SBI34DXR4198187,70,29,15,14,1
SBI26UJV2979426,88,28,25,3,1
SBI86YAF0587703,24,33,21,12,1
SBI13TNC2789062,22,21,15,6,1
SBI61QGF0173845,60,18,17,1,1
SBI48CGG9655158,82,32,24,8,1
SBI76YLI0641999,23,24,19,5,1
SBI96VML5699682,25,28,17,11,1
SBI16UFV0151927,21,33,17,16,1
SBI64KAG3149251,94,18,12,6,1
SBI79JGZ6842290,94,28,22,6,1
SBI86XAO6458146,79,22,15,7,1
SBI36EHD4747666,96,24,14,10,1
SBI49VHU3970722,63,31,29,2,1
SBI96ZIK4026434,66,26,15,11,1
SBI52ITH0334607,23,25,19,6,1
SBI70EVP2198266,78,23,21,2,1
SBI32EIT5611770,85,21,15,6,1
SBI61KHM3903618,94,29,22,7,1
SBI97ZLM3215928,98,23,21,2,1
SBI34ZQX0056951,25,32,17,15,1
SBI66ZAZ6394759,64,23,19,4,1
SBI97PIU5300768,22,13,7,6,1
SBI19REJ5498838,98,16,15,1,1
SBI21FKH1089316,87,30,19,11,1
SBI79OBI4869220,81,31,18,13,1
SBI60URO1558178,68,22,20,2,1
SBI59FVU5145802,97,22,16,6,1
SBI18MZW2154184,18,23,16,7,1
SBI27WAA0731498,71,26,16,10,1
SBI10XXQ2957910,65,17,14,3,1
SBI90GNK8023746,61,33,22,11,1
SBI56NJJ5011890,82,24,22,2,1
SBI77GCV8169069,62,26,19,7,1
SBI38EPU1409543,24,16,12,4,1
SBI02CDH8887179,95,19,17,2,1
SBI98CMN0288882,75,21,11,10,1
SBI29CZZ7775856,89,23,21,2,1
SBI86ZHV9018415,62,20,13,7,1
SBI37HIA2463964,92,27,18,9,1
SBI90XUD2310454,62,18,16,2,1
SBI21JIL2089713,66,32,17,15,1
SBI67NBP9991396,24,20,11,9,1
SBI13YSR7358512,68,30,18,12,1
SBI72QUC6358350,69,32,24,8,1
SBI57EST0185508,63,21,15,6,1
SBI53LHK2101691,97,28,22,6,1
SBI30RAK2462799,65,22,15,7,1
SBI58YTF0311127,20,21,12,9,1
SBI90ESJ2571647,73,23,18,5,1
SBI34NSV0024695,95,18,16,2,1
SBI60QIL8359989,79,18,14,4,1
SBI59SII7262810,94,22,15,7,1
SBI42OYU1280833,21,31,27,4,1
SBI09QIU7994344,77,24,18,6,1
SBI08BNA2617773,61,26,17,9,1
SBI38LSK6985773,21,20,11,9,1
SBI20IQX2480050,80,26,20,6,1
SBI30CFH5040343,67,27,19,8,1
SBI83HOX3361587,62,24,22,2,1
SBI40BEO4886170,76,22,13,9,1
SBI05DLD6549494,60,21,20,1,1
SBI01ANJ0560682,98,26,18,8,1
SBI30LQO4982713,61,28,15,13,1
SBI97QYC7055435,25,13,10,3,1
SBI25HDL6590369,63,17,13,4,1
SBI24WAH3010201,91,26,19,7,1
SBI51AQV2571441,91,20,13,7,1
SBI35QHR8649592,74,25,15,10,1
SBI77MYI3181840,89,26,16,10,1
SBI96NIM7000440,79,21,13,8,1
SBI11HON6093069,95,24,19,5,1
SBI01FPT2762007,83,26,23,3,1
SBI34SKF6258371,79,28,19,9,1
SBI41UGW4423591,76,29,23,6,1
SBI84SIS4230334,21,25,19,6,1
SBI31IWE6356855,60,32,19,13,1
SBI44WKB7311998,79,27,16,11,1
SBI66EHH1222440,78,16,15,1,1
SBI11WZB1146934,97,27,26,1,1
SBI54JEV8555876,88,24,13,11,1
SBI01QHK3857558,87,21,19,2,1
SBI96WPK9255202,98,24,19,5,1
SBI93YEF5272127,96,22,20,2,1
SBI74AXZ7955156,96,24,19,5,1
SBI28SFN9031941,69,20,15,5,1
SBI76AOL7395920,62,25,22,3,1
SBI77DWJ9199004,99,17,11,6,1
SBI58HXB6875550,64,28,15,13,1
SBI86EJP7923554,82,20,19,1,1
SBI66BOF3249832,78,30,22,8,1
SBI93FUA9709963,90,28,21,7,1
SBI96NPO0512948,68,25,15,10,1
SBI72PYO5122235,68,11,6,5,1
SBI08BIP1779227,64,29,17,12,1
SBI97TMJ0449926,22,32,20,12,1
SBI90MWK1160436,88,27,17,10,1
SBI63MIH6873910,91,18,10,8,1
SBI68LME2953337,66,19,14,5,1
SBI42CYX6672408,18,15,11,4,1
SBI42BXW0739182,60,25,17,8,1
SBI75GUX5566029,92,34,33,1,1
SBI34BBY2194339,72,25,15,10,1
SBI47JUP7019211,70,22,16,6,1
SBI77NTK3978893,96,22,16,6,1
SBI50BZJ6189849,70,27,22,5,1
SBI02BKW9276041,20,22,17,5,1
SBI85XOY9598319,95,34,24,10,1
SBI72XTN9434647,71,18,15,3,1
SBI95JSI8355524,81,31,22,9,1
SBI92BXT4832052,20,31,19,12,1
SBI32KLH1705685,92,32,22,10,1
SBI37WBC6110195,68,28,19,9,1
SBI92HIQ6149201,22,25,24,1,1
SBI91HNL8294245,81,24,15,9,1
SBI52KHN7170382,68,30,20,10,1
SBI81VTG0786894,82,26,22,4,1
SBI02AZM8936494,19,22,18,4,1
SBI82OAC6679948,66,28,22,6,1
SBI29WVF1672849,22,19,17,2,1
SBI91ZUE8456068,22,23,15,8,1
SBI34FUH3264145,68,29,21,8,1
SBI42PQL9205779,24,27,20,7,1
SBI99GJL4678304,87,9,5,4,1
SBI65QPP1920409,85,20,12,8,1
SBI53SXM3638226,70,21,12,9,1
SBI82IKA7828894,92,19,11,8,1
SBI85NXU2085888,21,30,17,13,1
SBI67LGY9625009,75,23,12,11,1
SBI21HDR4225479,86,33,22,11,1
SBI08FPM7377978,96,31,18,13,1
SBI63MMY3486036,21,15,12,3,1
SBI62QML6665553,82,26,15,11,1
SBI98QGV1767029,21,19,17,2,1
SBI04TSP2320332,69,16,9,7,1
SBI32EUI5731481,21,17,10,7,1
SBI59BDN8049422,73,21,14,7,1
SBI27ZVS4703297,68,16,12,4,1
SBI66CIV2102844,88,25,19,6,1
SBI26WMU9655186,74,29,17,12,1
SBI14KNQ9550483,69,24,18,6,1
SBI44PKA2491806,86,18,11,7,1
SBI16TZC9882136,82,28,24,4,1
SBI67JPG5323558,75,27,14,13,1
SBI99SYG8541445,85,30,21,9,1
SBI77NGC2270744,66,24,22,2,1
SBI89YPA6303764,89,24,19,5,1
SBI05WGW3720460,75,25,21,4,1
SBI34KQC9728254,63,28,26,2,1
SBI51KRL8264673,63,27,22,5,1
SBI63RWD7400600,78,24,22,2,1
SBI41TLV3238082,93,34,30,4,1
SBI52XPC4641402,90,23,21,2,1
SBI01HTG1549991,76,27,16,11,1
SBI22NBU3232649,74,26,14,12,1
SBI56TSM4227254,73,27,20,7,1
SBI08EJL6935418,20,22,20,2,1
SBI07EBS0964157,65,22,21,1,1
SBI87GVZ8632059,73,32,23,9,1
SBI10LJP2879689,73,19,10,9,1
SBI56BTT4886800,98,21,17,4,1
SBI32MWZ0497914,90,24,14,10,1
SBI58LIX6553691,90,33,29,4,1
SBI88LMG8732945,24,22,18,4,1
SBI81SKA3474539,73,25,16,9,1
SBI60XUP5023026,82,33,24,9,1
SBI36KMD2029374,75,20,13,7,1
SBI81RHT0787157,84,27,18,9,1
SBI60UMX7683311,82,22,14,8,1
SBI02MXB2473196,70,23,17,6,1
SBI71JRP0143618,75,21,18,3,1
SBI81MLS3113042,65,28,23,5,1
SBI72KNX0117599,83,23,22,1,1
SBI11PTT9974203,63,21,11,10,1
SBI94AUD1953873,21,33,19,14,1
SBI05ZXK5598063,69,23,15,8,1
SBI08MFE8451213,71,21,11,10,1
SBI25CPL2661965,74,19,11,8,1
SBI32KHT8592335,66,24,23,1,1
SBI10KEF6482920,91,21,15,6,1
SBI82KPI3580173,78,32,27,5,1
SBI58VTX8402101,95,36,24,12,1
SBI54VVV1015188,66,26,21,5,1
SBI51KIB9891410,22,32,26,6,1
SBI34CVX3193238,61,27,16,11,1
SBI66NNX0752451,98,16,10,6,1
SBI45FXK5524009,19,28,21,7,1
SBI41RFT9674637,70,29,21,8,1
SBI59ADX1603620,18,25,16,9,1
SBI04MRF3478425,63,24,14,10,1
SBI66QAJ8685767,66,32,26,6,1
SBI72ITP4125548,78,18,12,6,1
SBI13TUG5397303,84,24,23,1,1
SBI08IZN5642730,82,23,20,3,1
SBI07UOX5215568,64,25,20,5,1
SBI11RSX2217444,24,25,17,8,1
SBI14CTK4251815,22,32,20,12,1
SBI72ZUN0073940,75,14,11,3,1
SBI90QWL3888990,78,28,22,6,1
SBI19PAH6854437,23,17,12,5,1
SBI06UWL0617242,95,21,16,5,1
SBI52HKH6084716,98,20,13,7,1
SBI14PSK3536152,69,32,20,12,1
SBI79ZTX4421346,62,22,14,8,1
SBI02CFB3479891,63,13,10,3,1
SBI57FSK4240412,93,24,16,8,1
SBI63ZVR4208616,68,27,17,10,1
SBI17SNM6557342,77,25,24,1,1
SBI19CRM7239955,87,19,10,9,1
SBI51NFQ2080412,63,24,14,10,1
SBI91MLE8304174,85,30,19,11,1
SBI01NEE4502944,64,33,18,15,1
SBI63POE3987509,23,27,24,3,1
SBI28SHJ3262509,76,27,21,6,1
SBI75DOW4264020,74,30,18,12,1
SBI15DAQ1591807,23,25,21,4,1
SBI54UAO6872198,91,18,11,7,1
SBI22OYD6690947,18,32,21,11,1
SBI04HFT6315124,67,25,18,7,1
SBI20ILG0140080,89,23,19,4,1
SBI68CTG5559981,95,11,8,3,1
SBI13AEW3395084,65,26,24,2,1
SBI14HZA1133103,91,31,17,14,1
SBI44NHP2739654,96,24,14,10,1
SBI03ZOH4501778,90,22,16,6,1
SBI85EPE4228162,98,27,25,2,1
SBI51JCC9588151,69,20,13,7,1
SBI58FTN2563571,84,31,25,6,1
SBI22MIM0481003,85,22,13,9,1
SBI36GDJ7437694,80,23,15,8,1
SBI09DYE7006735,23,22,20,2,1
SBI91DZZ9621961,66,13,11,2,1
SBI95KCG4265562,70,29,17,12,1
SBI36NXL1935044,70,32,22,10,1
SBI77VHR0708786,25,22,15,7,1
SBI45QNO6177322,19,17,13,4,1
SBI35TSD9686792,61,20,13,7,1
SBI84GED3932215,81,27,14,13,1
SBI56QEF6774379,74,31,19,12,1
SBI61KLM7875787,75,28,27,1,1
SBI91XRY7310631,61,25,19,6,1
SBI30DZW0981915,21,27,15,12,1
SBI30JOJ2301154,69,31,17,14,1
SBI39HRJ5557308,20,23,13,10,1
SBI39YLL6713666,71,21,16,5,1
SBI78IXB7858299,66,31,19,12,1
SBI75YNY6484866,71,28,27,1,1
SBI03HLQ3078562,99,26,17,9,1
SBI59HSP0028078,63,20,19,1,1
SBI64UNN3921566,25,23,21,2,1
SBI16VPI7489820,64,27,16,11,1
SBI94ISS8247652,75,23,16,7,1
SBI70UXX2244879,97,30,20,10,1
SBI08HQV1874813,95,18,14,4,1
SBI05VVW7440267,65,22,15,7,1
SBI46BVL9406909,79,24,22,2,1
SBI06CFH4215874,67,33,20,13,1
SBI18OGG8370704,94,22,18,4,1
SBI87GPW0030677,77,23,13,10,1
SBI36ATH4901718,69,20,16,4,1
SBI60IYQ2522840,79,25,15,10,1
SBI83DHB2233932,85,19,12,7,1
SBI75VFG6196910,62,35,30,5,1
SBI05FQD0331327,23,33,21,12,1
SBI51MOT4501768,96,18,13,5,1
SBI30EXD9051035,18,21,12,9,1
SBI55KEW3496834,19,28,19,9,1
SBI20HYI2781651,19,23,17,6,1
SBI15FPG3660150,94,20,15,5,1
SBI07PLC3267879,86,45,41,4,1
SBI88FEV7744958,23,29,19,10,1
SBI24GUM4281415,77,26,25,1,1
SBI90EYH5930394,78,37,34,3,1
SBI62FBQ7358548,25,17,10,7,1
SBI71SLC3135043,24,24,14,10,1
SBI95JMM6774086,73,26,23,3,1
SBI22NSB6549584,23,36,26,10,1
SBI75YFZ0245203,64,22,15,7,1
SBI11VGD0965273,71,21,20,1,1
SBI25PBF7279817,22,24,22,2,1
SBI40JAR4528539,91,33,30,3,1
SBI05KMP0355544,67,23,12,11,1
SBI22FPC2033403,90,16,9,7,1
SBI57GWA2878098,78,21,20,1,1
SBI34NOK1007135,72,32,22,10,1
SBI93GZK7816720,18,21,15,6,1
SBI02KQP1748521,84,27,19,8,1
SBI75EBZ5073984,78,25,16,9,1
SBI71PIA0708167,23,24,23,1,1
SBI22IBJ2849735,62,26,23,3,1
SBI52DPI6853298,72,25,18,7,1
SBI19HVC5284402,21,25,13,12,1
SBI51KTS6143778,66,27,19,8,1
SBI87XND4738664,88,33,25,8,1
SBI34WAF3435244,68,25,15,10,1
SBI89PSB4334714,75,21,19,2,1
SBI33IOU3542768,98,38,24,14,1
SBI78HKW7023210,85,32,27,5,1
SBI60TGK9567063,94,28,15,13,1
SBI51IGQ1229295,97,25,24,1,1
SBI00IAW9500713,61,25,13,12,1
SBI17HTR4882521,24,27,15,12,1
SBI81UPX7963743,68,19,10,9,1
SBI17JDI8458382,85,22,20,2,1
SBI62IIV3415045,92,25,21,4,1
SBI62IAX7586944,24,15,8,7,1
SBI63NTO2643286,63,25,22,3,1
SBI80KEV6827319,61,20,17,3,1
SBI99QPW5796900,65,21,14,7,1
SBI82UZX2762379,95,24,18,6,1
SBI33ZGV5870322,76,20,16,4,1
SBI57VBA8197978,95,25,14,11,1
SBI73VQU7130519,89,23,17,6,1
SBI49YNK9608586,91,31,16,15,1
SBI86JOU4826780,21,24,21,3,1
SBI47HKJ8757971,99,28,18,10,1
SBI50NOI2195435,67,29,23,6,1
SBI30EMG7181916,77,28,25,3,1
SBI03IVT0895460,83,23,20,3,1
SBI12KAA4364220,63,35,21,14,1
SBI81OZQ8007237,23,22,15,7,1
SBI68XYE7712945,79,13,10,3,1
SBI50ZAF6196012,70,26,22,4,1
SBI61WTN2210710,94,20,15,5,1
SBI27PEK5156836,98,29,17,12,1
SBI36XSR9379968,70,26,19,7,1
SBI50LSW9036237,91,17,9,8,1
SBI66QLQ9373257,99,29,24,5,1
SBI34IRM3832026,22,25,22,3,1
SBI47BBT9680624,86,25,23,2,1
SBI91XNM7945483,92,19,16,3,1
SBI61JAB0036259,22,29,17,12,1
SBI14DUY3291192,64,22,12,10,1
SBI31COD1409673,98,24,20,4,1
SBI36QTH6884600,24,26,14,12,1
SBI07XGD6840693,97,34,24,10,1
SBI32FBK5147513,19,19,17,2,1
SBI55IKS6860425,94,25,18,7,1
SBI17RJY2885040,80,28,20,8,1
SBI42QKK3958708,22,24,13,11,1
SBI47RSK0696905,20,27,18,9,1
SBI69ZWC5454874,69,20,15,5,1
SBI22ENC7995327,69,23,14,9,1
SBI35VEW8195668,66,26,16,10,1
SBI06FGQ5161066,77,26,25,1,1
SBI67YEG1117617,87,25,22,3,1
SBI39QDY2055356,87,22,17,5,1
SBI68CZT2426568,20,24,20,4,1
SBI24HPC5407799,78,26,17,9,1
SBI23GAT8018867,65,31,22,9,1
SBI52URI3982982,91,29,18,11,1
SBI87BSX2124389,97,26,20,6,1
SBI19XKO6127154,23,26,25,1,1
SBI55AFY7293360,68,30,23,7,1
SBI08GBI2960347,81,29,20,9,1
SBI18JCO4223975,67,22,21,1,1
SBI69LDK0903228,60,27,21,6,1
SBI46WTV4603565,18,21,12,9,1
SBI49JLY4026976,77,20,14,6,1
SBI81MDB9645742,95,25,18,7,1
SBI22ICV6914849,91,21,12,9,1
SBI04SLA7108085,25,23,22,1,1
SBI49HLU8704527,66,27,26,1,1
SBI04CGN9957610,65,15,10,5,1
SBI50LJK7672267,86,34,27,7,1
SBI76EGM1739207,89,34,31,3,1
SBI28GLL9700850,75,16,13,3,1
SBI83VBU1755394,73,33,26,7,1
SBI51VNF1750511,75,29,27,2,1
SBI16EFV3610276,18,19,12,7,1
SBI81WIP9014059,96,35,22,13,1
SBI89IBY0184070,99,25,24,1,1
SBI98LYI8753238,64,28,21,7,1
SBI13GWJ2399700,71,19,15,4,1
SBI08UGC3682228,76,21,15,6,1
SBI04UNU1687010,88,18,13,5,1
SBI31RQX0799970,82,18,15,3,1
SBI41NHS9126367,79,20,18,2,1
SBI31EOJ4980455,76,26,18,8,1
SBI34DRT9634843,66,30,18,12,1
SBI24YOM0077166,67,33,30,3,1
SBI62SQE5160274,83,29,19,10,1
SBI59YTC7602387,83,24,18,6,1
SBI97GXZ4755165,90,20,16,4,1
SBI14KCL2571313,78,32,31,1,1
SBI83LMJ8659263,21,25,20,5,1
SBI62LRH1886215,20,27,14,13,1
SBI19GPC6975853,73,27,21,6,1
SBI14WVW9986290,97,28,15,13,1
SBI45QSW5845522,87,17,9,8,1
SBI89UZX6243046,91,13,11,2,1
SBI47NRB3756186,97,22,12,10,1
SBI58SOZ5749390,67,16,11,5,1
SBI33JQV0674309,93,31,17,14,1
SBI31EIR9783858,94,22,14,8,1
SBI02GAL9805365,97,32,29,3,1
SBI05GEV1596999,94,26,16,10,1
SBI40NJI9494124,65,24,19,5,1
SBI39FZU1440436,65,26,20,6,1
SBI49MPW0591854,18,21,14,7,1
SBI58IJC1589212,24,32,31,1,1
SBI30IND7440060,70,28,19,9,1
SBI41WSO8910973,84,18,10,8,1
SBI27CHF7438652,22,14,13,1,1
SBI99WHU0539215,91,25,18,7,1
SBI08UQA8515544,86,26,18,8,1
SBI32SYZ9884040,93,33,31,2,1
SBI22IQI9230952,65,25,16,9,1
SBI94PYJ0331252,20,20,18,2,1
SBI34LAX3308760,87,25,24,1,1
SBI32SEE7049216,99,20,13,7,1
SBI65SRQ0474623,85,31,24,7,1
SBI63MOE8627778,65,28,18,10,1
SBI18JTK4997542,83,26,17,9,1
SBI71JZC1353672,96,28,24,4,1
SBI88EZX7781052,81,20,13,7,1
SBI17SXG5042647,19,28,21,7,1
SBI13DWO6059379,19,29,24,5,1
SBI66NWN9131271,92,27,21,6,1
SBI27VRZ3678988,96,22,15,7,1
SBI40UYN9873196,68,23,20,3,1
SBI95ZRU9781605,20,18,17,1,1
SBI85QZS4499901,61,25,15,10,1
SBI05ZUK9392691,62,29,19,10,1
SBI02LGA1603414,95,22,14,8,1
SBI79UKZ5687954,25,21,14,7,1
SBI94BTU7248523,21,24,20,4,1
SBI81XEB6923365,19,16,13,3,1
SBI21WVW8703586,70,22,18,4,1
SBI74CET4864192,84,24,21,3,1
SBI13HGJ1628158,95,19,16,3,1
SBI54RGG0998086,91,16,14,2,1
SBI89NTB1924593,96,19,13,6,1
SBI16QAX2325413,84,34,28,6,1
SBI44EDM8466360,21,33,30,3,1
SBI11EQE1099779,63,27,21,6,1
SBI00WGE5917110,91,21,13,8,1
SBI73BBX8686535,20,25,14,11,1
SBI33VSW8827091,68,18,15,3,1
SBI98EHQ0926847,22,20,15,5,1
SBI57YRN7496406,72,31,17,14,1
SBI36XUV9425857,66,24,19,5,1
SBI06MKE4812652,80,24,20,4,1
SBI84DAJ8148115,90,17,9,8,1
SBI80ZVS5948435,69,16,11,5,1
SBI08XIJ5295555,78,28,19,9,1
SBI56OJI7699048,20,29,16,13,1
SBI67CHC4078962,71,27,19,8,1
SBI78ULR1802045,65,22,12,10,1
SBI11YAM4892071,86,22,17,5,1
SBI58CLA4389734,67,18,12,6,1
SBI03NVN3063912,81,28,23,5,1
SBI67ZOD0411618,61,31,24,7,1
SBI86SQX7731359,69,32,19,13,1
SBI65EPV5564440,78,24,15,9,1
SBI33RCH1358337,86,26,16,10,1
SBI87EFN1275651,88,24,17,7,1
SBI08ZBP6618305,71,29,15,14,1
SBI28UNA5196396,90,17,15,2,1
SBI18IVC4541898,98,15,9,6,1
SBI79JLV3356252,62,27,25,2,1
SBI19HUQ9677972,25,14,10,4,1
SBI17MKN5999555,92,20,11,9,1
SBI64CAG1333394,65,31,19,12,1
SBI71EDW7825997,91,29,24,5,1
SBI76UXM8985675,62,18,12,6,1
SBI88VLQ1303476,20,31,29,2,1
SBI87EBB8137912,22,28,25,3,1
SBI55PFA3049639,25,19,13,6,1
SBI03WEV4381827,68,31,20,11,1
SBI46CTW5026784,63,25,21,4,1
SBI18PCT0750763,97,23,12,11,1
SBI63CJY7708520,83,28,27,1,1
SBI00BKA8058619,89,33,29,4,1
SBI64HTP4467945,81,28,27,1,1
SBI70GXQ1240650,96,21,17,4,1
SBI24XYD9220879,62,23,21,2,1
SBI49CLK7313699,18,25,22,3,1
SBI78WPO3621987,18,34,23,11,1
SBI51JJF6994240,90,16,13,3,1
SBI76TSO5960517,63,23,18,5,1
SBI32IJX1906339,70,24,17,7,1
SBI09TUH1251618,20,20,16,4,1
SBI69TNB6591089,62,23,16,7,1
SBI71VOY8326419,24,26,16,10,1
SBI12RUP9377295,95,34,27,7,1
SBI75VJR0694763,83,20,12,8,1
SBI83XMQ0691126,69,28,20,8,1
SBI20IXX7506897,24,27,15,12,1
SBI47GBX0667649,81,22,15,7,1
SBI61SKJ5938800,65,23,21,2,1
SBI13VRJ3867309,24,29,21,8,1
SBI84TLT9753018,78,18,16,2,1
SBI37EDL0596200,89,28,23,5,1
SBI47DPD3521352,73,27,22,5,1
SBI42EZM7416973,90,29,26,3,1
SBI10MPY2118225,73,28,15,13,1
SBI87CTX5363077,25,17,13,4,1
SBI89WWJ9337491,60,30,19,11,1
SBI10MXQ2610013,80,28,18,10,1
SBI34WNY1084929,67,26,24,2,1
SBI01BGQ5459441,22,25,21,4,1
SBI13CSR0637814,20,29,15,14,1
SBI82MLS6070619,67,35,20,15,1
SBI90VNH7843247,84,23,17,6,1
SBI55LNF0945962,60,27,15,12,1
SBI55YVJ6158172,62,27,15,12,1
SBI63WCP2214006,77,30,19,11,1
SBI91GSM5109519,19,19,12,7,1
SBI45JVP1694116,67,19,12,7,1
SBI59IQD6869442,89,21,18,3,1
SBI38IYY3910922,76,17,9,8,1
SBI60QTB0331547,87,22,19,3,1
SBI10QIF8661894,20,20,15,5,1
SBI18MRD0290455,65,30,16,14,1
SBI01WNW3449889,83,29,27,2,1
SBI38XKO1369590,77,19,18,1,1
SBI39MLH2807411,83,23,19,4,1
SBI48RTR9104258,85,26,20,6,1
SBI20MTZ4703079,83,32,22,10,1
SBI14NSF9337272,63,17,9,8,1
SBI24YYD5677830,63,20,18,2,1
SBI30TNJ8739580,69,32,23,9,1
SBI27UHI3712183,62,17,14,3,1
SBI21OXM8693424,85,20,18,2,1
SBI21OSC1348746,85,30,24,6,1
SBI72YHQ9441470,78,25,18,7,1
SBI81UQC1369179,72,29,28,1,1
SBI21UQR8917177,72,30,26,4,1
SBI52NHS1261988,93,23,15,8,1
SBI13EVX4286550,68,22,12,10,1
SBI88ERE4464009,85,22,17,5,1
SBI63JPN4157614,68,23,20,3,1
SBI21WPJ1113313,90,26,15,11,1
SBI60WEJ5566263,25,16,11,5,1
SBI66SCT4969423,19,25,14,11,1
SBI01DDL5050718,80,25,14,11,1
SBI47QHK0812313,94,18,11,7,1
SBI49KUL8593303,79,38,34,4,1
SBI22SVL7664735,99,12,11,1,1
SBI50LOO3744893,24,24,21,3,1
SBI02JSU9502457,84,26,21,5,1
SBI51NSA7244481,95,29,28,1,1
SBI20GUU1397289,80,24,16,8,1
SBI67JGH2962520,83,18,11,7,1
SBI27AXY4404369,80,26,24,2,1
SBI34LCC2115952,74,30,28,2,1
SBI21SPN6374302,73,12,10,2,1
SBI30PNQ1119833,23,28,17,11,1
SBI13ALL8487197,84,22,20,2,1
SBI72RSK1454921,96,21,19,2,1
SBI99EQW8891311,88,22,13,9,1
SBI80GBJ5325974,88,36,26,10,1
SBI63OMH9742787,71,22,16,6,1
SBI82SQV5253804,69,26,21,5,1
SBI36DXM6275030,80,31,16,15,1
SBI61OYP7481085,88,24,15,9,1
SBI77UQZ1163614,86,26,20,6,1
SBI04BHA4426184,66,27,21,6,1
SBI62NPN4502193,89,21,17,4,1
SBI49FME0368070,92,22,16,6,1
SBI74IMT4323061,62,17,10,7,1
SBI14GDE8569424,65,15,9,6,1
SBI81JOV8947635,88,28,26,2,1
SBI25CKE9993089,94,29,26,3,1
SBI22JEX9963608,94,21,18,3,1
SBI21HEO2817608,97,25,13,12,1
SBI94ASP0016708,67,27,14,13,1
SBI62NEG4642292,93,12,8,4,1
SBI60EDZ4475792,83,20,18,2,1
SBI31NYN7904041,88,28,25,3,1
SBI51WVJ6871826,61,19,17,2,1
SBI80IMJ8086388,60,34,27,7,1
SBI92KQJ4538907,97,19,18,1,1
SBI03ENT4157552,24,23,22,1,1
SBI33NFZ5473069,67,28,26,2,1
SBI12FVR9756186,63,24,16,8,1
SBI49OPM8427718,95,19,10,9,1
SBI76BEL2694772,78,23,20,3,1
SBI02FBO2396808,22,29,25,4,1
SBI13IRC7616758,87,27,14,13,1
SBI89OXW7224228,86,25,19,6,1
SBI64DJD7313644,23,33,31,2,1
SBI30DNC4064747,25,18,14,4,1
SBI54GST8882433,71,26,21,5,1
SBI99JYV8964299,74,27,25,2,1
SBI87DET1737279,76,25,17,8,1
SBI46HKN7513513,83,22,17,5,1
SBI65GES8750622,25,24,15,9,1
SBI04NQX1065222,86,34,21,13,1
SBI49MAT3941705,85,19,16,3,1
SBI73WHC6973658,23,21,16,5,1
SBI26WQE9953044,79,30,24,6,1
SBI56OJM9186174,79,23,18,5,1
SBI16PQP8045508,94,31,28,3,1
SBI67WQE2838471,81,31,16,15,1
SBI44IJH1467601,98,31,26,5,1
SBI48XUZ0602905,75,29,22,7,1
SBI57GZX4107427,79,14,10,4,1
SBI22ZIP4379820,19,23,13,10,1
SBI23QJX8838851,60,36,23,13,1
SBI45NVZ1370866,82,21,17,4,1
SBI74YON5926757,23,30,20,10,1
SBI34KWB8094853,89,29,26,3,1
SBI95ZQV3907656,91,19,12,7,1
SBI50GOL5876121,18,26,25,1,1
SBI39ROK1461517,86,23,21,2,1
SBI04QER4306745,81,26,18,8,1
SBI67PCO3552165,84,26,17,9,1
SBI64FQA1981742,95,29,26,3,1
SBI38JST1396867,95,28,15,13,1
SBI08OJR9474167,62,25,17,8,1
SBI36JWS1926315,95,22,16,6,1
SBI56BYP0042003,89,29,26,3,1
SBI91YJP4432283,25,27,16,11,1
SBI47YQE8046923,97,30,24,6,1
SBI02KRU6916089,74,28,24,4,1
SBI48SIC7110588,82,28,21,7,1
SBI79XTX3899847,81,25,23,2,1
SBI07ZAK9722081,20,22,19,3,1
SBI70UAL1755789,81,21,15,6,1
SBI32OQK7213718,22,26,23,3,1
SBI57MEA7377841,84,30,23,7,1
SBI34ESQ5268603,72,34,24,10,1
SBI63HUA4581257,85,21,20,1,1
SBI70NMV9891147,75,19,17,2,1
SBI60JJC5576700,84,30,18,12,1
SBI97ZYC1122525,81,23,12,11,1
SBI54QBB2992639,93,27,14,13,1
SBI51NBL9790484,74,12,7,5,1
SBI12LOD0137212,82,18,16,2,1
SBI48AFJ2783810,99,20,12,8,1
SBI44YXP5981038,72,30,24,6,1
SBI66SES7004638,94,29,21,8,1
SBI91WBT0197116,63,32,27,5,1
SBI66POI0468413,24,20,15,5,1
SBI34CTY6955712,79,29,22,7,1
SBI99TZV8957403,25,24,20,4,1
SBI58GSM8042689,72,30,25,5,1
SBI98YFL4345895,81,27,22,5,1
SBI87JYI4363378,20,26,22,4,1
SBI44XLM7738114,86,32,24,8,1
SBI48NTR1181876,78,21,13,8,1
SBI20RKI3626821,70,33,24,9,1
SBI57RVL0727990,77,22,20,2,1
SBI30VVT3478684,78,22,13,9,1
SBI27JUC7628661,77,28,25,3,1
SBI32HUB4670296,99,32,25,7,1
SBI40DWH9681050,18,24,13,11,1
SBI55WRD9164316,84,23,18,5,1
SBI05YMQ9528345,66,29,27,2,1
SBI74ZBR5599612,69,24,17,7,1
SBI07EKV4320965,94,26,23,3,1
SBI89LUI0589647,20,23,21,2,1
SBI91CFZ7615266,81,31,25,6,1
SBI18YGD2500987,98,24,18,6,1
SBI83SMN1859253,82,21,11,10,1
SBI36MJZ2660503,70,31,23,8,1
SBI50HGN6518404,21,24,23,1,1
SBI24OYP0661277,63,23,18,5,1
SBI74SUZ7144363,96,20,13,7,1
SBI19FTL9138752,70,18,11,7,1
SBI46GPT6883245,81,21,15,6,1
SBI38TGT7709649,91,21,14,7,1
SBI80QKB6755188,23,17,16,1,1
SBI16UJN1619208,77,23,21,2,1
SBI54YZT1618363,60,28,16,12,1
SBI46KGY1283458,71,22,18,4,1
SBI86SQK9709550,63,29,27,2,1
SBI23AUV7391481,91,24,14,10,1
SBI61JTF2872475,65,29,24,5,1
SBI35RKQ7520166,20,17,11,6,1
SBI70DDZ5478727,60,17,12,5,1
SBI19WND4856403,25,33,23,10,1
SBI17GXF2256164,80,24,18,6,1
SBI53VCH8171613,69,24,19,5,1
SBI68POH0382761,88,31,20,11,1
SBI61ICW0444277,21,21,11,10,1
SBI00NII3823836,86,24,15,9,1
SBI36SBY7943728,91,27,23,4,1
SBI84OMT5300105,92,15,12,3,1
SBI90CWA2853712,18,17,10,7,1
SBI63MNJ2347777,71,21,11,10,1
SBI02SWD8886916,97,29,22,7,1
SBI63PBQ0744350,84,29,26,3,1
SBI25HAP5108325,97,23,21,2,1
SBI63VYZ8260532,75,25,22,3,1
SBI18EYO3209465,78,17,15,2,1
SBI46PZB6814556,65,24,13,11,1
SBI38KWK0781841,78,28,20,8,1
SBI12XDC6496081,96,29,15,14,1
SBI57JQB8526409,94,28,24,4,1
SBI65UAY0916542,95,22,17,5,1
SBI74AJX9393854,81,15,13,2,1
SBI24WOH6978811,22,19,17,2,1
SBI56RBN6824910,63,25,18,7,1
SBI93FWQ4661113,74,23,19,4,1
SBI38AOQ9314184,18,20,13,7,1
SBI86GKB8079511,84,32,20,12,1
SBI37OEG5452604,70,28,16,12,1
SBI04KHY6803437,63,19,15,4,1
SBI67BGM8308902,72,21,15,6,1
SBI81NNK9412662,85,21,19,2,1
SBI33YKI6553378,77,26,20,6,1
SBI47GYH1308070,92,28,24,4,1
SBI60VXJ3534453,79,24,16,8,1
SBI33KPR6320792,81,23,18,5,1
SBI11UEQ6917762,70,32,21,11,1
SBI94HJY9362024,21,27,23,4,1
SBI36PNK1907919,99,19,17,2,1
SBI87GFB1538159,24,25,19,6,1
SBI88OZQ3930109,67,21,13,8,1
SBI65XUU0246989,65,19,17,2,1
SBI84UKT1420404,74,16,10,6,1
SBI14TMQ6822460,80,18,11,7,1
SBI19WCW9949755,95,25,19,6,1
SBI05MHM2222855,22,27,23,4,1
SBI05LVI8983133,73,28,23,5,1
SBI37WCN7730241,73,22,20,2,1
SBI50TPS7643295,69,28,16,12,1
SBI68QYT5655726,63,23,19,4,1
SBI57XDY1773131,76,22,15,7,1
SBI86VOV1963579,88,20,19,1,1
SBI79EXH0314288,19,26,23,3,1
SBI05VKE7396183,23,26,16,10,1
SBI54GYF7730255,91,28,26,2,1
SBI53NRF2819744,68,28,19,9,1
SBI98BBS2049897,86,38,35,3,1
SBI53BCU1498107,25,23,18,5,1
SBI17DQH0649639,97,23,18,5,1
SBI84MJW3674916,68,18,16,2,1
SBI65PRS0653297,72,22,21,1,1
SBI45EYT3152705,67,24,16,8,1
SBI26TPM7412906,70,27,18,9,1
SBI82ZHE8282125,65,19,13,6,1
SBI08FAK8318855,88,25,21,4,1
SBI71NLT9842257,92,26,22,4,1
SBI14RUO5526306,68,22,13,9,1
SBI51FKR5196674,95,31,19,12,1
SBI38XYJ7050008,95,20,11,9,1
SBI75UHT3833358,91,23,21,2,1
SBI30CNU9200765,92,26,18,8,1
SBI85EQU3824014,97,22,17,5,1
SBI72LMY1542516,91,24,19,5,1
SBI05AJH3611363,76,34,33,1,1
SBI33HVA6336245,18,19,14,5,1
SBI09UKK0327599,95,21,14,7,1
SBI16RVS0182933,64,17,15,2,1
SBI11SXK6775954,66,27,22,5,1
SBI34KAB7503717,93,23,12,11,1
SBI82UAL1924171,69,27,22,5,1
SBI19RSA6160848,62,22,14,8,1
SBI07SCK3671305,85,27,17,10,1
SBI87EJX8397831,18,18,17,1,1
SBI31BUY8159575,74,30,23,7,1
SBI59TNN1640339,80,16,9,7,1
SBI08LJJ5730727,81,30,23,7,1
SBI87XYR9494640,81,19,12,7,1
SBI09FJY6887754,77,19,11,8,1
SBI10AXM3294352,19,38,30,8,1
SBI87WMC5199123,66,29,21,8,1
SBI64KMY0640352,66,29,17,12,1
SBI17WJM9215449,62,36,32,4,1
SBI15LSR9534480,79,23,13,10,1
SBI95KVC6002436,68,28,15,13,1
SBI47HTR5169924,25,31,20,11,1
SBI37THP2892725,67,25,20,5,1
SBI50LHX1253601,77,24,15,9,1
SBI84UOQ7974095,83,29,27,2,1
SBI20YAB1452472,82,16,10,6,1
SBI13LIO2953907,76,36,32,4,1
SBI74NIK6230810,74,31,19,12,1
SBI76PZR2206114,74,30,16,14,1
SBI48LKT9287929,66,17,14,3,1
SBI64BJG7864985,61,18,12,6,1
SBI70LLL7240467,74,25,20,5,1
SBI56ZQQ1156006,69,20,19,1,1
SBI35ORN6863530,70,29,24,5,1
SBI64BCI7256501,79,20,18,2,1
SBI29MMK6951112,83,19,10,9,1
SBI46PMW0622437,65,14,8,6,1
SBI86UXW4671207,23,34,18,16,1
SBI66MBQ3111543,62,24,23,1,1
SBI04RYL1505525,18,21,19,2,1
SBI52QGD2973172,94,21,13,8,1
SBI21SAA6085621,19,19,11,8,1
SBI32OUY4658987,90,31,23,8,1
SBI55PUG2137130,85,29,17,12,1
SBI20EBR6162977,65,26,23,3,1
SBI28MQX6619819,93,15,14,1,1
SBI62KKR7600684,87,19,17,2,1
SBI59XYH2674302,23,33,32,1,1
SBI74OOZ6354354,91,26,16,10,1
SBI42IBY0884048,60,23,22,1,1
SBI84GTQ2521063,90,36,32,4,1
SBI63JAL7481157,65,16,14,2,1
SBI04KKV8106931,85,24,15,9,1
SBI82EPV1049762,68,20,16,4,1
SBI36NEU3541008,99,22,19,3,1
SBI18ERC9503298,94,28,25,3,1
SBI40MMC4604109,18,36,20,16,1
SBI24ZLP6318064,80,11,10,1,1
SBI02LFQ0343638,72,16,14,2,1
SBI71LPU7327076,68,28,18,10,1
SBI64OCI6753859,73,24,20,4,1
SBI76LAC1679442,70,17,14,3,1
SBI05HVM7006004,70,29,22,7,1
SBI46KMU9352988,70,19,18,1,1
SBI04LHN9929403,74,26,20,6,1
SBI28ETU1907595,87,18,15,3,1
SBI25XGZ1558951,84,14,12,2,1
SBI11XIO2428490,78,18,17,1,1
SBI48ZLW3362473,25,20,16,4,1
SBI12SEO7017093,23,19,12,7,1
SBI23ERV0257190,95,25,19,6,1
SBI56QEJ9528530,79,26,21,5,1
SBI76OPL3268553,82,31,16,15,1
SBI71DJQ5829225,24,22,18,4,1
SBI60TAX3349912,78,18,17,1,1
SBI28KHB5878849,79,31,23,8,1
SBI56AVS6499225,78,24,17,7,1
SBI93TOE6944191,97,21,11,10,1
SBI93BLR3702559,63,17,16,1,1
SBI74WGL3278919,86,23,19,4,1
SBI19NUM7222507,75,34,27,7,1
SBI28ONX3093060,21,23,13,10,1
SBI19RMY6737670,71,19,12,7,1
SBI60IBY2009716,81,26,23,3,1
SBI81FXU2030507,96,15,12,3,1
SBI10LSH4439760,72,30,28,2,1
SBI93SEN7572185,75,25,22,3,1
SBI12CNF0397816,62,23,16,7,1
SBI71PCL9475982,92,23,19,4,1
SBI52XJS2137231,90,26,20,6,1
SBI11RUR7974105,96,30,22,8,1
SBI49FRB3478270,72,27,16,11,1
SBI37ZNT0126571,64,21,13,8,1
SBI54RXV9020219,69,19,12,7,1
SBI03CRT3235576,92,13,11,2,1
SBI56VIS3519455,94,19,17,2,1
SBI64YNA1895793,82,25,20,5,1
SBI27MUG5644975,19,24,19,5,1
SBI06BID1757482,97,24,16,8,1
SBI66UZI6144154,71,21,18,3,1
SBI02WID6610651,84,27,16,11,1
SBI38SWA3358573,63,19,12,7,1
SBI36OGU0750383,83,21,19,2,1
SBI11FHR4513613,66,29,15,14,1
SBI87UCJ4800306,95,26,17,9,1
SBI36MIN2201800,82,25,13,12,1
SBI82MRL7984213,88,27,20,7,1
SBI38GBY5947487,92,28,18,10,1
SBI36QRB5232540,78,27,17,10,1
SBI58AKD6859665,60,31,22,9,1
SBI91BSX8267304,80,28,16,12,1
SBI13OWZ6399346,60,30,20,10,1
SBI65PGF9081939,92,29,21,8,1
SBI90IDU5927677,76,23,16,7,1
SBI35PFT8876089,84,29,28,1,1
SBI02NQE8551713,24,25,21,4,1
SBI86SJL0453220,90,16,14,2,1
SBI90PCU4389995,98,35,25,10,1
SBI44VYI7083250,61,25,23,2,1
SBI18KIJ6420455,22,32,24,8,1
SBI67IOM2411022,62,23,19,4,1
SBI39PKH8942472,61,29,27,2,1
SBI00GLK2255416,71,21,15,6,1
SBI09MIO5458058,72,15,13,2,1
SBI53HZK9170588,64,34,23,11,1
SBI43VHC5841729,22,16,14,2,1
SBI83RFW5551659,88,17,12,5,1
SBI50MTR1842156,76,24,15,9,1
SBI52BHD7229483,97,27,15,12,1
SBI30OVR4684652,73,21,14,7,1
SBI42XLI5182118,60,16,13,3,1
SBI42KKM0602543,85,23,21,2,1
SBI97RJP7640609,78,26,25,1,1
SBI54PAL0699416,20,27,19,8,1
SBI15HWT3955150,70,26,18,8,1
SBI90LKA5510032,80,10,7,3,1
SBI05IBH7670690,95,28,22,6,1
SBI96WML0861898,66,24,17,7,1
SBI78XKV5036076,61,25,16,9,1
SBI52REW1327313,75,23,16,7,1
SBI07OGW9498068,74,30,18,12,1
SBI71HWE2476219,66,17,10,7,1
SBI28PHX2128252,88,24,14,10,1
SBI71RBN1004304,99,34,33,1,1
SBI60QFK9848303,70,18,12,6,1
SBI37NDW1121913,96,27,15,12,1
SBI40AKY2771562,69,31,25,6,1
SBI51ATT8033598,88,18,13,5,1
SBI21UHA4666769,76,17,15,2,1
SBI09ZBD0290353,68,33,22,11,1
SBI60BWP9084031,70,19,15,4,1
SBI55YXY5991197,19,36,29,7,1
SBI35VYE1722489,65,30,17,13,1
SBI30WKD5282951,20,17,12,5,1
SBI90JYV3949824,61,27,25,2,1
SBI09YKR4543231,65,27,25,2,1
SBI31QEG8842726,87,23,16,7,1
SBI00RUR5632494,65,36,22,14,1
SBI50DIG4565936,86,25,20,5,1
SBI89QLQ4456724,93,29,18,11,1
SBI25SUJ7898235,60,24,21,3,1
SBI07WBD6800660,66,24,17,7,1
SBI53AFC2355467,87,28,20,8,1
SBI23QFX3388375,98,16,11,5,1
SBI39WXB5147353,81,26,18,8,1
SBI57RMQ9947538,70,26,25,1,1
SBI20JHZ6285751,66,22,17,5,1
SBI33VYN3897572,66,36,34,2,1
SBI96PHF4290241,88,25,22,3,1
SBI36JMD3973182,23,26,22,4,1
SBI03VKA0310525,65,29,28,1,1
SBI02IDG5820928,88,14,11,3,1
SBI29WQY8755339,83,31,16,15,1
SBI33TSO7122244,79,36,22,14,1
SBI31REX6590914,60,20,18,2,1
SBI89QAP9784926,66,24,14,10,1
SBI09HTF4592661,63,19,16,3,1
SBI22BGE6582799,86,23,19,4,1
SBI26COV8224580,85,27,21,6,1
SBI43ETE3451027,72,22,13,9,1
SBI54JUQ5636587,25,31,18,13,1
SBI71GVZ2718341,75,21,16,5,1
SBI91XJQ7138157,22,18,10,8,1
SBI44XVX6620002,23,28,23,5,1
SBI44LVE9400257,73,21,18,3,1
SBI84GYZ9929181,97,27,23,4,1
SBI62EID3335204,24,23,18,5,1
SBI60JDY2950116,65,28,19,9,1
SBI55RYD2090628,92,21,18,3,1
SBI83CNW7003517,67,31,27,4,1
SBI29HBS1112105,22,19,18,1,1
SBI67UOI8927747,87,36,24,12,1
SBI13EQZ2579918,70,30,28,2,1
SBI44CWL9143359,90,20,15,5,1
SBI18KJG6451226,68,31,24,7,1
SBI26ICV3115044,70,34,27,7,1
SBI89GPA0407058,86,21,20,1,1
SBI81ERL9576616,67,30,19,11,1
SBI01TDL7759720,78,27,26,1,1
SBI14GIH2019555,79,19,13,6,1
SBI68WVH6128447,86,20,11,9,1
SBI54ZSM5639679,69,25,23,2,1
SBI87DXC7823443,74,21,18,3,1
SBI95CPJ1250759,95,22,19,3,1
SBI70MND3752317,81,22,15,7,1
SBI24HDX1189889,92,23,15,8,1
SBI69PYY7802719,24,38,26,12,1
SBI59TKX2487094,78,23,14,9,1
SBI48EXX7938538,71,31,24,7,1
SBI61MQV9778580,83,27,25,2,1
SBI50CWG5244301,69,26,22,4,1
SBI77XIQ6381478,75,26,21,5,1
SBI40UUW9356508,95,22,18,4,1
SBI03QOL1617809,65,29,15,14,1
SBI64YRK0889973,18,22,20,2,1
SBI77IGT3705383,75,32,27,5,1
SBI74IYF3229593,75,27,23,4,1
SBI65VMR4355585,97,19,11,8,1
SBI96CEY4830270,25,30,21,9,1
SBI11EAP6108940,85,19,11,8,1
SBI57HNA3521167,86,30,17,13,1
SBI41EIL2875291,61,16,13,3,1
SBI91FYA9256498,23,28,17,11,1
SBI04YTY9091752,99,31,16,15,1
SBI63BAI9725015,95,25,15,10,1
SBI06OPN4418309,21,22,15,7,1
SBI62BAV1913343,68,19,17,2,1
SBI32NQF1581339,24,24,14,10,1
SBI65IKE3572843,65,24,16,8,1
SBI84VJD1539184,24,19,11,8,1
SBI89OFL5927722,68,26,15,11,1
SBI65UFP7014660,91,24,14,10,1
SBI74RHT1793713,78,11,6,5,1
SBI32VJN7260149,21,21,18,3,1
SBI00FTZ9128222,65,29,20,9,1
SBI19VHI9788103,61,21,19,2,1
SBI33OYL6465744,61,28,22,6,1
SBI41IAI9848620,64,15,9,6,1
SBI61RII7406194,85,19,18,1,1
SBI45IUN9689595,91,24,18,6,1
SBI80OWJ5119608,60,25,18,7,1
SBI58XLL7615456,84,19,14,5,1
SBI06JRS3938910,22,31,29,2,1
SBI81BZN3932282,61,25,17,8,1
SBI96FCP2591572,82,14,13,1,1
SBI31EGZ5989774,89,34,28,6,1
SBI08DKN6168986,66,23,21,2,1
SBI04CUL2738281,99,21,12,9,1
SBI53VOI9421576,66,20,12,8,1
SBI75UEF6046016,67,20,14,6,1
SBI70GWE0072375,65,22,20,2,1
SBI59BNY5666864,76,17,15,2,1
SBI16ASV7532612,77,30,21,9,1
SBI28HSJ8976727,76,29,21,8,1
SBI41HKJ9548449,21,28,21,7,1
SBI74ZZJ8983221,70,23,20,3,1
SBI66KSM6188118,60,34,25,9,1
SBI37CQW6597729,99,23,12,11,1
SBI23AYQ6205440,81,30,22,8,1
SBI82PQF2503908,70,11,9,2,1
SBI99ECV8532771,74,21,15,6,1
SBI61EOB3332980,79,20,17,3,1
SBI98ZNH1055817,63,31,20,11,1
SBI10HCK6187214,20,16,14,2,1
SBI92DCZ3463062,21,19,14,5,1
SBI09PPE3066060,78,23,16,7,1
SBI14QKS4626745,65,26,16,10,1
SBI56VVD2005530,21,19,15,4,1
SBI52GBE4628677,73,23,19,4,1
SBI59LNL7431093,95,22,16,6,1
SBI59PEI3412778,63,33,19,14,1
SBI12MPK6971524,20,23,15,8,1
SBI62SHY4029228,67,17,11,6,1
SBI58BIX4612062,82,24,17,7,1
SBI97FXF8398914,82,27,23,4,1
SBI49LIV7288456,72,15,12,3,1
SBI44ZCA1449652,21,30,28,2,1
SBI58WGB5865963,92,27,18,9,1
SBI27WVR7465782,69,27,16,11,1
SBI15IVW9145511,23,22,16,6,1
SBI46CSO0016890,78,25,14,11,1
SBI06TTI5927518,61,26,20,6,1
SBI02SZW8051650,62,29,22,7,1
SBI94NUO8679299,25,18,10,8,1
SBI16OZM3713095,85,28,27,1,1
SBI30UOV4219349,88,24,23,1,1
SBI01MPE0557006,95,16,11,5,1
SBI51QOU1457767,81,30,16,14,1
SBI48BQQ1418199,61,16,15,1,1
SBI98DUF1131840,67,22,18,4,1
SBI76VXZ5363364,99,22,16,6,1
SBI14NNK8942239,97,20,12,8,1
SBI70HKJ0024519,68,31,21,10,1
SBI80WKH2589862,80,22,18,4,1
SBI20HKJ2704163,75,28,26,2,1
SBI94PKY1389753,81,24,20,4,1
SBI39MNX5878660,61,26,19,7,1
SBI27URJ2437960,93,19,18,1,1
SBI04WTY3343672,78,31,17,14,1
SBI80FAF0602398,65,25,13,12,1
SBI79NLM4756248,92,18,13,5,1
SBI83YGH3486289,98,30,17,13,1
SBI36DJF0606482,62,35,19,16,1
SBI86WEN0216313,98,18,11,7,1
SBI48TAQ0879584,97,28,20,8,1
SBI57BJF3082748,81,22,14,8,1
SBI22ARC1725544,65,22,19,3,1
SBI53EQQ0921032,86,19,15,4,1
SBI37JNJ9190119,73,25,15,10,1
SBI03WCK2406644,21,14,13,1,1
SBI65YZR7649566,71,32,31,1,1
SBI89PBD5599866,63,35,22,13,1
SBI09OSE6920127,66,19,17,2,1
SBI64UFJ9558138,21,21,16,5,1
SBI80NKG5787577,70,37,22,15,1
SBI89CYX8057987,97,28,23,5,1
SBI09NWV1813080,87,27,16,11,1
SBI48KIJ8848050,87,23,13,10,1
SBI93KLF4519303,62,20,16,4,1
SBI92ROC3200184,87,24,23,1,1
SBI82GWI4048076,78,18,17,1,1
SBI69JFG2875027,65,25,20,5,1
SBI89DAL7754339,71,28,26,2,1
SBI97AOI7354503,18,22,15,7,1
SBI41JQG2440573,25,21,11,10,1
SBI91NLA0666904,90,28,16,12,1
SBI34KMX8403422,93,24,20,4,1
SBI61CYX3962371,77,32,31,1,1
SBI66SJY3045107,66,27,20,7,1
SBI74JOT2305727,76,23,19,4,1
SBI63WWV9527182,60,37,32,5,1
SBI62POU1517560,63,17,9,8,1
SBI92MWK0610124,91,22,18,4,1
SBI37CNE8956729,86,26,14,12,1
SBI97RDE3998711,83,28,16,12,1
SBI84VBJ2226704,74,27,21,6,1
SBI28SXA9667281,89,30,27,3,1
SBI21NEA4668252,84,20,17,3,1
SBI86IGG3921903,64,27,24,3,1
SBI44KJM6547900,86,21,19,2,1
SBI95GUC1437211,97,29,21,8,1
SBI07WDU9727889,74,18,17,1,1
SBI70FYL1895282,63,20,11,9,1
SBI44EKK3283296,96,31,20,11,1
SBI28DLV7998387,97,31,18,13,1
SBI11CPJ8677801,21,17,12,5,1
SBI82HUU8070365,60,18,10,8,1
SBI45YEX5806393,87,26,16,10,1
SBI89UIN2760738,61,30,27,3,1
SBI18CDS4227031,93,22,12,10,1
SBI22HHX7118873,64,25,23,2,1
SBI29FRZ2482553,90,33,25,8,1
SBI75JPB4559913,95,27,14,13,1
SBI94AZJ9176567,18,33,32,1,1
SBI45EMH3900351,93,18,16,2,1
SBI68GHC5849240,21,24,20,4,1
SBI53NKW5350894,18,35,20,15,1
SBI42ROJ3153300,81,22,12,10,1
SBI71TBD5082145,75,24,20,4,1
SBI15OXQ9293911,87,14,13,1,1
SBI38BDF9690098,25,21,16,5,1
SBI70ZSL3512986,83,22,16,6,1
SBI79YLZ3929106,84,18,12,6,1
SBI35VQC8500747,20,16,9,7,1
SBI77GEK8817913,60,23,15,8,1
SBI25KTS7925858,87,17,13,4,1
SBI56VWI6790144,62,24,13,11,1
SBI24QJB7081391,74,17,13,4,1
SBI26UVZ6868908,69,17,9,8,1
SBI47THO2091306,22,24,18,6,1
SBI95XJI0140624,69,24,14,10,1
SBI36WIU8290696,83,24,19,5,1
SBI66UDB7201084,80,31,18,13,1
SBI46YJC8396094,86,22,16,6,1
SBI05NOB4678084,75,21,13,8,1
SBI71CLI8449071,19,27,14,13,1
SBI66WSN1455910,86,22,17,5,1
SBI05KDI4990040,18,25,23,2,1
SBI04LHC6323845,83,21,20,1,1
SBI81MJH3062340,89,27,18,9,1
SBI78WEE0906877,20,29,25,4,1
SBI99GHR6638380,61,19,14,5,1
SBI83PSK5248775,75,29,25,4,1
SBI49VAT5483246,68,26,21,5,1
SBI54EUP6327075,65,24,20,4,1
SBI06PCX2535665,65,30,17,13,1
SBI81ODG0633032,86,22,19,3,1
SBI42IAP9789946,21,29,16,13,1
SBI16QSK9508420,18,27,22,5,1
SBI66ATL2214261,84,23,16,7,1
SBI89OSV0006670,20,29,17,12,1
SBI13WKF5457157,65,32,19,13,1
SBI94HAM9722954,92,19,10,9,1
SBI44ZDE7132536,25,26,25,1,1
SBI87GOS1862163,75,30,26,4,1
SBI12RUX7601726,83,26,18,8,1
SBI70DHR2080554,60,23,15,8,1
SBI26OIJ6171508,75,25,20,5,1
SBI28ACI0816870,95,25,19,6,1
SBI99KJX0265033,97,28,23,5,1
SBI83YVY4755156,75,30,19,11,1
SBI58YQS8839556,64,17,14,3,1
SBI03IKH7186891,23,33,20,13,1
SBI89WPK1294720,89,29,26,3,1
SBI19QAA3506905,60,22,13,9,1
SBI10MSL9525561,73,25,20,5,1
SBI14OBP8174726,67,24,15,9,1
SBI76NWL5404597,73,25,16,9,1
SBI53BPY4612162,94,24,21,3,1
SBI21GPG4171539,85,37,27,10,1
SBI84GWY5831476,23,26,19,7,1
SBI81PEQ9803044,78,24,23,1,1
SBI90GCC2465389,21,25,17,8,1
SBI13MXG8377825,71,16,15,1,1
SBI01CVS8432144,60,22,16,6,1
SBI55OXU3907179,82,28,15,13,1
SBI39NFM3750424,92,22,15,7,1
SBI83LBK6934613,98,24,21,3,1
SBI59UAI0348159,60,32,26,6,1
SBI81XJO4134823,70,24,13,11,1
SBI38SFS0077331,67,29,24,5,1
SBI87MFQ4670123,22,29,19,10,1
SBI11COZ9525746,92,26,14,12,1
SBI48LUK6834181,87,26,20,6,1
SBI40ZJH5529334,99,31,17,14,1
SBI95FGF8568170,70,25,18,7,1
SBI38WOB3262790,94,27,18,9,1
SBI01DHM5968805,79,33,24,9,1
SBI25MWE0480149,21,34,22,12,1
SBI53YSO2919408,77,34,20,14,1
SBI34YEN7509936,93,19,10,9,1
SBI53CBW4320930,25,30,26,4,1
SBI65UDM6954885,69,25,20,5,1
SBI95THF2209454,79,23,22,1,1
SBI57ERD4546250,81,22,15,7,1
SBI40YLP0555342,65,15,9,6,1
SBI32GQF7071900,92,30,21,9,1
SBI28YFY0292516,63,27,24,3,1
SBI81USI1674580,21,27,15,12,1
SBI95PVV9919827,24,26,22,4,1
SBI25WIF4207909,92,22,16,6,1
SBI21GPV2012816,79,25,13,12,1
SBI93CBE4633907,24,29,27,2,1
SBI25AYH0969268,82,18,17,1,1
SBI36EHD8436449,90,20,14,6,1
SBI77JNO6802480,76,27,17,10,1
SBI65SJT4386334,84,29,20,9,1
SBI06VDG0530696,83,18,10,8,1
SBI92GTW1394028,62,23,16,7,1
SBI38VLA3200368,86,24,19,5,1
SBI78RRM5323734,60,22,19,3,1
SBI20HAI4748472,73,28,15,13,1
SBI38SMQ2767087,72,27,24,3,1
SBI85XUH6608770,95,30,16,14,1
SBI08GEK3885047,98,17,12,5,1
SBI84DVO1593563,94,24,16,8,1
SBI98RTR7428003,93,22,20,2,1
SBI65NWV2254973,66,29,25,4,1
SBI06UNP8015367,82,23,20,3,1
SBI71IRE3858781,86,14,11,3,1
SBI35JWQ5714792,66,20,11,9,1
SBI90MQW8643882,96,31,30,1,1
SBI73LJJ8790706,77,29,18,11,1
SBI13RPT1344821,63,32,23,9,1
SBI58OJM0207776,22,35,28,7,1
SBI05PLS8444565,65,25,24,1,1
SBI01QEF8958092,87,23,13,10,1
SBI78TBN3642056,94,28,26,2,1
SBI53WDN5060325,18,26,19,7,1
SBI54IJD9419912,95,29,18,11,1
SBI90YLD6636768,70,28,27,1,1
SBI19WBD0281450,77,23,21,2,1
SBI53DKN5640166,23,21,14,7,1
SBI75KXT6186961,88,28,22,6,1
SBI30CIB7809132,62,26,23,3,1
SBI52QNF8528965,77,21,11,10,1
SBI68UYT9992166,66,26,18,8,1
SBI45RNF0887396,19,37,28,9,1
SBI17IHS2319478,70,26,18,8,1
SBI14DXG0341656,95,15,13,2,1
SBI87IQG7399513,93,28,27,1,1
SBI55DEB5131702,73,17,10,7,1
SBI66BUI8331985,67,26,20,6,1
SBI52DPO3362842,73,13,7,6,1
SBI44MJI2099833,63,38,33,5,1
SBI15FPO9552351,21,38,33,5,1
SBI17WMG8752450,21,13,8,5,1
SBI67WUA8274467,79,27,14,13,1
SBI43OGQ9299176,64,22,19,3,1
SBI19JMK0673459,74,21,20,1,1
SBI26SFT0502025,99,30,19,11,1
SBI39PLY7458350,21,20,13,7,1
SBI71URZ2414215,21,17,14,3,1
SBI73FUA8862054,20,24,17,7,1
SBI63VLC7549361,88,22,14,8,1
SBI05MKR1385088,93,20,18,2,1
SBI53XFN2700624,98,22,18,4,1
SBI03ZCT3092153,76,29,16,13,1
SBI58NJE4711171,87,32,19,13,1
SBI50XDA1355374,97,20,13,7,1
SBI91VDP8962275,64,23,15,8,1
SBI15CPN0664698,23,25,19,6,1
SBI09PFB4811059,98,26,15,11,1
SBI67UEE4970520,18,32,20,12,1
SBI98VMY6041025,64,19,11,8,1
SBI60EPV6478281,93,22,18,4,1
SBI71OQG2329357,81,34,29,5,1
SBI26JDE2791561,83,30,28,2,1
SBI94CER5713262,65,21,20,1,1
SBI13KSC1515291,80,25,18,7,1
SBI37MHC3855776,86,21,12,9,1
SBI44JHC7373954,64,31,22,9,1
SBI17YYG0512204,74,26,14,12,1
SBI53SIV9833152,61,18,16,2,1
SBI14LSA9964072,92,23,17,6,1
SBI12DMV9500012,61,24,21,3,1
SBI70QPL2849240,94,22,14,8,1
SBI03IZF2953978,19,25,15,10,1
SBI88ZKZ2550937,62,16,15,1,1
SBI70GRA7716564,97,18,13,5,1
SBI82WWS9681470,96,24,13,11,1
SBI98MRH4702115,98,17,14,3,1
SBI32SGQ1255985,93,27,23,4,1
SBI07LFK8494083,67,31,24,7,1
SBI58PMT9625741,83,29,17,12,1
SBI82ZYF2456701,73,21,14,7,1
SBI12IUZ5528005,96,28,27,1,1
SBI78XKH5504908,83,44,23,21,1
SBI61XSL7137872,72,21,18,3,1
SBI77NWY9811174,73,17,10,7,1
SBI32JNH6027662,20,31,30,1,1
SBI51WNG9368109,99,27,22,5,1
SBI95UZV6696990,61,18,16,2,1
SBI70HZT4047606,78,22,15,7,1
SBI84DZM9695264,67,26,19,7,1
SBI35AWU4316144,73,22,18,4,1
SBI71TJQ2379420,64,21,12,9,1
SBI35SDP5012120,83,22,17,5,1
SBI10MKX3722387,99,25,24,1,1
SBI78QKI6427050,60,27,23,4,1
SBI24TTS6450448,67,27,16,11,1
SBI13PCX4433461,61,22,20,2,1
SBI71APE7837355,63,18,16,2,1
SBI21WDU4924250,73,30,26,4,1
SBI15GNY3273009,24,21,11,10,1
SBI76CUM4034213,75,19,10,9,1
SBI74FYY8205662,22,17,9,8,1
SBI86WYC1625802,77,22,19,3,1
SBI44VLQ2195550,90,23,13,10,1
SBI92ZTX1660722,79,33,26,7,1
SBI41YNG9059121,66,29,19,10,1
SBI32TWF1544577,70,34,23,11,1
SBI73NRI5228191,20,22,16,6,1
SBI33IFZ0838414,91,20,19,1,1
SBI15HDT2239777,18,27,17,10,1
SBI19EWD9378585,19,30,26,4,1
SBI09OLF8953627,23,30,19,11,1
SBI10WQF5599678,70,18,16,2,1
SBI17CVV1141941,18,16,11,5,1
SBI09IGV9146403,92,21,12,9,1
SBI27UID0538515,75,14,13,1,1
SBI78BVL3285036,80,25,23,2,1
SBI38NUP4836085,60,29,22,7,1
SBI02HUA9193789,77,23,13,10,1
SBI33OAV4006896,79,22,12,10,1
SBI43ZXW6063864,61,20,13,7,1
SBI20JOU7369015,20,34,25,9,1
SBI85WCU3042562,23,20,17,3,1
SBI47KGU9062880,96,30,16,14,1
SBI02XTW9055285,89,29,21,8,1
SBI54IRH3731841,92,25,24,1,1
SBI34KOJ3513635,65,17,14,3,1
SBI48ZDE8257815,20,27,25,2,1
SBI08NNM5272643,24,24,14,10,1
SBI18PEY1564184,66,32,22,10,1
SBI29UTQ2147517,62,27,18,9,1
SBI04JPU2722395,89,22,13,9,1
SBI19GGP5207673,87,34,24,10,1
SBI72RDM6380231,80,21,15,6,1
SBI64HEI7108741,68,32,21,11,1
SBI30YKQ7473666,25,25,13,12,1
SBI52EZM5816546,23,17,10,7,1
SBI79QGK0366479,20,14,8,6,1
SBI97ICV0650058,93,25,22,3,1
SBI03NSL4826832,89,27,19,8,1
SBI28GTS7001777,80,25,15,10,1
SBI19ZRI3213080,74,15,13,2,1
SBI86CEC1490388,68,31,19,12,1
SBI18ZRK3279548,96,21,17,4,1
SBI28QVD9372107,61,27,25,2,1
SBI89KWS6731289,80,24,18,6,1
SBI92KSV4196745,99,23,19,4,1
SBI83FSZ6806628,71,23,21,2,1
SBI54BFO2943411,89,37,32,5,1
SBI93QZL3720080,73,21,18,3,1
SBI64PFE3748803,61,26,18,8,1
SBI73PUL0218511,80,35,28,7,1
SBI55TKX4695695,79,23,12,11,1
SBI79QRA4112021,67,29,17,12,1
SBI44VRE5930851,70,33,18,15,1
SBI35NRY0287186,19,16,11,5,1
SBI82JSD1154203,97,27,20,7,1
SBI09FML1524010,81,23,21,2,1
SBI64KLR3906868,25,24,14,10,1
SBI56OOH0935033,72,22,15,7,1
SBI02RDS7788171,74,24,15,9,1
SBI19YPO7788259,67,22,16,6,1
SBI76QNN3844991,21,23,16,7,1
SBI06WZK4571171,99,25,24,1,1
SBI79VVM6364835,74,19,18,1,1
SBI60HYV5381087,76,20,12,8,1
SBI28SEJ4464057,64,20,15,5,1
SBI79LVO4790737,95,33,19,14,1
SBI63WOH8149800,63,29,15,14,1
SBI53NLM2610337,19,25,15,10,1
SBI53RRB1629018,79,24,15,9,1
SBI95XHP0853658,64,26,24,2,1
SBI50UBJ7639126,75,31,22,9,1
SBI97FMD0128954,76,18,14,4,1
SBI77RYD7665655,75,17,12,5,1
SBI30QNU2481559,80,28,15,13,1
SBI27LNU4864185,19,27,24,3,1
SBI77MPO0940982,90,26,15,11,1
SBI11JFX9792366,81,30,25,5,1
SBI26ASL6360329,60,12,11,1,1
SBI06SCI7276096,92,27,14,13,1
SBI97ZNL5373364,80,30,28,2,1
SBI64QEH5216578,83,20,13,7,1
SBI18FAC4358840,62,17,10,7,1
SBI11EYJ0433246,64,26,24,2,1
SBI39JWS2382563,90,30,28,2,1
SBI88SIJ9821581,78,28,15,13,1
SBI59LGI2547368,62,16,13,3,1
SBI89IEE5435740,21,29,17,12,1
SBI48MBY3135387,93,21,16,5,1
SBI32MMX3300203,63,22,17,5,1
SBI09RDP3386074,81,16,12,4,1
SBI42WVB5596569,97,22,14,8,1
SBI46HQO6558993,81,27,22,5,1
SBI38ZIP1136210,62,27,22,5,1
SBI70RZM1742632,96,18,15,3,1
SBI29RPO2811471,71,17,10,7,1
SBI89LFL0897907,82,12,8,4,1
SBI46DNB7306347,88,21,17,4,1
SBI77YPP2003477,80,22,19,3,1
SBI08VAU4277874,19,27,14,13,1
SBI27SEN6108869,76,24,16,8,1
SBI79RMJ6683107,87,19,16,3,1
SBI09GJU9751034,89,21,13,8,1
SBI10VYJ3469195,67,28,26,2,1
SBI25RVR7606090,73,20,15,5,1
SBI99NAX1693667,99,20,19,1,1
SBI00KPT0840570,79,18,17,1,1
SBI80JQY7473033,85,21,19,2,1
SBI46NMI3194541,86,22,20,2,1
SBI66XBJ4448111,95,19,11,8,1
SBI56RJL3026961,60,37,31,6,1
SBI12GFQ3985927,93,18,14,4,1
SBI59XIE6652304,74,23,18,5,1
SBI76LFL9443595,84,26,21,5,1
SBI92XKG9391388,62,29,22,7,1
SBI35UPS1368097,22,40,28,12,1
SBI67XVS5263244,90,26,25,1,1
SBI31LUO4442878,81,30,26,4,1
SBI70CXQ3890085,82,17,11,6,1
SBI23CKN6064818,79,31,26,5,1
SBI23SWO4255081,76,20,17,3,1
SBI74PVY6231634,65,13,9,4,1
SBI88TWY6767422,21,26,20,6,1
SBI17ANK1786392,78,30,24,6,1
SBI91TBI0332032,65,30,23,7,1
SBI77AYP2915387,81,25,15,10,1
SBI43WFK0137976,21,23,12,11,1
SBI73PUG5116519,90,16,12,4,1
SBI49WBQ4051110,75,22,21,1,1
SBI67OMI4034080,94,25,18,7,1
SBI14BTS2324989,87,22,17,5,1
SBI87KKJ2247535,20,25,16,9,1
SBI56NDP6924719,67,34,33,1,1
SBI48GXO2442127,89,19,16,3,1
SBI21OAO5356039,78,18,16,2,1
SBI07ASZ9640347,81,30,26,4,1
SBI31RWL3998856,96,29,25,4,1
SBI93MTH1864770,85,19,15,4,1
SBI09TPE9842749,78,15,11,4,1
SBI58ZGX7191611,72,33,28,5,1
SBI82NLD9630528,95,30,23,7,1
SBI36OFV7187404,70,25,16,9,1
SBI33OKD6323494,96,17,13,4,1
SBI03AWC0503420,99,24,15,9,1
SBI79BIQ0159410,83,24,14,10,1
SBI35ABF3739587,69,29,27,2,1
SBI30KBA2756571,20,29,18,11,1
SBI59RFW3408932,25,21,11,10,1
SBI22QBJ6045497,82,19,14,5,1
SBI25FYO4814501,20,21,12,9,1
SBI77CFL1868180,91,26,20,6,1
SBI64KXB0415441,70,17,15,2,1
SBI52RGE3275560,64,19,14,5,1
SBI27FBV3127700,76,21,14,7,1
SBI64LYM6898367,61,25,20,5,1
SBI86NPL4531600,72,24,16,8,1
SBI91DYD8782546,62,29,21,8,1
SBI02ERX0816540,99,22,17,5,1
SBI67MXD3460737,21,25,15,10,1
SBI57ULI1458113,23,30,26,4,1
SBI74UTT1129534,90,26,14,12,1
SBI80CFS5129237,62,13,11,2,1
SBI18ZUI9465273,62,17,15,2,1
SBI24JJT6612004,89,24,15,9,1
SBI23RWR0617623,64,27,24,3,1
SBI27SSZ4815558,74,32,29,3,1
SBI25SDO8477284,21,32,30,2,1
SBI06DBS9841822,23,26,21,5,1
SBI89CGJ2577870,87,26,16,10,1
SBI40NNC2273695,24,20,12,8,1
SBI08NIP6610188,73,23,18,5,1
SBI92RJO9885850,78,26,15,11,1
SBI64FVL3611924,99,23,13,10,1
SBI92KKC4370225,21,32,27,5,1
SBI91LKC9363479,86,30,26,4,1
SBI19SYF9000419,85,24,21,3,1
SBI48GBE3646290,24,27,20,7,1
SBI95VRB2256263,80,25,24,1,1
SBI81ZXV1379412,71,25,15,10,1
SBI80NFM8346746,83,20,14,6,1
SBI66FZO0062874,73,19,10,9,1
SBI95MUI4691319,99,33,25,8,1
SBI14VLM2611825,64,26,14,12,1
SBI65LMQ0936610,69,27,19,8,1
SBI33AGL6160734,94,29,22,7,1
SBI30EBU9081064,74,25,21,4,1
SBI41QGJ6572572,63,28,21,7,1
SBI96LZW3291051,96,28,15,13,1
SBI73GUA4801447,62,28,16,12,1
SBI50SOV6816696,18,30,19,11,1
SBI98TFR8847294,63,31,20,11,1
SBI35JDO6217693,93,28,20,8,1
SBI92IUL0968386,77,17,13,4,1
SBI45USF8879672,91,23,20,3,1
SBI96KRX8867220,69,24,18,6,1
SBI07GJF4091319,97,26,25,1,1
SBI37PHX5748561,91,22,21,1,1
SBI95CCE2839374,22,20,13,7,1
SBI23KXT4175322,88,29,17,12,1
SBI06HAA2031761,79,32,22,10,1
SBI44TDA8043619,21,17,9,8,1
SBI68MNM0964294,76,28,21,7,1
SBI10JRZ3916554,68,31,20,11,1
SBI22KNC5346306,70,19,14,5,1
SBI74HZX5820647,93,19,14,5,1
SBI81RYO6633300,73,20,19,1,1
SBI79GQK3794383,73,30,21,9,1
SBI86JQZ4627008,84,27,18,9,1
SBI69MEI2078611,82,21,18,3,1
SBI12RNL3761582,61,17,15,2,1
SBI48YCX0472791,24,30,21,9,1
SBI45WKN2051883,78,19,11,8,1
SBI05MPK9955318,18,14,9,5,1
SBI66QNY6223205,78,28,19,9,1
SBI08WNZ4251910,91,25,16,9,1
SBI46TBD6519891,73,23,14,9,1
SBI13QRA1727955,71,9,6,3,1
SBI86WGY5963937,63,29,15,14,1
SBI27MPL2411447,20,23,16,7,1
SBI93YUD5686801,66,21,16,5,1
SBI49EQI8778083,93,30,24,6,1
SBI86UGP6830249,76,23,21,2,1
SBI88FZR0879846,71,19,13,6,1
SBI68KLP9709195,93,17,14,3,1
SBI55JOY8624906,81,30,19,11,1
SBI51NID0654540,19,22,14,8,1
SBI61SXK5994527,81,22,18,4,1
SBI70FXZ0838188,66,31,22,9,1
SBI94KWH5919694,18,23,15,8,1
SBI08SKK4909291,81,16,12,4,1
SBI56NOB8442566,82,21,16,5,1
SBI80UCB3259957,85,29,26,3,1
SBI64IOJ7209989,62,24,21,3,1
SBI95GOF4123060,99,18,10,8,1
SBI53RUE3885083,66,17,15,2,1
SBI73NVI0418062,72,26,15,11,1
SBI86XYI6027134,84,21,20,1,1
SBI59QVM8754712,92,25,22,3,1
SBI48GRJ6054045,94,23,13,10,1
SBI82NTS0126310,97,25,14,11,1
SBI86JPG1096425,74,27,25,2,1
SBI93NRK3206143,98,21,12,9,1
SBI97LZM3799119,92,20,12,8,1
SBI06KCY3993244,84,19,12,7,1
SBI75BTM8748639,98,35,20,15,1
SBI47BTF5023011,98,29,25,4,1
SBI05MSU8272103,75,22,13,9,1
SBI93MQY5694395,66,24,17,7,1
SBI98MTA8713910,77,22,19,3,1
SBI80AXS3587066,89,36,28,8,1
SBI80BGP0571310,82,16,10,6,1
SBI10KTO8012488,71,20,12,8,1
SBI29HZV2337173,74,30,28,2,1
SBI86UUU6513418,97,23,22,1,1
SBI96JXI9503845,67,25,14,11,1
SBI37UKB8316312,70,24,15,9,1
SBI03TMW6537631,67,26,23,3,1
SBI85HKE8959359,89,21,13,8,1
SBI42XAS1978983,95,23,20,3,1
SBI42MNO2216489,95,24,18,6,1
SBI07MOF3521287,83,24,13,11,1
SBI30SPA2308324,76,28,26,2,1
SBI52EEZ1878965,81,16,9,7,1
SBI83UPQ1137033,98,17,9,8,1
SBI22WGY5104926,74,26,24,2,1
SBI07QUZ5447695,90,22,18,4,1
SBI36AVN2667070,70,17,11,6,1
SBI78SMC5800493,91,25,17,8,1
SBI66XDT4394007,98,33,25,8,1
SBI48RVO0398135,78,26,15,11,1
SBI35PYB5250855,89,22,13,9,1
SBI18HRI8870237,73,24,18,6,1
SBI82KFX0291155,66,22,12,10,1
SBI42ZXM3809060,85,22,19,3,1
SBI93UXR7470599,63,33,24,9,1
SBI26OLX8157450,72,28,25,3,1
SBI78GVV1019683,91,31,30,1,1
SBI09AOT2814506,93,32,29,3,1
SBI13OOX2363251,19,17,9,8,1
SBI73CYF4905621,96,17,9,8,1
SBI59TRS9822746,78,19,14,5,1
SBI46LVK0711371,82,23,21,2,1
SBI55SRW1016361,91,27,17,10,1
SBI17CHG4733975,69,27,26,1,1
SBI36YNI4287915,92,21,12,9,1
SBI33YCT1457884,66,28,18,10,1
SBI12JBR0108552,22,20,16,4,1
SBI64DTI2466089,97,28,25,3,1
SBI97DPZ1071566,91,23,12,11,1
SBI21ILJ3983554,72,16,10,6,1
SBI54FCO4895929,83,27,16,11,1
SBI60TYL8645762,64,23,14,9,1
SBI29WEW1995285,90,22,20,2,1
SBI29HQQ0513064,82,18,13,5,1
SBI22YFN8533927,91,23,18,5,1
SBI26ZAU2302414,65,19,17,2,1
SBI89CCJ2000341,74,32,20,12,1
SBI15FDS2672576,69,27,18,9,1
SBI51DDQ7957599,82,23,20,3,1
SBI69UVR2826253,19,20,18,2,1
SBI18LFF0351152,25,30,29,1,1
SBI50MXU1445220,72,27,24,3,1
SBI33KJQ2464994,75,18,10,8,1
SBI08CUL0952031,65,25,21,4,1
SBI36NXH4577919,81,24,14,10,1
SBI39SMB8063006,87,17,11,6,1
SBI67YYB5469357,20,21,19,2,1
SBI86IKV3268288,91,36,35,1,1
SBI05FHJ2456897,81,25,23,2,1
SBI24ITH2221020,76,23,15,8,1
SBI75NYE3698432,64,18,13,5,1
SBI07KGF4046604,78,19,16,3,1
SBI28OXX1696005,60,32,29,3,1
SBI44WBR8393310,86,27,23,4,1
SBI91WYX2604638,22,27,20,7,1
SBI53IJR9905326,79,34,28,6,1
SBI74QDX3435934,19,28,17,11,1
SBI74CKV2952439,61,26,23,3,1
SBI20GTZ6314536,24,31,17,14,1
SBI60NBL4567392,18,18,13,5,1
SBI77KOW3484780,24,19,15,4,1
SBI94QIO5023856,76,25,19,6,1
SBI55GCW8954972,92,22,16,6,1
SBI92TYT7063758,73,20,18,2,1
SBI31LWS3212797,85,28,16,12,1
SBI38NQK8128400,87,27,15,12,1
SBI75MUK6118077,83,19,18,1,1
SBI60LQW3524012,93,28,24,4,1
SBI90RMI3123096,92,25,17,8,1
SBI27GXL8729116,77,23,12,11,1
SBI04WZP4479298,83,25,18,7,1
SBI12NKQ1227073,20,17,13,4,1
SBI47LSG8164978,18,16,12,4,1
SBI55MBD6432507,25,20,17,3,1
SBI91WWF0988416,69,23,18,5,1
SBI82XUP5991433,87,24,21,3,1
SBI23NHL1356813,75,31,30,1,1
SBI67IFM2303706,71,17,13,4,1
SBI72UGK5436166,74,18,13,5,1
SBI35AZS1823297,80,26,14,12,1
SBI16TLJ9872963,25,31,19,12,1
SBI95BGF4439959,82,31,28,3,1
SBI99SKW5093888,84,21,14,7,1
SBI67GYI9720919,60,23,19,4,1
SBI03YAQ7384341,90,13,10,3,1
SBI97GEK0199871,97,29,20,9,1
SBI89XYF2806755,71,30,28,2,1
SBI82CAL4674074,91,19,12,7,1
SBI07LVB5163136,68,23,21,2,1
SBI76IDX2587684,23,22,17,5,1
SBI74KRL9014322,60,16,13,3,1
SBI17GHT3546047,87,25,15,10,1
SBI57RDB0141211,78,23,17,6,1
SBI03QEX2298806,90,31,22,9,1
SBI98RPS9293949,80,32,26,6,1
SBI84QYK3828460,93,20,16,4,1
SBI97NEJ6335734,20,27,24,3,1
SBI25IRA5092594,61,28,26,2,1
SBI37RME3495618,92,34,20,14,1
SBI61XJM1801332,79,23,17,6,1
SBI73VQV1496210,66,19,14,5,1
SBI03KOW3493034,79,22,20,2,1
SBI49JTT4874379,18,24,15,9,1
SBI77HHG2606657,25,19,12,7,1
SBI62BFO4433952,25,27,23,4,1
SBI16IFC9273600,24,28,16,12,1
SBI82UEB9417639,20,20,11,9,1
SBI77QFE7482280,78,39,32,7,1
SBI42NGV9696852,74,18,12,6,1
SBI56PSH9524888,85,23,16,7,1
SBI01GSO6821007,67,26,16,10,1
SBI56QEZ7135722,18,30,16,14,1
SBI38DHU1881399,89,23,17,6,1
SBI76YBK0503911,60,24,15,9,1
SBI67QQP7259633,76,25,23,2,1
SBI46ZDV9599345,67,20,15,5,1
SBI90ESC3191900,18,28,19,9,1
SBI30TEX6972396,88,20,16,4,1
SBI44KQI2587875,19,31,23,8,1
SBI73XQZ3248819,75,27,24,3,1
SBI85XJS6825996,61,18,11,7,1
SBI19JAL4260138,80,19,16,3,1
SBI14VLQ8683188,75,21,12,9,1
SBI18VKS8455592,19,22,20,2,1
SBI81OOS4801797,69,29,16,13,1
SBI45SUT4804867,84,18,15,3,1
SBI57DSJ6197657,73,26,16,10,1
SBI39NSV8363964,82,23,21,2,1
SBI81NEE5118717,96,21,12,9,1
SBI80GPA5249883,24,30,24,6,1
SBI82JUE0690740,85,26,20,6,1
SBI37NZZ5338049,21,25,22,3,1
SBI98KFE4833196,96,23,18,5,1
SBI88BJW9438858,64,29,15,14,1
SBI91RLS9997491,91,15,14,1,1
SBI39OYS2138935,64,15,13,2,1
SBI36WDI5157547,72,27,24,3,1
SBI07GSG3759049,98,20,19,1,1
SBI33ERA3668693,91,29,22,7,1
SBI29KKO7292355,19,25,22,3,1
SBI78LPY3182937,95,25,20,5,1
SBI56VFY4561656,60,18,11,7,1
SBI06BQB6932568,66,29,18,11,1
SBI53RVI0367989,71,22,16,6,1
SBI50VMD0850316,62,25,17,8,1
SBI70NRD4748550,98,23,16,7,1
SBI96ZVX1282209,20,21,18,3,1
SBI95BKT1336523,81,18,16,2,1
SBI23MZW4537210,94,27,15,12,1
SBI81ZKH2101260,84,29,15,14,1
SBI51FZJ2659317,72,34,26,8,1
SBI15KTN4849790,64,22,14,8,1
SBI44EIK2313696,93,17,15,2,1
SBI39UPH3026803,72,28,19,9,1
SBI39TEK4119608,95,31,23,8,1
SBI38ICF7341411,64,23,18,5,1
SBI41XEU4221295,99,23,22,1,1
SBI42DHX6936697,22,30,29,1,1
SBI01EEW7981629,98,28,23,5,1
SBI45ULO9510080,20,23,18,5,1
SBI70HGN5515255,93,17,15,2,1
SBI58HLS1046721,71,17,15,2,1
SBI60SVV6491256,71,27,14,13,1
SBI82ENN9624151,99,35,26,9,1
SBI05ADJ1897121,75,24,19,5,1
SBI25BBB4500084,93,18,14,4,1
SBI46EQV7410997,81,24,23,1,1
SBI51BLW5234641,98,24,16,8,1
SBI36ANN4870212,80,23,19,4,1
SBI90NPW1358899,81,35,21,14,1
SBI57KCY1693337,24,23,14,9,1
SBI68YAX8785035,92,23,16,7,1
SBI56JLX8779030,87,19,12,7,1
SBI66CAL6374502,86,25,17,8,1
SBI84NEU4335620,75,26,14,12,1
SBI87CUE5225077,64,22,21,1,1
SBI54WDP8783323,71,24,15,9,1
SBI08XQI7312458,99,25,23,2,1
SBI56MOG8105433,18,30,27,3,1
SBI44SYV5969109,89,25,16,9,1
SBI81DAX2479591,19,22,12,10,1
SBI62VXE6923188,79,24,20,4,1
SBI09MWJ4421722,64,23,15,8,1
SBI44VYP0129024,71,19,15,4,1
SBI37PRW0996139,67,30,25,5,1
SBI83JGI7979922,70,19,13,6,1
SBI67WXY2471563,97,23,15,8,1
SBI53XNY7886207,21,34,18,16,1
SBI16CSO2851307,94,27,25,2,1
SBI28BKJ2825314,90,26,20,6,1
SBI68RDH4411368,21,24,21,3,1
SBI14VLS8001129,60,25,24,1,1
SBI95OZU6225255,18,13,7,6,1
SBI73ARI9914012,83,26,23,3,1
SBI39OPJ5227372,75,20,12,8,1
SBI41PBQ0145218,65,24,13,11,1
SBI73DKL0955576,60,23,12,11,1
SBI88RAD5636306,64,21,20,1,1
SBI15DOP6663600,23,11,10,1,1
SBI82ULK9214169,66,33,32,1,1
SBI84NVR4407093,69,20,14,6,1
SBI44DEX8326046,20,21,12,9,1
SBI09BDA9828798,77,29,21,8,1
SBI02JOZ5362744,91,21,18,3,1
SBI61VBO5467032,71,31,27,4,1
SBI12OUH5097385,77,29,23,6,1
SBI79TXR7851010,85,19,16,3,1
SBI35UXU3982298,83,33,21,12,1
SBI02TBR0572351,94,16,15,1,1
SBI57FDK9018922,62,18,17,1,1
SBI62HIL1042720,22,24,16,8,1
SBI52HIM7682369,19,25,14,11,1
SBI44POP0958760,72,23,13,10,1
SBI11AXS9678188,88,10,7,3,1
SBI74GKF9992154,78,27,18,9,1
SBI47QLY2932475,20,31,29,2,1
SBI70JHN7953250,63,24,19,5,1
SBI75MGA6263742,22,13,11,2,1
SBI64QFV7430096,83,23,14,9,1
SBI99KXD5959080,90,23,17,6,1
SBI49LTV8587587,74,19,10,9,1
SBI08VLP3838077,84,33,21,12,1
SBI05VKG5185628,72,26,21,5,1
SBI66BYW5541268,77,21,16,5,1
SBI58MVA4363722,95,29,21,8,1
SBI06LNE7178061,87,25,23,2,1
SBI30BYU8064109,67,25,15,10,1
SBI08SBD5985229,18,27,17,10,1
SBI76CJY8352693,21,21,11,10,1
SBI91XQE9393392,91,20,15,5,1
SBI65GUX9713536,21,32,24,8,1
SBI20SAF2201662,66,19,14,5,1
SBI71KVK4048611,78,17,14,3,1
SBI28GDX6452555,89,30,24,6,1
SBI25UXS8569361,80,25,22,3,1
SBI10DHJ0672695,92,28,20,8,1
SBI40SCK1547087,88,23,19,4,1
SBI22BBQ4244751,75,23,18,5,1
SBI43TAC4949636,24,16,13,3,1
SBI79LOV1029608,21,29,17,12,1
SBI63JRX2636781,73,25,14,11,1
SBI74CMA6261070,77,26,18,8,1
SBI87NRH2711844,74,17,10,7,1
SBI88GKQ8347632,68,26,23,3,1
SBI04SWH0980104,97,26,14,12,1
SBI15VAW1077488,72,21,12,9,1
SBI97MSJ8582901,65,28,26,2,1
SBI13KLL3557948,25,26,18,8,1
SBI74AFW4767996,25,19,18,1,1
SBI04FTY2841444,19,33,22,11,1
SBI08XCR7406986,88,18,17,1,1
SBI40ESR7286565,68,27,17,10,1
SBI47QTE3733193,18,24,13,11,1
SBI68WUJ7520173,65,15,9,6,1
SBI28HEE1555073,95,23,18,5,1
SBI79IZZ3863349,65,25,16,9,1
SBI52QCI6957077,93,34,20,14,1
SBI72XTX2460359,81,27,21,6,1
SBI63TKK7140680,96,27,18,9,1
SBI10OXL8193940,72,24,23,1,1
SBI88YFX8927170,21,17,9,8,1
SBI15IVI7228365,63,24,13,11,1
SBI86UQE9180233,75,23,16,7,1
SBI34AMY4359430,24,14,11,3,1
SBI95GNW6389173,78,22,15,7,1
SBI67DGW3212683,75,30,22,8,1
SBI58SFT3746638,65,31,22,9,1
SBI01DZM3167133,74,23,19,4,1
SBI53KRH5420619,84,22,17,5,1
SBI27WYV7795071,63,27,21,6,1
SBI56EYJ6077531,83,25,24,1,1
SBI37CXU3112486,81,28,16,12,1
SBI67CHO4013489,95,29,20,9,1
SBI85AAU5396960,64,23,14,9,1
SBI29FTI1078815,76,19,18,1,1
SBI78VFM2077456,79,16,13,3,1
SBI89QNS8300813,20,28,15,13,1
SBI40SUG8699650,82,18,17,1,1
SBI59FPO4986725,63,26,17,9,1
SBI84AKM2749334,89,21,16,5,1
SBI74LJH6244661,89,23,20,3,1
SBI34HDR6495459,20,21,16,5,1
SBI32NDY0980898,71,27,18,9,1
SBI46COX8854960,95,25,14,11,1
SBI48AKU6419062,73,19,14,5,1
SBI89WYT1418774,20,24,21,3,1
SBI97FTH6529949,94,27,19,8,1
SBI45AQW2472941,92,27,21,6,1
SBI85QGS4619396,70,27,25,2,1
SBI51LZM9654447,76,33,21,12,1
SBI95HEF7537631,95,24,21,3,1
SBI13BXA2738029,62,24,17,7,1
SBI94YKP6650135,75,36,29,7,1
SBI77ONA9866237,99,33,28,5,1
SBI16PMV0475864,69,25,24,1,1
SBI84LEE4358654,81,33,18,15,1
SBI58IDS8071444,66,24,19,5,1
SBI83SUF6166215,72,20,16,4,1
SBI09YSP0642756,67,24,23,1,1
SBI12LPC6674323,20,35,27,8,1
SBI71RMZ1106082,97,35,25,10,1
SBI21DQU7636154,95,22,20,2,1
SBI00LLF7487900,24,22,14,8,1
SBI25JAQ6256702,91,23,22,1,1
SBI75KRV0880621,62,28,26,2,1
SBI02PHI4533842,19,25,22,3,1
SBI70UWB5379475,68,25,13,12,1
SBI38QWU0911685,98,17,11,6,1
SBI72QRH0550633,61,25,23,2,1
SBI61NSX8785260,24,31,23,8,1
SBI32HJU4190122,23,26,24,2,1
SBI32ZJU7335643,24,19,10,9,1
SBI92UQP9219619,85,28,23,5,1
SBI41NAK0937287,81,27,23,4,1
SBI83YLP3628842,70,23,14,9,1
SBI97SNK3196096,99,27,20,7,1
SBI20LXJ9625613,77,32,27,5,1
SBI83WMJ8454415,89,27,26,1,1
SBI70WMQ6231869,68,24,13,11,1
SBI63DKU6018019,93,23,12,11,1
SBI84BOU6137765,80,17,13,4,1
SBI47EKL6352660,68,21,14,7,1
SBI97MPZ5365293,60,24,18,6,1
SBI79MMG3000522,83,24,19,5,1
SBI77LSU4183468,22,22,19,3,1
SBI59GBK3579414,96,29,26,3,1
SBI86ARB8039142,74,20,19,1,1
SBI32KYT8133698,86,31,21,10,1
SBI25CYK9902503,23,35,30,5,1
SBI91WUX4866530,65,18,11,7,1
SBI49KMX8436350,85,21,17,4,1
SBI82ZJA2050229,64,22,20,2,1
SBI09ARP7695816,89,22,20,2,1
SBI94SIG4497104,75,22,17,5,1
SBI37LQN1745457,77,29,28,1,1
SBI29SKZ0757807,93,29,18,11,1
SBI46UWQ9506812,92,20,12,8,1
SBI15ZVM9276737,23,34,25,9,1
SBI68HID3757643,73,17,14,3,1
SBI51VDD6628548,24,19,15,4,1
SBI02CKG9043058,62,37,22,15,1
SBI46HTK1835955,76,15,8,7,1
SBI36AZK2329149,97,29,16,13,1
SBI02YXY8965647,20,27,16,11,1
SBI49OOD4339865,66,24,18,6,1
SBI60JIS1923904,72,24,18,6,1
SBI70AWJ9041738,64,18,13,5,1
SBI81JUP4018694,65,23,21,2,1
SBI61AVN6945105,76,17,15,2,1
SBI75CGX9620912,73,19,12,7,1
SBI86DKI4669549,68,27,22,5,1
SBI92ZIW5108180,66,26,18,8,1
SBI02SPG4887285,61,26,21,5,1
SBI10BCR4009592,18,21,14,7,1
SBI81OWJ2765644,71,22,17,5,1
SBI77APZ9899365,24,21,13,8,1
SBI19CKE2858829,82,18,17,1,1
SBI40ELO0623731,61,24,18,6,1
SBI25TCJ7791105,93,23,14,9,1
SBI40TZS3521847,78,27,23,4,1
SBI39DRE9504623,99,21,11,10,1
SBI17DHQ3249368,84,29,24,5,1
SBI10XFN6253544,20,24,20,4,1
SBI47SGT8091368,67,25,24,1,1
SBI42DDO4907376,77,25,19,6,1
SBI10XUZ6395964,95,22,18,4,1
SBI69IFF8794880,23,33,30,3,1
SBI01RWU6856367,75,26,24,2,1
SBI10ZAF5570002,79,19,12,7,1
SBI56WSV8331649,64,33,19,14,1
SBI64GBB1035454,79,11,7,4,1
SBI35VIO8849367,79,21,20,1,1
SBI35WJP5375926,24,28,16,12,1
SBI79RUV5961399,64,31,23,8,1
SBI54RYK1841281,67,20,15,5,1
SBI27VRN3399754,92,24,13,11,1
SBI55TVE0593681,88,25,14,11,1
SBI43HIF1663665,75,22,18,4,1
SBI34RYF7486559,23,29,24,5,1
SBI59QSV7838717,93,25,16,9,1
SBI69QBE7789940,76,29,15,14,1
SBI82WQX4824177,96,24,21,3,1
SBI61KPX7520349,94,26,17,9,1
SBI26LFL1228930,23,24,14,10,1
SBI31ONW0165133,77,35,30,5,1
SBI03SPD1596494,76,28,17,11,1
SBI44OQS3564005,84,25,18,7,1
SBI41JFR0926029,24,22,19,3,1
SBI00URK4515099,77,19,11,8,1
SBI47KXN6043127,95,24,22,2,1
SBI52EUK6824009,67,24,17,7,1
SBI47NWL0654228,78,34,30,4,1
SBI73PBO7171166,60,24,18,6,1
SBI67IGL9642670,81,21,19,2,1
SBI33QAX2038762,67,26,23,3,1
SBI49GZL4914991,60,23,18,5,1
SBI25UAF3543967,93,25,13,12,1
SBI55MNT3320139,86,17,12,5,1
SBI19GYG8308838,94,21,19,2,1
SBI08DSX4086284,95,24,15,9,1
SBI10PMQ1565845,64,14,12,2,1
SBI41ZLQ1160437,88,29,20,9,1
SBI65WRG3526235,99,20,18,2,1
SBI24XPA6887936,92,29,26,3,1
SBI71XLH3963303,18,21,11,10,1
SBI63SWL2066027,92,12,11,1,1
SBI91BWV7117738,78,30,26,4,1
SBI05RUC2521023,84,24,21,3,1
SBI81CMG1461220,95,23,15,8,1
SBI00VKG5528013,96,22,20,2,1
SBI59CML4921907,89,28,21,7,1
SBI86GEC7789864,19,37,24,13,1
SBI86FQB4817823,87,20,15,5,1
SBI18HAE9358494,68,24,13,11,1
SBI55HVH8448243,21,25,19,6,1
SBI28RYU3580430,84,26,17,9,1
SBI42WLY2264239,81,28,27,1,1
SBI73WXH7445518,60,16,11,5,1
SBI10XQD9350653,76,33,22,11,1
SBI27EOB6907625,24,20,12,8,1
SBI11CGP9149058,24,32,24,8,1
SBI69XHK1152333,81,28,22,6,1
SBI00JXL2457675,66,27,14,13,1
SBI58IXA1258361,72,19,12,7,1
SBI09UJI0622908,65,18,15,3,1
SBI48XFI3540904,73,19,14,5,1
SBI72YRU5389855,92,17,9,8,1
SBI62ELY7167669,90,6,5,1,1
SBI82SVX6722444,65,26,16,10,1
SBI33ROK6105562,24,27,18,9,1
SBI18DGV5041473,25,32,21,11,1
SBI24WWM5680907,66,20,17,3,1
SBI27SMC4717567,79,27,18,9,1
SBI11FYX1306107,99,15,9,6,1
SBI20MGS6388599,62,24,13,11,1
SBI24YCK3106525,84,16,12,4,1
SBI93CTZ2922133,73,23,22,1,1
SBI23MWR4029581,74,23,14,9,1
SBI32TEX1863009,97,29,18,11,1
SBI92TAU3311133,98,20,16,4,1
SBI66AOF1040024,19,25,19,6,1
SBI61TDB6828909,76,20,12,8,1
SBI64ILD1619273,90,24,18,6,1
SBI91DXV7466141,22,24,19,5,1
SBI16QVH7256174,62,22,12,10,1
SBI58TUT2571580,70,14,8,6,1
SBI13JJO5290853,25,10,7,3,1
SBI07TDH7079276,83,30,22,8,1
SBI26JBG2311678,76,29,19,10,1
SBI69XER9861765,81,29,15,14,1
SBI39WZG9915548,61,24,23,1,1
SBI46LDY8401190,97,23,20,3,1
SBI93MPZ8774254,24,17,14,3,1
SBI90YTT7724037,89,25,16,9,1
SBI26JVT1583751,92,25,16,9,1
SBI27ENI5888191,79,27,14,13,1
SBI39KUJ1893037,86,30,18,12,1
SBI98HGQ3581095,20,19,17,2,1
SBI04RDV0049901,66,23,20,3,1
SBI60OKC6725499,81,28,25,3,1
SBI36DZP8226723,62,27,23,4,1
SBI43BLM6865070,86,30,19,11,1
SBI04DNN3734738,76,31,27,4,1
SBI71ZEK5607743,83,19,18,1,1
SBI97YPH4213865,21,28,15,13,1
SBI49LSV2985328,97,29,15,14,1
SBI77JVG2562277,67,27,17,10,1
SBI93AHJ3042899,78,21,18,3,1
SBI00THP3685970,94,33,19,14,1
SBI34EVB2124382,21,31,23,8,1
SBI83KDB8182362,23,19,15,4,1
SBI59OYT2193954,86,26,22,4,1
SBI43LMW8771094,23,21,15,6,1
SBI52RYW1323387,86,20,15,5,1
SBI43MVD0675504,66,29,28,1,1
SBI92JLZ7242976,77,30,25,5,1
SBI02HAK5672776,77,26,20,6,1
SBI39ZTR5549052,73,15,10,5,1
SBI12HKK6563691,99,31,28,3,1
SBI52LVH6581639,81,17,12,5,1
SBI62ILK0334287,89,18,13,5,1
SBI70DSC8595819,75,27,17,10,1
SBI06KPO2033178,72,27,14,13,1
SBI21CDN0881811,21,28,21,7,1
SBI30QFX6064607,60,23,13,10,1
SBI23WXH8646824,74,26,21,5,1
SBI20JKT2704226,20,24,21,3,1
SBI21XRB7025014,70,17,16,1,1
SBI04VKN4185456,61,25,23,2,1
SBI44ZYT4976385,99,21,14,7,1
SBI26JNU2275192,69,25,22,3,1
SBI85KAP1804188,71,21,19,2,1
SBI31VBH5945839,20,25,16,9,1
SBI22NQL8693217,89,25,19,6,1
SBI61MOX4578048,84,27,26,1,1
SBI38OAY8526140,96,28,23,5,1
SBI90IIP0772079,19,16,10,6,1
SBI33SRD9054487,84,23,19,4,1
SBI93BZT7431291,73,23,17,6,1
SBI60XXP7167420,24,20,17,3,1
SBI46ATG6688223,88,25,15,10,1
SBI20PJB4295072,25,29,23,6,1
SBI89WNI4171866,95,19,12,7,1
SBI20AWB8660917,19,29,16,13,1
SBI85SHT7176552,60,29,25,4,1
SBI77WPW2112820,93,28,19,9,1
SBI86ZEE1896071,90,25,24,1,1
SBI59SEF1964544,66,17,10,7,1
SBI36RMC8012685,67,23,12,11,1
SBI15JNI4055858,72,26,23,3,1
SBI85JZT4020369,81,22,17,5,1
SBI94UFN5424593,65,22,15,7,1
SBI12CKF0152166,20,22,19,3,1
SBI85NFJ1672018,61,23,18,5,1
SBI31QZH0550751,75,27,18,9,1
SBI84GAP6070241,72,23,17,6,1
SBI23MDP5951736,19,21,13,8,1
SBI29JDN6322535,67,27,23,4,1
SBI54CCR6994882,78,19,15,4,1
SBI68UUM6263020,61,22,20,2,1
SBI18PHS8423895,23,30,22,8,1
SBI64NDC8725372,78,25,14,11,1
SBI88IIV9557072,91,23,19,4,1
SBI09ERP2921598,18,28,16,12,1
SBI33IPA8884513,69,16,12,4,1
SBI22EXO1907972,94,19,13,6,1
SBI05GYA6197124,66,29,25,4,1
SBI73NRY8266197,94,24,18,6,1
SBI44NEA8179330,89,30,25,5,1
SBI05GRI5556651,93,25,23,2,1
SBI20GQL3957448,23,28,15,13,1
SBI11GFJ7004545,19,16,9,7,1
SBI24PIN6496880,80,32,26,6,1
SBI60UUU2990143,91,28,16,12,1
SBI39ONR8772506,79,19,14,5,1
SBI76JDL0648325,81,27,21,6,1
SBI87XTS8890394,83,34,30,4,1
SBI09ZQN1150896,88,23,19,4,1
SBI82CJZ0092442,65,23,16,7,1
SBI82ADK6459808,63,10,7,3,1
SBI57LEE9154813,24,25,21,4,1
SBI55EKR0207150,68,23,16,7,1
SBI19HJM3335253,67,17,14,3,1
SBI12BKO6716512,76,29,28,1,1
SBI01CNA9481442,19,25,18,7,1
SBI40CQJ8886493,87,24,20,4,1
SBI43MYI0814754,21,17,16,1,1
SBI52QAK7883314,77,30,22,8,1
SBI70ZPE5548255,24,27,25,2,1
SBI10BRR0665892,76,31,29,2,1
SBI13UJZ2871234,61,28,19,9,1
SBI14ZVQ9456975,25,17,10,7,1
SBI66IEA8560934,98,28,23,5,1
SBI91VMB3295424,70,15,10,5,1
SBI79KIY1730467,60,35,29,6,1
SBI01RAV6947427,68,23,22,1,1
SBI85QFZ4590813,65,24,21,3,1
SBI77YYR7441841,82,24,13,11,1
SBI18OAW2202041,99,26,14,12,1
SBI65VAD7200586,94,27,24,3,1
SBI36GLH2533657,82,19,13,6,1
SBI79VOQ2301079,62,29,18,11,1
SBI81SZE1033549,98,20,11,9,1
SBI90QMR0055092,99,27,21,6,1
SBI34TWU5060753,78,22,19,3,1
SBI69QXI6550559,97,20,15,5,1
SBI67MNK7598667,90,15,9,6,1
SBI27SKC9912746,74,23,16,7,1
SBI99KQI0597883,91,21,16,5,1
SBI15CAL3613070,79,24,18,6,1
SBI80ESR7021028,79,20,18,2,1
SBI78XLN6323144,75,22,15,7,1
SBI52QDS3921677,23,26,15,11,1
SBI87EXU9733445,96,21,12,9,1
SBI77SNT8480861,77,27,18,9,1
SBI85EGG5177350,80,23,21,2,1
SBI98HUK0791576,60,18,13,5,1
SBI59FMC5795107,21,24,17,7,1
SBI07PLH8645085,77,25,13,12,1
SBI70WTO6730979,75,20,11,9,1
SBI90XIG8400206,69,29,22,7,1
SBI33LER8728606,24,30,21,9,1
SBI77YFI1777132,97,31,16,15,1
SBI42FPP6272721,97,26,16,10,1
SBI06LJJ2009108,82,18,17,1,1
SBI56TFK5345173,74,18,14,4,1
SBI09VHE2313311,18,13,9,4,1
SBI78CGV8624755,92,28,20,8,1
SBI07ANJ6813378,70,25,24,1,1
SBI83OOY1093539,63,28,26,2,1
SBI52WJN7029044,74,24,20,4,1
SBI40MIB5260533,24,23,15,8,1
SBI72VAI4142559,19,14,12,2,1
SBI49XER7749405,70,25,24,1,1
SBI61NDB6728112,88,26,20,6,1
SBI56YVM5823958,91,19,10,9,1
SBI57CRE3334161,20,29,28,1,1
SBI53JXO3190456,76,26,16,10,1
SBI79HMX9365835,69,25,19,6,1
SBI74MIL8014740,20,20,16,4,1
SBI21DMJ5203077,61,29,28,1,1
SBI52MTJ3987625,84,29,26,3,1
SBI56AIW5505616,61,26,15,11,1
SBI56MTO8861767,62,22,16,6,1
SBI25OLH6208507,86,25,19,6,1
SBI08UXL7377374,99,27,22,5,1
SBI11BEV1158193,70,17,16,1,1
SBI94LOB2673777,23,29,18,11,1
SBI29GIA0508222,21,29,19,10,1
SBI70WPZ4840993,98,30,16,14,1
SBI83PQU6334397,91,29,22,7,1
SBI70UHW8300932,74,23,21,2,1
SBI14FOL6102090,86,15,14,1,1
SBI65BDS6630907,72,16,11,5,1
SBI43FTM1613832,20,21,17,4,1
SBI44NYV9507671,72,17,13,4,1
SBI64EYT0599754,18,18,11,7,1
SBI62XUZ3710852,90,26,19,7,1
SBI40BDQ1644864,24,34,21,13,1
SBI83ARN9913655,21,20,14,6,1
SBI60GBR5248494,97,21,20,1,1
SBI05VGQ2115226,63,32,29,3,1
SBI67QTO4792267,96,29,25,4,1
SBI26KBW3970069,92,25,23,2,1
SBI94KFW4714628,80,24,18,6,1
SBI82UDW7125385,98,28,27,1,1
SBI84TSZ1217266,82,26,24,2,1
SBI09ITO1862351,73,25,22,3,1
SBI73AIG7347164,24,24,19,5,1
SBI07TBM8256882,66,26,17,9,1
SBI90TRX5562727,65,33,20,13,1
SBI82SIG9639189,96,26,25,1,1
SBI24TNZ2876070,70,23,20,3,1
SBI42IGC5873732,60,25,13,12,1
SBI83SCR0302603,65,24,19,5,1
SBI99LFJ5524708,64,28,24,4,1
SBI52SYM3333623,99,28,23,5,1
SBI80VMR8033975,76,34,24,10,1
SBI38AEK6111915,76,25,21,4,1
SBI14FNP5094894,70,28,24,4,1
SBI19XYH1254842,66,31,18,13,1
SBI14CPO3046639,25,20,15,5,1
SBI50ULE8420989,72,28,20,8,1
SBI31DGR2495035,82,38,37,1,1
SBI16SSA2679375,90,24,19,5,1
SBI24GOP0535804,24,26,17,9,1
SBI04HQX2612414,77,18,11,7,1
SBI41PMU9541847,91,18,12,6,1
SBI89MTJ6797583,68,27,15,12,1
SBI84HGU0264369,88,27,22,5,1
SBI44TGK0209732,75,24,13,11,1
SBI08UEF3179760,60,15,13,2,1
SBI89RLJ5156368,62,23,20,3,1
SBI33DAY2688608,88,26,21,5,1
SBI12APP7023395,75,21,15,6,1
SBI22JQE5580132,76,15,10,5,1
SBI70GBP5680667,98,20,13,7,1
SBI19EGH1157083,98,26,22,4,1
SBI70FFJ1981243,87,15,12,3,1
SBI53OAU7315214,63,21,12,9,1
SBI08ZEQ6457830,70,28,17,11,1
SBI20IPS4495878,62,25,21,4,1
SBI71ZGC5237030,65,19,11,8,1
SBI16BQH0130358,83,27,24,3,1
SBI26HGC5295831,95,26,15,11,1
SBI92QSL3684790,77,23,12,11,1
SBI64OSZ4924565,91,24,19,5,1
SBI99DAO5752318,99,18,13,5,1
SBI30LEL0010256,85,22,19,3,1
SBI84UYS3562568,74,17,14,3,1
SBI68BOX3213423,95,24,15,9,1
SBI21OXU5212136,92,27,23,4,1
SBI78MKU9997645,92,25,17,8,1
SBI95JSU3552761,20,21,17,4,1
SBI48CHV1473239,99,28,19,9,1
SBI34MWE8696275,79,18,10,8,1
SBI51VKF9666020,87,22,17,5,1
SBI07CBF0859611,76,27,23,4,1
SBI25HHA5144637,79,21,13,8,1
SBI45EXX0894945,24,28,24,4,1
SBI24XVJ2352525,89,25,23,2,1
SBI15APJ5075975,67,28,19,9,1
SBI15FGO9714477,98,26,17,9,1
SBI41KZT3980035,21,23,15,8,1
SBI92JHJ3845692,74,19,11,8,1
SBI95VSF0835846,76,25,20,5,1
SBI92IIP8395974,90,31,24,7,1
SBI20QUO5831684,72,25,21,4,1
SBI02TER2021997,62,21,14,7,1
SBI73EHQ6057456,86,32,18,14,1
SBI59PSD2411903,25,26,23,3,1
SBI67JNH3063614,98,27,17,10,1
SBI36FIS0330998,24,27,25,2,1
SBI52PHK6159413,85,27,21,6,1
SBI79TEP9826564,22,28,17,11,1
SBI66YCE4930041,81,27,23,4,1
SBI98OWJ5941248,81,16,9,7,1
SBI48UHP1120455,70,29,28,1,1
SBI29WLO0262140,98,19,14,5,1
SBI14KUE5989906,73,15,10,5,1
SBI96EBF8465793,19,20,17,3,1
SBI05SOV2743520,76,30,17,13,1
SBI11RKJ0630918,70,31,23,8,1
SBI11TLK6842769,88,22,18,4,1
SBI42EBA9288818,66,18,15,3,1
SBI41IQH3229192,19,24,13,11,1
SBI36BFT2275597,96,25,17,8,1
SBI68DBM6095945,78,31,20,11,1
SBI03RPA4491059,97,23,14,9,1
SBI07QZO1706653,73,25,21,4,1
SBI53HGJ2988453,70,20,16,4,1
SBI81AFF7685939,67,24,20,4,1
SBI18JSJ6788869,23,22,17,5,1
SBI83XIH4053564,25,25,16,9,1
SBI22ORZ7789514,93,19,17,2,1
SBI26JCR0613273,83,21,20,1,1
SBI31DLM0177417,95,24,17,7,1
SBI19CSQ8191432,22,22,13,9,1
SBI67USA2355101,67,19,17,2,1
SBI92RMX5196417,79,23,12,11,1
SBI41ILD7487762,79,22,12,10,1
SBI07BDB3174712,66,31,17,14,1
SBI18SVA0908327,22,24,23,1,1
SBI12TXP6594969,91,26,23,3,1
SBI28UNC4865535,19,25,21,4,1
SBI36CJR2915997,71,31,28,3,1
SBI88MUH2288220,84,25,24,1,1
SBI89HUX5707114,23,22,17,5,1
SBI29XGU3882270,98,16,13,3,1
SBI77VGE7489492,92,26,17,9,1
SBI16SAF9761789,69,26,25,1,1
SBI06UDB1695960,83,23,20,3,1
SBI61ADW3292973,83,26,18,8,1
SBI44ODM3240325,85,20,11,9,1
SBI31DLC9844981,89,29,17,12,1
SBI91LSP6397490,89,25,14,11,1
SBI23SFS0191041,19,28,18,10,1
SBI00XMH2290536,87,18,11,7,1
SBI78QSA8225404,79,24,23,1,1
SBI67CVH1307228,83,31,30,1,1
SBI64HXU5437452,21,22,18,4,1
SBI56FEZ1945822,93,19,10,9,1
SBI65DPH1345994,83,24,22,2,1
SBI45OVR2465492,85,25,16,9,1
SBI85PXI1899087,96,26,23,3,1
SBI30NSK9463951,71,18,10,8,1
SBI61UDX1021102,85,34,21,13,1
SBI54WXT0628680,83,29,26,3,1
SBI12SWQ7653564,89,19,15,4,1
SBI88XQE8155294,86,26,20,6,1
SBI61UFP7070094,91,16,13,3,1
SBI17PKX3779314,93,19,12,7,1
SBI50VQW5906637,65,21,13,8,1
SBI11HWO5514432,61,25,20,5,1
SBI47QYR8818456,85,23,13,10,1
SBI24WGH5604976,64,27,24,3,1
SBI38UOP0774113,94,24,23,1,1
SBI90HRW4607559,61,22,15,7,1
SBI71YVT6571179,96,31,30,1,1
SBI17UZF6918956,97,28,26,2,1
SBI78PES1585161,24,24,16,8,1
SBI63DHY5995144,82,25,21,4,1
SBI31UIF0205809,89,21,16,5,1
SBI23PPP1538874,24,21,15,6,1
SBI08LUW0677002,90,28,26,2,1
SBI80JXY7103600,80,27,16,11,1
SBI42LRU0380505,93,17,12,5,1
SBI79BGP8931951,18,34,25,9,1
SBI64ULV8038041,85,26,24,2,1
SBI70TTX5565324,62,29,19,10,1
SBI20OUP9568324,21,29,15,14,1
SBI28ZOX1990148,90,13,7,6,1
SBI57FZN9963702,99,19,11,8,1
SBI40JYZ9303264,65,21,15,6,1
SBI52BKV7232503,87,20,16,4,1
SBI19VIL6189615,64,33,28,5,1
SBI20DPP3989726,61,26,20,6,1
SBI02FGO2788068,95,18,17,1,1
SBI18JTB7725819,69,22,14,8,1
SBI70UME3195877,78,24,21,3,1
SBI36VEE2551429,72,25,16,9,1
SBI05VHE0017568,73,20,19,1,1
SBI10BMT1214138,70,22,20,2,1
SBI49GUT0316590,89,25,23,2,1
SBI20UHA0203531,25,27,19,8,1
SBI89FYQ8839502,72,20,12,8,1
SBI03HPT1844491,75,23,12,11,1
SBI25FCA4165806,81,24,16,8,1
SBI09MUK1852811,64,24,17,7,1
SBI00WZD2104466,97,27,25,2,1
SBI66NQY2544209,82,28,26,2,1
SBI28DRH2445566,98,29,26,3,1
SBI18CPV1899012,61,26,24,2,1
SBI77UOO4956643,98,29,24,5,1
SBI22OMF8396784,88,31,29,2,1
SBI57FRT7102547,22,31,28,3,1
SBI81UPI0360932,90,30,23,7,1
SBI73EFA5125404,61,31,28,3,1
SBI60ZAC2674822,63,27,25,2,1
SBI83BSZ7496007,62,29,21,8,1
SBI76RBN5270174,68,30,19,11,1
SBI12JCX3344582,83,25,22,3,1
SBI46AAO7108441,80,21,13,8,1
SBI15OMX4370311,22,23,12,11,1
SBI09DKJ9073989,64,17,15,2,1
SBI71IPO7964159,66,28,19,9,1
SBI80XXV1185050,72,15,11,4,1
SBI39JZV9327061,80,21,17,4,1
SBI72JLR7979418,25,27,20,7,1
SBI91FGY5123728,85,20,19,1,1
SBI23ILN6425402,81,25,13,12,1
SBI08DMH2954600,65,28,22,6,1
SBI02QYO9421740,66,33,28,5,1
SBI34IRJ5840186,93,24,16,8,1
SBI35DZX7746835,72,17,13,4,1
SBI85EGY0013007,23,24,22,2,1
SBI20DAJ7076353,68,17,16,1,1
SBI28XHZ6468479,77,27,19,8,1
SBI26ZNV9816570,94,21,15,6,1
SBI90XRM2639262,67,23,22,1,1
SBI24ARP4093786,74,22,15,7,1
SBI20ZPL1292857,22,29,23,6,1
SBI14JEY1839096,88,19,12,7,1
SBI12HUD3141628,24,30,25,5,1
SBI68CTN9756483,23,26,16,10,1
SBI50KOT2659266,25,19,17,2,1
SBI72CYS4661446,18,30,29,1,1
SBI33AJI1345565,79,25,17,8,1
SBI61OYA3691007,65,20,14,6,1
SBI85XZO0839251,22,24,13,11,1
SBI56CSH0527185,72,25,16,9,1
SBI44BRL5326871,68,28,21,7,1
SBI94ZVX7692137,75,23,14,9,1
SBI91CTU8853211,90,23,13,10,1
SBI08MFY6750705,94,35,34,1,1
SBI90WES7761733,78,32,17,15,1
SBI36XUG9245252,62,27,18,9,1
SBI44NQB0343140,67,19,18,1,1
SBI22CDE5451226,81,17,14,3,1
SBI61ZZM2450414,83,29,17,12,1
SBI68NKC4128677,92,17,14,3,1
SBI03JNH7550809,67,19,16,3,1
SBI71TYV7659160,80,20,18,2,1
SBI11FKH9736202,94,30,25,5,1
SBI54JEM0998274,24,15,13,2,1
SBI99EKP4478956,82,16,9,7,1
SBI03UQI5067392,72,24,15,9,1
SBI99DIW3362119,77,28,15,13,1
SBI16JFQ4042650,83,25,22,3,1
SBI02KGN0495394,89,30,18,12,1
SBI13UMF4449614,87,23,12,11,1
SBI15FZO7138770,87,20,16,4,1
SBI28OXN1088560,87,26,25,1,1
SBI20AVZ6874994,85,28,23,5,1
SBI91CIJ3009994,90,25,16,9,1
SBI66SNY6964323,61,23,14,9,1
SBI63TZG4603054,73,21,11,10,1
SBI74FCF6350905,62,25,23,2,1
SBI17VOW5584228,98,28,19,9,1
SBI04GMR3860391,79,19,15,4,1
SBI58GLJ5494003,78,24,14,10,1
SBI15JJM8806515,85,25,21,4,1
SBI76YHN2374625,20,32,18,14,1
SBI23HGI5224659,83,19,17,2,1
SBI78IXR7801316,62,28,24,4,1
SBI46XHR1363199,67,33,31,2,1
SBI77OZM6880163,72,27,21,6,1
SBI05JIT8318044,61,22,13,9,1
SBI96OMB7752223,73,20,18,2,1
SBI25YEP9514674,75,26,20,6,1
SBI14GIT7389556,97,21,15,6,1
SBI92GWE3171501,94,25,15,10,1
SBI34LDS4904344,24,21,11,10,1
SBI30SFS3058169,97,23,19,4,1
SBI64FJY4555788,66,23,17,6,1
SBI24KEU9149408,20,19,11,8,1
SBI32WFZ7263188,81,26,22,4,1
SBI58SEE2645963,76,26,14,12,1
SBI88TXO8762838,20,20,17,3,1
SBI08OHR6366327,98,24,20,4,1
SBI02FHA8249910,79,27,16,11,1
SBI34WHN6019652,68,23,22,1,1
SBI90VJD3522955,65,29,27,2,1
SBI58MBJ1866926,76,32,23,9,1
SBI50JKN6718569,24,25,20,5,1
SBI84SDN1408624,75,34,20,14,1
SBI53WAK9148055,64,25,14,11,1
SBI79PIL5689913,74,25,19,6,1
SBI56SHX0578522,63,26,22,4,1
SBI27FGN5650898,65,23,12,11,1
SBI55DMV3358298,67,25,17,8,1
SBI64UMM4369787,70,16,14,2,1
SBI54YOT4777059,82,23,15,8,1
SBI91LZR6731125,71,29,26,3,1
SBI67IUH1082155,21,20,16,4,1
SBI30DDE7891959,77,34,19,15,1
SBI00YFN0530083,96,28,27,1,1
SBI74XTP0129387,80,21,17,4,1
SBI34HMS8162868,70,26,23,3,1
SBI02TDE9399084,99,27,17,10,1
SBI19ZHF7664347,20,25,23,2,1
SBI23SUS3498927,21,23,19,4,1
SBI18MLA6912738,68,22,16,6,1
SBI05KPZ5834753,62,25,18,7,1
SBI86SUF3476554,84,25,19,6,1
SBI38CQK1754032,95,17,16,1,1
SBI43WDA6344697,78,16,15,1,1
SBI10TSV5220508,90,27,17,10,1
SBI02TVI0600052,20,22,21,1,1
SBI34NHK3964575,70,34,30,4,1
SBI73XRV7268065,90,25,18,7,1
SBI18VFX1259723,86,38,20,18,1
SBI56FCH6215827,21,25,18,7,1
SBI19WAP7595248,75,19,14,5,1
SBI85AOO7602059,25,21,17,4,1
SBI12SHX0605985,84,26,17,9,1
SBI08HZR3942209,76,23,12,11,1
SBI72JCS3895329,70,21,19,2,1
SBI80IAF8087003,60,21,14,7,1
SBI17PGS7362551,95,23,20,3,1
SBI21KEP3670713,69,29,15,14,1
SBI04UCF4618386,68,26,18,8,1
SBI28KVJ5998629,18,28,20,8,1
SBI07CMF5477560,25,35,29,6,1
SBI11AXK1504944,98,21,13,8,1
SBI69BKN3852925,22,19,15,4,1
SBI22YWN9755871,82,21,20,1,1
SBI66FPS1824866,76,27,15,12,1
SBI91AIA0449347,79,28,16,12,1
SBI91OVS4224632,23,19,17,2,1
SBI79DWF8146121,75,26,22,4,1
SBI25ZKT8412141,23,21,19,2,1
SBI21KWD0340922,87,24,18,6,1
SBI83OMB7376390,64,28,19,9,1
SBI65WTO6731898,91,34,32,2,1
SBI90MZF0876301,79,22,12,10,1
SBI95KZU7449326,68,23,21,2,1
SBI94GTU8418922,76,25,21,4,1
SBI26IYV2780160,67,23,15,8,1
SBI60RXL3250550,19,22,16,6,1
SBI93EPH5061924,79,23,22,1,1
SBI96HDA1276936,90,27,23,4,1
SBI84EDA1054243,72,24,22,2,1
SBI05XUM1520942,25,30,22,8,1
SBI64FQY2705444,96,26,17,9,1
SBI25DAA4472145,88,21,19,2,1
SBI09GQD1211472,85,20,19,1,1
SBI45LER0245659,75,27,14,13,1
SBI63HLQ8736605,21,22,15,7,1
SBI81OOJ7308746,85,24,21,3,1
SBI38OCW9955497,69,11,10,1,1
SBI26TLY8362619,81,25,23,2,1
SBI89UZB0293728,89,23,18,5,1
SBI38QDY6820035,79,29,21,8,1
SBI62HCR4002299,62,25,20,5,1
SBI46XML8049239,22,22,14,8,1
SBI72OVQ9180711,60,21,15,6,1
SBI00KOL1953787,71,23,21,2,1
SBI36GAT4780852,81,23,20,3,1
SBI59NAZ5672418,85,26,24,2,1
SBI96JMY6838246,83,23,13,10,1
SBI83RXR3242612,23,27,20,7,1
SBI08OVP2959083,73,28,22,6,1
SBI84HNZ1164298,24,25,23,2,1
SBI85VLX3990175,89,22,12,10,1
SBI68GER6536813,22,17,13,4,1
SBI96BNQ5181780,93,29,24,5,1
SBI79SRG4030864,82,29,19,10,1
SBI38OBG3790837,99,24,14,10,1
SBI80JMA0502919,23,32,24,8,1
SBI77JQI7444751,76,26,14,12,1
SBI32EGY9532164,61,28,24,4,1
SBI16LEA0707925,75,30,26,4,1
SBI27AGG9647536,72,27,23,4,1
SBI12QME3982065,73,30,24,6,1
SBI83ZBL5291097,77,25,19,6,1
SBI56HQB0172074,63,32,29,3,1
SBI30QSB4518727,98,27,16,11,1
SBI28ZMB4411712,85,23,16,7,1
SBI87BWS8555375,77,35,25,10,1
SBI87MEI8920358,25,13,7,6,1
SBI38CBT1368180,96,20,12,8,1
SBI91RQC2147651,99,28,27,1,1
SBI16KLA0308369,70,24,14,10,1
SBI58GGG2540262,87,21,11,10,1
SBI55CSI3051024,22,17,14,3,1
SBI40GTH1042896,87,16,12,4,1
SBI24EOO9713854,82,32,26,6,1
SBI07GHF3117893,88,15,14,1,1
SBI73YLT7842282,65,14,10,4,1
SBI92MHW0198346,94,20,12,8,1
SBI19ZKC6127355,70,35,18,17,1
SBI07SLK2812979,21,27,19,8,1
SBI23HSP2814159,22,24,13,11,1
SBI64FRA1760375,72,19,15,4,1
SBI16LDF0370261,85,29,27,2,1
SBI01JET5378852,62,29,23,6,1
SBI97PHC3427863,24,29,27,2,1
SBI68GRR6413667,69,25,21,4,1
SBI69BID7461137,82,26,17,9,1
SBI24INJ3422869,67,20,12,8,1
SBI82GQX9447030,67,23,17,6,1
SBI49MLF9019996,87,26,20,6,1
SBI69UWT7273905,73,20,18,2,1
SBI57FYU3098300,93,27,19,8,1
SBI85BOH0522976,97,28,15,13,1
SBI63RQJ8292796,73,35,23,12,1
SBI94QBQ5044989,62,22,12,10,1
SBI05IMI6059696,22,23,21,2,1
SBI36JCJ8105314,95,22,18,4,1
SBI88JOU9995587,93,31,20,11,1
SBI20RQP5464919,85,26,18,8,1
SBI65OXI4467817,24,15,14,1,1
SBI50LTQ2469491,62,26,24,2,1
SBI18OYL3431258,80,26,24,2,1
SBI16LUC5358374,95,22,14,8,1
SBI84FOR2378310,95,12,8,4,1
SBI27JHK3397163,65,22,15,7,1
SBI45BHF4759369,76,33,19,14,1
SBI74KDA4308451,98,23,12,11,1
SBI89SUY9477112,63,31,18,13,1
SBI62YOG9654838,68,31,26,5,1
SBI64XGQ8460279,19,31,28,3,1
SBI78OJN3289272,62,17,14,3,1
SBI96OSD8607790,69,24,22,2,1
SBI64DDC5764732,64,30,29,1,1
SBI07EWB7051488,99,24,20,4,1
SBI77UCN9313569,60,17,15,2,1
SBI86FNQ9685979,79,20,17,3,1
SBI96UCL4812102,98,26,21,5,1
SBI25YWN7013152,93,29,27,2,1
SBI10CIR5245485,70,26,20,6,1
SBI14HOQ5715071,90,23,16,7,1
SBI72NAX9269506,91,27,16,11,1
SBI30HLT2688679,99,29,22,7,1
SBI77NJH1076056,88,28,22,6,1
SBI37TST1317137,72,22,13,9,1
SBI38MJQ6397279,77,26,21,5,1
SBI46ROG2706029,64,24,17,7,1
SBI51TQV0042473,71,22,19,3,1
SBI90SHS1110004,60,20,18,2,1
SBI20UWJ7170754,96,37,27,10,1
SBI11RCI2551044,77,20,17,3,1
SBI45LXP0419888,98,29,16,13,1
SBI64ZII1908544,82,27,20,7,1
SBI54DKV6845536,78,17,15,2,1
SBI99SKH1728665,65,25,24,1,1
SBI76AQV7912867,94,27,23,4,1
SBI15CAK9609579,77,32,28,4,1
SBI22TUH4606211,22,22,18,4,1
SBI47IHZ2927654,81,23,13,10,1
SBI34VRZ2088802,80,18,15,3,1
SBI58GCK7282495,96,24,17,7,1
SBI35TWE9006821,84,25,21,4,1
SBI49BPB8764095,89,19,10,9,1
SBI28ZUW4960468,20,26,19,7,1
SBI80AZW2678904,23,27,23,4,1
SBI44FBQ1410005,68,20,17,3,1
SBI23UMN0826504,82,25,14,11,1
SBI74VOL0043755,77,12,9,3,1
SBI16CAP6135704,66,22,19,3,1
SBI06THF9782321,83,21,16,5,1
SBI92NCG1493243,90,32,31,1,1
SBI46QPX5996553,73,24,16,8,1
SBI88VFV5195103,80,38,25,13,1
SBI59XEO0009530,69,26,14,12,1
SBI47OBY6954561,91,26,18,8,1
SBI28FTD9386368,98,17,12,5,1
SBI43XMJ7897481,76,29,15,14,1
SBI32STP3332476,61,31,28,3,1
SBI92DNP0105988,69,22,17,5,1
SBI56YTN3253220,95,34,28,6,1
SBI66LZP6433805,75,29,28,1,1
SBI13FFI5607366,77,26,15,11,1
SBI07QJP4031269,18,32,23,9,1
SBI50QZM3084378,75,25,19,6,1
SBI90DTM1580985,62,19,16,3,1
SBI12NUE0507405,76,23,17,6,1
SBI99BSA8885350,94,25,21,4,1
SBI27ONE1167314,76,20,17,3,1
SBI41MJG2502621,20,30,23,7,1
SBI95QDL4191874,74,27,18,9,1
SBI91XKT4888469,89,24,22,2,1
SBI79WQH0264775,62,26,18,8,1
SBI12SFL1472312,63,24,21,3,1
SBI58KGS3770800,78,25,22,3,1
SBI98DPQ7470585,62,27,25,2,1
SBI71UEN8073174,82,19,15,4,1
SBI68FAW7719433,19,20,16,4,1
SBI56PPM4392710,74,16,15,1,1
SBI94JPU3121193,86,21,16,5,1
SBI68ZTC3575021,67,31,17,14,1
SBI08POP2084276,86,23,22,1,1
SBI42NLE4253015,66,33,29,4,1
SBI21CRZ8565262,91,27,23,4,1
SBI02GWM5526351,25,26,16,10,1
SBI19CKK7546980,91,19,18,1,1
SBI12HQR9847278,94,27,19,8,1
SBI87JRF0609158,91,22,18,4,1
SBI83KOU7212580,68,22,21,1,1
SBI95NLO7804011,79,27,26,1,1
SBI47WHG7397885,94,18,14,4,1
SBI73USU3142076,84,21,19,2,1
SBI79CQO3001396,93,25,19,6,1
SBI25YZN3718681,95,25,19,6,1
SBI75DSW0109840,20,31,25,6,1
SBI58BTF4514503,23,23,18,5,1
SBI93IUJ9122653,21,18,17,1,1
SBI52JAL3068526,77,17,13,4,1
SBI78PVN6598343,90,24,23,1,1
SBI62GED1977447,66,27,25,2,1
SBI82GMK9720289,95,18,12,6,1
SBI27FUO9833358,91,35,18,17,1
SBI92BHE3889855,66,26,24,2,1
SBI42KRS9651439,82,21,17,4,1
SBI17KAL5239158,89,24,22,2,1
SBI46VWD8400747,76,28,18,10,1
SBI03GLQ5081904,77,23,17,6,1
SBI40STF0339896,85,21,20,1,1
SBI20PYS1364138,73,36,20,16,1
SBI19OSP3871339,22,27,22,5,1
SBI01PZL2403628,87,22,21,1,1
SBI48NAF0558465,89,23,18,5,1
SBI08VHW1261342,18,20,17,3,1
SBI99ZSQ2546109,98,21,16,5,1
SBI97PWH7766960,24,20,19,1,1
SBI72UBU0757984,20,27,26,1,1
SBI53FJO9085557,19,17,15,2,1
SBI27PGU3656908,70,19,10,9,1
SBI90PXY0848788,62,22,18,4,1
SBI86ZRK2582124,19,30,19,11,1
SBI96BOV0315783,89,16,9,7,1
SBI76GKG3455950,79,16,12,4,1
SBI42PQT8172933,20,28,19,9,1
SBI85YLQ0056062,90,24,21,3,1
SBI21JDH9031621,92,28,19,9,1
SBI60LDO9580880,99,22,21,1,1
SBI28WZO2269990,83,23,16,7,1
SBI30DJT3194381,20,18,10,8,1
SBI42BOX0610697,65,24,18,6,1
SBI63MSG5923718,18,16,10,6,1
SBI36VXM4065891,83,34,25,9,1
SBI76RNA8554504,78,31,26,5,1
SBI32IUU7305033,89,19,13,6,1
SBI20IGH2686640,75,19,11,8,1
SBI08KLP2075004,79,24,16,8,1
SBI91AKC2280259,76,21,11,10,1
SBI94NJQ8062890,20,29,20,9,1
SBI95AII4600534,23,23,14,9,1
SBI79PLZ1498343,21,21,20,1,1
SBI10JRV6514802,83,21,14,7,1
SBI49HAC6597911,89,22,21,1,1
SBI99UTG0337561,66,23,12,11,1
SBI86BQA8310779,72,21,14,7,1
SBI35YDY7436859,18,19,12,7,1
SBI78BWB2465130,68,19,11,8,1
SBI85CIW3974467,76,17,16,1,1
SBI25IIB3310470,78,16,13,3,1
SBI33CYZ6432881,92,19,11,8,1
SBI63YAJ2087579,98,19,16,3,1
SBI98DRI0300918,91,25,24,1,1
SBI78MKX5454466,24,30,16,14,1
SBI11PGO0283018,82,33,27,6,1
SBI94ZQX3959167,20,10,6,4,1
SBI81EJC6829570,96,31,19,12,1
SBI87MJF2183572,89,10,7,3,1
SBI34OJL6507504,95,31,20,11,1
SBI46WGB0629117,22,31,20,11,1
SBI03DWY6050604,90,26,22,4,1
SBI14XVO9155453,81,23,12,11,1
SBI46WKR8714063,67,30,24,6,1
SBI30ATH7816652,62,26,14,12,1
SBI51GFM6568977,91,20,12,8,1
SBI98SAY3074228,18,18,11,7,1
SBI34ERX0933776,95,23,16,7,1
SBI65UNM3048972,71,29,27,2,1
SBI89NNK1318790,83,25,15,10,1
SBI75CWC8519475,20,23,21,2,1
SBI14JIT6091270,95,25,18,7,1
SBI57JWK4452994,80,24,17,7,1
SBI00QDJ4272991,73,32,20,12,1
SBI33ZJU9170616,22,19,10,9,1
SBI38GZY3736116,20,16,9,7,1
SBI30JRP6579472,76,23,14,9,1
SBI73EGS9139162,63,26,19,7,1
SBI78AZH2076422,67,26,23,3,1
SBI67EXF7044591,74,24,20,4,1
SBI15NYI6907948,93,18,13,5,1
SBI36HTJ8539903,81,38,35,3,1
SBI83ZRX2979411,20,21,12,9,1
SBI46RJB8620141,68,26,22,4,1
SBI49UDH3550416,85,27,22,5,1
SBI71VUB5822779,83,23,17,6,1
SBI10GOJ0907272,70,28,17,11,1
SBI32TVP6263123,24,22,15,7,1
SBI08LFT7076208,60,30,26,4,1
SBI51LKP4788781,84,28,21,7,1
SBI05WLD2450176,65,30,26,4,1
SBI58YOT4923975,95,33,17,16,1
SBI44MAU4071124,76,17,9,8,1
SBI84GDT9900620,95,29,22,7,1
SBI53GFS8881682,68,33,28,5,1
SBI81ZSK2728073,75,18,17,1,1
SBI80ELP6785619,63,29,20,9,1
SBI07ZGR7863459,76,22,14,8,1
SBI68OUE7178365,88,27,24,3,1
SBI04USU7838388,25,28,16,12,1
SBI88RNR0271209,64,23,21,2,1
SBI42UMJ9355960,93,27,16,11,1
SBI57ZCI5991436,79,25,14,11,1
SBI59JSY4949045,24,20,15,5,1
SBI40RMX1030051,20,29,15,14,1
SBI07OQS1570299,86,28,22,6,1
SBI80XOI2221203,79,21,12,9,1
SBI91EYA5500685,62,23,19,4,1
SBI37USZ2343724,22,18,10,8,1
SBI20ORK0231598,80,23,14,9,1
SBI67VYO9303904,60,29,21,8,1
SBI81GSX8645731,77,22,15,7,1
SBI23JAO2770641,95,26,21,5,1
SBI32JUT2152788,71,11,7,4,1
SBI90ISD2418177,94,36,30,6,1
SBI90MCI7105651,60,28,21,7,1
SBI69TAN7265425,82,26,17,9,1
SBI62EUT8591021,64,27,22,5,1
SBI21DNT3320320,23,23,22,1,1
SBI20EZD5630482,85,25,24,1,1
SBI04RUI2701931,83,22,20,2,1
SBI31EOV2385659,81,19,15,4,1
SBI79LJZ9577424,77,24,14,10,1
SBI37PMA2540550,79,26,20,6,1
SBI33QEK4926782,99,27,19,8,1
SBI95CCL7750130,91,18,14,4,1
SBI90DVI8215306,62,32,19,13,1
SBI06NOX4290506,21,25,16,9,1
SBI64CYS1055769,88,23,15,8,1
SBI95VOQ0982811,25,26,21,5,1
SBI35LAB4369826,92,26,24,2,1
SBI02EVX5683557,82,24,23,1,1
SBI74IAY8270621,63,23,17,6,1
SBI38BAO8776839,84,34,30,4,1
SBI00QSA7112464,77,19,17,2,1
SBI95KXV6517832,66,14,10,4,1
SBI43HOR5397875,83,28,19,9,1
SBI50ONP4316366,81,34,32,2,1
SBI86TVQ7131882,67,21,14,7,1
SBI05FIO4286110,70,25,22,3,1
SBI23QBE2514896,75,23,13,10,1
SBI58KFM3073076,63,34,19,15,1
SBI50BXU9122673,96,27,21,6,1
SBI21JJN7642287,87,23,19,4,1
SBI56SHZ5216982,70,32,31,1,1
SBI88VAY5366351,86,25,24,1,1
SBI50KKH6194018,83,27,26,1,1
SBI92SLI8430423,68,26,15,11,1
SBI34JJO2462520,89,21,17,4,1
SBI59QYM3250571,93,27,19,8,1
SBI45JCY0825742,75,24,14,10,1
SBI70CNQ4626359,77,28,20,8,1
SBI07QDC1725989,77,34,27,7,1
SBI40WNO7670802,23,24,23,1,1
SBI01BWN7507057,98,29,24,5,1
SBI47JKQ9935849,69,25,13,12,1
SBI01OOA4630485,98,29,19,10,1
SBI45BDA6747246,94,29,28,1,1
SBI47EJU8755840,77,23,13,10,1
SBI53JNO5717992,60,33,28,5,1
SBI85QVJ8838679,60,28,19,9,1
SBI52WUP9619294,80,18,17,1,1
SBI55GFY3630095,89,28,27,1,1
SBI91OKX1448161,25,34,20,14,1
SBI19YOH3998212,79,29,27,2,1
SBI87UVL6329795,87,21,13,8,1
SBI89AMY0529980,98,24,15,9,1
SBI73NOI1560554,70,29,24,5,1
SBI54VSG5481704,78,24,23,1,1
SBI86BER9321148,88,26,19,7,1
SBI77IDF2885574,75,27,23,4,1
SBI57VJB5725773,60,26,14,12,1
SBI37BPY9259255,62,21,20,1,1
SBI64DRG5968431,88,22,21,1,1
SBI92YPQ3375320,91,26,17,9,1
SBI99JQF7048818,64,19,11,8,1
SBI02RWJ9751317,20,20,12,8,1
SBI86PYK7594429,19,33,25,8,1
SBI18QRH4086900,63,18,17,1,1
SBI34WMQ1610676,89,20,13,7,1
SBI07MQM5063314,95,21,12,9,1
SBI12IPA4966421,68,30,23,7,1
SBI12JRV2261407,96,28,18,10,1
SBI59USY5287369,88,28,20,8,1
SBI47PYU5363318,82,25,14,11,1
SBI73DIE0723753,74,29,23,6,1
SBI70PGK9728686,68,23,12,11,1
SBI24ATY4662142,85,15,12,3,1
SBI64KYG9213666,65,26,22,4,1
SBI82OSK3936359,21,35,31,4,1
SBI47KJK0166941,98,38,31,7,1
SBI77TEE3225929,90,19,15,4,1
SBI00WIA4850273,25,20,14,6,1
SBI30EYU0497203,81,24,15,9,1
SBI06HUI0275827,82,25,23,2,1
SBI60NWZ3885748,85,17,16,1,1
SBI55RFL1325982,67,22,20,2,1
SBI06NWS6459870,23,26,16,10,1
SBI13FKE8846280,97,23,15,8,1
SBI26UTU9102284,25,25,14,11,1
SBI41HUK9228439,83,20,18,2,1
SBI36QCJ3094184,83,18,11,7,1
SBI91BQP2897639,71,25,24,1,1
SBI69JDM9279817,70,22,13,9,1
SBI19CII8290636,93,24,22,2,1
SBI11NDJ4658103,25,24,23,1,1
SBI22FPQ4181578,81,19,15,4,1
SBI45WOZ9307724,99,31,23,8,1
SBI86VNU2735981,22,28,23,5,1
SBI26MCW9408529,96,27,17,10,1
SBI56SBI7152892,72,24,17,7,1
SBI97OQY8177572,20,31,24,7,1
SBI31ARV2470781,78,22,19,3,1
SBI06OFD5156036,85,35,24,11,1
SBI46VTF8112745,74,17,15,2,1
SBI48YRO5843256,90,25,20,5,1
SBI07SVG0156981,75,24,20,4,1
SBI69LFB7292189,94,21,15,6,1
SBI87HKR7889391,73,22,18,4,1
SBI03GAF6444818,91,20,19,1,1
SBI81OZH7138682,62,28,24,4,1
SBI84ZCQ9745718,92,19,15,4,1
SBI83RQN4384933,68,26,23,3,1
SBI04MHU1163872,25,20,15,5,1
SBI09WKR8522106,85,18,14,4,1
SBI82PYE3331978,79,24,16,8,1
SBI59XTW9970132,73,23,21,2,1
SBI26KJQ4253449,61,27,26,1,1
SBI15QOJ5075005,98,24,18,6,1
SBI57DNL0990809,79,26,21,5,1
SBI26FMW0053809,19,23,17,6,1
SBI32DQI6653381,72,23,18,5,1
SBI39KYE4132527,93,26,24,2,1
SBI99QNZ0240215,25,29,19,10,1
SBI48FJJ9178512,85,29,22,7,1
SBI08LFG7225383,74,27,26,1,1
SBI64HMP8527460,88,23,20,3,1
SBI69DDR0464295,77,23,17,6,1
SBI85VJN5221274,98,17,14,3,1
SBI43ZLN6869600,78,28,16,12,1
SBI27DYF6275896,98,25,14,11,1
SBI16LAF4066113,76,26,16,10,1
SBI58HBL7115494,21,20,18,2,1
SBI58ZCT6932814,85,17,14,3,1
SBI73ORM5696719,84,23,20,3,1
SBI81GAU7792966,60,35,25,10,1
SBI59QNV1390789,80,22,14,8,1
SBI99OWA1521225,97,16,14,2,1
SBI20GJP4208620,80,28,18,10,1
SBI50LFD1088167,25,26,20,6,1
SBI93DGO2040934,77,18,15,3,1
SBI45XTL2398296,22,31,16,15,1
SBI53RTH7606309,79,19,10,9,1
SBI64PSD7881433,95,22,14,8,1
SBI99JPX8936556,72,23,18,5,1
SBI08KVF7941839,89,22,19,3,1
SBI61OMQ7855353,64,19,15,4,1
SBI79MWB2150025,82,18,15,3,1
SBI90CAE7736315,86,21,11,10,1
SBI12KCY4040596,18,18,13,5,1
SBI50PHH8885586,82,26,25,1,1
SBI73GDG1224675,98,25,15,10,1
SBI60JHY3037781,83,25,21,4,1
SBI26LTZ5221198,87,30,22,8,1
SBI72IIC5236599,70,34,28,6,1
SBI11YFI4867549,25,29,27,2,1
SBI81ZVN9292499,96,32,30,2,1
SBI64OOB5866157,72,23,14,9,1
SBI39JPV5152079,65,25,21,4,1
SBI10VPP7676229,63,22,16,6,1
SBI82GYZ1355012,77,29,23,6,1
SBI08DIH5674255,93,31,26,5,1
SBI47CPE9454790,72,29,24,5,1
SBI88RQU4131187,90,30,24,6,1
SBI25AKE3574771,60,19,18,1,1
SBI43OKH9131782,70,20,11,9,1
SBI54TGS7424167,79,17,16,1,1
SBI35RWF4543783,79,29,17,12,1
SBI84KMR8166665,79,13,9,4,1
SBI78ORA3861208,87,23,22,1,1
SBI13FMX6184545,93,24,20,4,1
SBI53SZE1251513,61,24,14,10,1
SBI91MSL5225752,88,25,20,5,1
SBI12GRY5385349,72,22,12,10,1
SBI62ZXL6710098,22,20,19,1,1
SBI89RWM3633394,22,26,21,5,1
SBI03BER6041524,68,22,21,1,1
SBI90PDV9563568,92,28,18,10,1
SBI85BAR5087434,92,23,21,2,1
SBI56XOJ0390074,74,29,23,6,1
SBI90RAS4101735,94,21,13,8,1
SBI55MTJ9657905,85,25,18,7,1
SBI18SUI9528957,98,32,27,5,1
SBI95WFZ4936410,68,20,17,3,1
SBI94IPP5502372,81,21,15,6,1
SBI30FOL9159674,19,26,17,9,1
SBI70PLC2589321,76,20,18,2,1
SBI62NMK4206362,91,28,23,5,1
SBI73CGI4499068,73,28,20,8,1
SBI06OUL5588463,66,21,13,8,1
SBI02APM2102505,19,26,18,8,1
SBI65QMQ3483894,65,23,14,9,1
SBI45ICL0760049,61,26,22,4,1
SBI12FGH8363537,92,17,15,2,1
SBI82JMN6930227,23,27,21,6,1
SBI53LBW9798752,90,24,23,1,1
SBI33KHT9607522,74,27,14,13,1
SBI47YSC2130450,96,21,13,8,1
SBI01SQQ7819439,86,24,20,4,1
SBI82GXU8556976,22,36,34,2,1
SBI68OAR2631082,21,23,15,8,1
SBI45NJD4538368,76,21,16,5,1
SBI54DYI1428360,68,30,21,9,1
SBI98FGH0586741,77,28,21,7,1
SBI52YCT9314528,65,22,16,6,1
SBI08IUP8478751,91,24,20,4,1
SBI17FOC3801526,96,24,18,6,1
SBI01CQQ2878254,20,33,17,16,1
SBI67IHV1716903,22,14,10,4,1
SBI00HVE2834022,92,30,16,14,1
SBI54EOK7288696,95,20,13,7,1
SBI21BDG5510829,95,28,16,12,1
SBI96FLJ1535140,70,23,12,11,1
SBI66BRO7420071,81,30,29,1,1
SBI23AYH6392530,88,20,19,1,1
SBI19MFZ9033735,70,21,19,2,1
SBI49GSD3041985,62,15,14,1,1
SBI64DHE6021940,89,22,16,6,1
SBI34TVD4893675,71,20,15,5,1
SBI91DHB5480674,19,19,11,8,1
SBI36LSO8381112,80,19,17,2,1
SBI82QTA7996222,84,19,12,7,1
SBI38JCD5879022,92,27,22,5,1
SBI89CWS8458449,61,18,15,3,1
SBI88NUF6622133,19,30,19,11,1
SBI97UOK7722743,87,24,21,3,1
SBI57XFN7487669,68,30,29,1,1
SBI46NYO4536150,24,19,17,2,1
SBI34NGK7728879,84,35,29,6,1
SBI67DYQ2654032,24,22,18,4,1
SBI95PKY2821174,95,24,19,5,1
SBI38MND5396821,18,29,22,7,1
SBI78JPY3884924,21,28,21,7,1
SBI78KKT4623777,90,35,28,7,1
SBI38BEI1642221,96,29,19,10,1
SBI82SQK3657605,64,31,22,9,1
SBI77MYH8253826,96,25,23,2,1
SBI90XEG4850974,67,27,24,3,1
SBI65HQC8537018,95,21,17,4,1
SBI06MMJ6417362,65,24,14,10,1
SBI03ZRS2525958,63,25,23,2,1
SBI50CTT6863438,76,25,13,12,1
SBI70IEU1446360,23,29,17,12,1
SBI28IAR5786365,19,29,25,4,1
SBI36UYJ5194198,88,20,16,4,1
SBI43GFY8063191,24,20,17,3,1
SBI91TYD8594525,76,31,29,2,1
SBI05KCU0370351,74,27,18,9,1
SBI49JFX2401872,73,21,17,4,1
SBI88ETX2386020,22,31,23,8,1
SBI60PAR8434854,86,13,11,2,1
SBI54ZAU1758022,20,18,11,7,1
SBI89XQT5355920,90,24,16,8,1
SBI39OFS9202508,92,21,12,9,1
SBI79QJQ1689761,87,26,25,1,1
SBI36SLV9804418,84,29,18,11,1
SBI57ZYY3378297,90,34,23,11,1
SBI49HGD2023211,18,30,23,7,1
SBI44OJB2582460,89,28,17,11,1
SBI32ZWL8272815,64,30,17,13,1
SBI83KWI7793340,20,31,22,9,1
SBI46KWS1931959,62,23,19,4,1
SBI94EFF1637899,21,25,16,9,1
SBI94VVC3780631,73,33,32,1,1
SBI43RJI8988390,73,31,27,4,1
SBI01ZDG2102419,79,32,23,9,1
SBI81MVW5339396,78,23,18,5,1
SBI76CZK0173254,87,35,20,15,1
SBI13QDT1325137,84,20,12,8,1
SBI23PQS8180607,93,23,21,2,1
SBI80OEO0915911,93,20,17,3,1
SBI36KER3730533,91,18,16,2,1
SBI21HTS7562062,98,25,16,9,1
SBI46WYV3782077,72,29,16,13,1
SBI65UXP0110326,84,25,24,1,1
SBI95QOG2406931,23,24,16,8,1
SBI09VII4796202,82,15,13,2,1
SBI37XPM5018500,68,14,10,4,1
SBI56OIP3987798,60,13,8,5,1
SBI05JZH0190195,70,27,17,10,1
SBI24BHT2015672,88,25,15,10,1
SBI46BNV4839106,70,33,21,12,1
SBI98QZM1335589,63,28,16,12,1
SBI16MCL9277295,92,26,24,2,1
SBI04IPT5693580,98,21,14,7,1
SBI01TWW9673307,24,26,19,7,1
SBI40DCQ8089160,62,26,18,8,1
SBI49ZZR4350024,94,24,19,5,1
SBI62WRU3054978,73,25,13,12,1
SBI39WLZ8820500,63,27,17,10,1
SBI59DBE7676684,62,26,15,11,1
SBI50OBW7352757,67,22,14,8,1
SBI64NDO2547498,73,29,17,12,1
SBI01DWH6411015,75,17,9,8,1
SBI66RZG2730399,71,28,26,2,1
SBI14MKS1673321,98,20,16,4,1
SBI28KNE3117261,97,23,16,7,1
SBI61MAT4131542,90,23,12,11,1
SBI05RHA8059990,22,25,19,6,1
SBI02DEW7535771,73,15,13,2,1
SBI01XSY4971765,19,16,13,3,1
SBI38JMK3911171,92,33,17,16,1
SBI81IEP3450080,81,21,15,6,1
SBI48IDF9027797,70,21,14,7,1
SBI54CHU6999247,94,24,15,9,1
SBI62ALQ3563215,99,23,16,7,1
SBI72GEZ4578288,75,26,22,4,1
SBI91ECJ7792680,72,26,24,2,1
SBI03DZI5966341,20,26,25,1,1
SBI49XVY5385740,78,24,23,1,1
SBI56THE2563571,80,25,16,9,1
SBI84XET9872605,22,30,24,6,1
SBI59DRU9681392,64,26,18,8,1
SBI10AUM0911719,82,18,11,7,1
SBI70CLF5235097,85,32,18,14,1
SBI75HIT6205518,24,16,11,5,1
SBI38FKI2264232,76,29,21,8,1
SBI56YRH5780091,93,26,15,11,1
SBI29WBB7185260,19,18,12,6,1
SBI24UFN7065005,97,28,23,5,1
SBI38TPK6128994,89,26,18,8,1
SBI76LRT7736071,75,28,27,1,1
SBI69MLW5777639,65,13,8,5,1
SBI34OUM8109730,97,25,13,12,1
SBI42UJT3642748,88,20,17,3,1
SBI80JLV5607418,72,25,17,8,1
SBI27EYO7713170,19,23,12,11,1
SBI49WKU0000424,91,25,13,12,1
SBI82OQK2957458,78,30,23,7,1
SBI56ILT5556615,76,25,21,4,1
SBI36ZFC5699163,19,24,18,6,1
SBI89SLW6664749,67,24,19,5,1
SBI12ZMQ4040640,71,26,17,9,1
SBI52WUC5591148,96,21,16,5,1
SBI34QGE0048223,95,26,25,1,1
SBI17VQT6699523,74,31,28,3,1
SBI85JZY9819417,25,36,33,3,1
SBI95XYK7282115,85,28,25,3,1
SBI32LMM4858299,99,27,19,8,1
SBI93USI9772961,24,23,16,7,1
SBI06SMC0674967,90,28,24,4,1
SBI01WMY6551521,63,32,23,9,1
SBI24EZI4400947,94,23,17,6,1
SBI12SPH8018908,82,27,24,3,1
SBI75XOW6559897,64,26,20,6,1
SBI96PUR3811149,81,19,12,7,1
SBI79ZKD1278287,20,32,31,1,1
SBI01HIO8767063,70,15,10,5,1
SBI85PWN9856834,91,29,20,9,1
SBI79RVB5877596,65,26,21,5,1
SBI54MCU3089522,70,22,15,7,1
SBI84ZUX0758971,95,18,11,7,1
SBI82RXN9591159,67,30,18,12,1
SBI39GQU0929470,60,25,13,12,1
SBI32FDE1607577,95,26,20,6,1
SBI83CBD5328966,87,22,13,9,1
SBI42NBQ0692006,78,27,15,12,1
SBI39DYZ2992036,63,18,12,6,1
SBI33XDJ9879917,69,26,25,1,1
SBI32GVJ9148076,80,19,16,3,1
SBI18INX1564522,63,19,10,9,1
SBI63UUU1023963,70,22,13,9,1
SBI84ELU2326950,78,31,19,12,1
SBI70HDL4384181,87,20,16,4,1
SBI49QAF7397016,81,25,14,11,1
SBI65QKC4834033,78,29,26,3,1
SBI40RNC3132264,96,31,20,11,1
SBI35FHM9084019,24,31,30,1,1
SBI73CVY3558934,95,23,15,8,1
SBI10NFQ7836761,93,9,7,2,1
SBI56NER8855591,73,29,27,2,1
SBI34NRK0364950,23,27,26,1,1
SBI23EGS6605084,63,20,15,5,1
SBI92UIF9542931,85,23,17,6,1
SBI06WUC1961142,94,27,25,2,1
SBI59QFC0524473,92,34,22,12,1
SBI08TRZ2397589,18,13,12,1,1
SBI46PXN1298038,94,27,15,12,1
SBI63EZR4531905,60,22,19,3,1
SBI57XPA0186915,75,20,17,3,1
SBI37ICR7429208,22,25,20,5,1
SBI25JMT3290045,22,29,23,6,1
SBI94QCJ7452890,87,24,22,2,1
SBI24QSG5574107,60,31,23,8,1
SBI64XPP0610423,24,26,19,7,1
SBI10FTV5973199,22,23,16,7,1
SBI69ZLK0704416,89,34,21,13,1
SBI96VZO6974977,71,27,23,4,1
SBI53UVC1962689,70,22,12,10,1
SBI47NTL6459723,94,24,21,3,1
SBI89WDT2474707,90,27,20,7,1
SBI39NNW1193451,85,17,13,4,1
SBI62JNW8850920,82,18,12,6,1
SBI70YGU3611559,67,29,24,5,1
SBI01GQE4028555,68,25,15,10,1
SBI03KGM6240168,80,20,18,2,1
SBI42AWK7160830,83,19,17,2,1
SBI17OZQ8582774,94,31,29,2,1
SBI46HLP6478410,83,32,23,9,1
SBI99UCY9770809,23,25,13,12,1
SBI54TEI4962885,95,29,26,3,1
SBI71PKC2792983,96,23,15,8,1
SBI22IKY8899855,63,28,15,13,1
SBI56RLN4507408,99,33,24,9,1
SBI69DKQ2157109,87,27,23,4,1
SBI29GZX0154868,69,20,16,4,1
SBI61IQI4587387,95,24,18,6,1
SBI90JJI6027978,60,25,16,9,1
SBI75JEE4960557,91,28,26,2,1
SBI82AGU5932173,80,25,17,8,1
SBI79OUQ0226471,98,24,14,10,1
SBI44FET8832647,72,24,23,1,1
SBI45UEE3843149,92,23,16,7,1
SBI97NQT0540465,83,28,15,13,1
SBI83FUS7304758,96,26,22,4,1
SBI18OOO8841144,74,30,23,7,1
SBI88PFT5202761,64,20,15,5,1
SBI08RJP7594105,73,22,17,5,1
SBI42JVS7162883,66,21,17,4,1
SBI98QVA9341248,65,19,12,7,1
SBI78WKK9814423,71,21,15,6,1
SBI83JTK8942334,68,18,11,7,1
SBI47NQF5654328,67,33,20,13,1
SBI15FFC9897732,89,29,23,6,1
SBI31BJW3688409,88,16,10,6,1
SBI83EKU9061498,60,25,18,7,1
SBI89FSI2011118,24,29,25,4,1
SBI89ECP6245137,23,19,11,8,1
SBI43YHU6056533,95,24,19,5,1
SBI80HDA8566366,86,28,26,2,1
SBI77EHH3778432,79,29,21,8,1
SBI37JYW9319148,83,29,28,1,1
SBI62VWW9083031,85,26,16,10,1
SBI54WNM9005258,62,24,22,2,1
SBI40SBP6320156,67,30,25,5,1
SBI36UGQ0809744,86,23,15,8,1
SBI28YUW6915273,83,25,22,3,1
SBI93ZOZ3321365,63,25,23,2,1
SBI54KFT9300337,62,29,28,1,1
SBI31YFJ8729706,20,17,11,6,1
SBI32RXI6804235,90,13,8,5,1
SBI02DNU3735494,65,34,20,14,1
SBI34THT8905732,81,17,14,3,1
SBI89WMC5091809,70,29,17,12,1
SBI32YBG1481774,66,24,13,11,1
SBI10FVE7396073,79,28,23,5,1
SBI69BYZ3524366,74,16,14,2,1
SBI36BBV2024561,91,24,16,8,1
SBI98AXC7467158,21,21,11,10,1
SBI99YLX3362721,87,21,13,8,1
SBI95ZNP4531581,68,22,19,3,1
SBI49HSN7859558,83,23,13,10,1
SBI23YGG5520909,25,23,20,3,1
SBI14YYF8802692,62,24,13,11,1
SBI73GGS3441371,63,29,21,8,1
SBI73QWV1176889,70,30,24,6,1
SBI43URM8600421,20,27,26,1,1
SBI44TAY3576111,19,22,13,9,1
SBI42VPH3588410,71,35,19,16,1
SBI65ODH5962116,89,20,16,4,1
SBI22UAO3558781,80,22,18,4,1
SBI24RDB6379347,81,24,14,10,1
SBI60NER8024227,65,25,14,11,1
SBI44MDV7103303,20,24,17,7,1
SBI49FVB8123080,23,29,24,5,1
SBI11ODN6137941,21,21,17,4,1
SBI79RPL8273944,24,38,20,18,1
SBI32FKO2260024,65,33,21,12,1
SBI56EYC3434278,61,19,10,9,1
SBI75MMO7156937,69,23,15,8,1
SBI66CFJ7200039,97,17,16,1,1
SBI57BAR1940781,86,25,15,10,1
SBI00XBE4655670,87,20,12,8,1
SBI71AXU7194778,79,23,12,11,1
SBI88EET7150167,20,8,5,3,1
SBI46HFP6601652,19,29,19,10,1
SBI66UTC0464132,62,28,26,2,1
SBI80UKL7210998,18,24,20,4,1
SBI99AKA1198511,88,23,16,7,1
SBI00HSX5248718,72,24,22,2,1
SBI12DAL3636373,74,25,21,4,1
SBI31EGQ0438665,79,27,19,8,1
SBI02IKJ8041363,78,25,24,1,1
SBI99CUE6735398,22,25,13,12,1
SBI91WPH0497093,88,18,15,3,1
SBI59WOJ2673135,78,32,30,2,1
SBI43FJY1983450,97,26,25,1,1
SBI56WRT2734967,99,25,13,12,1
SBI97TWH5956094,76,16,12,4,1
SBI16JTN0079005,79,19,12,7,1
SBI21TEQ3345750,71,31,28,3,1
SBI87WFC1787043,67,23,17,6,1
SBI31BMG8324436,72,25,15,10,1
SBI52MIC1778791,63,24,19,5,1
SBI62PHE3325235,76,21,11,10,1
SBI08MYV3314860,22,19,11,8,1
SBI82DOJ2399823,98,24,22,2,1
SBI86KKH8317381,71,24,18,6,1
SBI80LCG8624317,94,25,19,6,1
SBI57GJX6416572,74,18,16,2,1
SBI09FTM7332385,83,17,10,7,1
SBI82FOU2709820,96,26,21,5,1
SBI31BJN6686380,67,24,17,7,1
SBI34OXN2816481,22,25,19,6,1
SBI86NYB3300906,64,25,20,5,1
SBI76HXE8612135,91,29,17,12,1
SBI74EFV7452304,65,26,14,12,1
SBI62MYY0257907,86,31,28,3,1
SBI88JDE2532221,70,28,20,8,1
SBI60FLX6345043,64,28,16,12,1
SBI89TIQ5739456,64,30,21,9,1
SBI92UIJ8643085,20,27,21,6,1
SBI57MOI0840472,87,32,28,4,1
SBI82JNB2923083,74,24,22,2,1
SBI22SRH1235655,64,24,13,11,1
SBI94IQS4182699,66,28,24,4,1
SBI10XEX1059070,78,15,14,1,1
SBI70ZTW8271955,72,29,27,2,1
SBI54EYC7709971,77,25,15,10,1
SBI58NXL0000500,86,30,28,2,1
SBI16QPZ0580655,84,28,16,12,1
SBI98UZQ4798528,62,33,17,16,1
SBI88CTL7534118,94,18,13,5,1
SBI58QUV4119514,97,27,17,10,1
SBI83YGW4131982,21,33,25,8,1
SBI54KHD8319444,85,32,31,1,1
SBI33DRP8865664,93,24,15,9,1
SBI67DCP7131174,25,24,21,3,1
SBI59RWS2647290,80,26,21,5,1
SBI96CQI4343675,18,15,11,4,1
SBI01PCL3110919,85,21,19,2,1
SBI48JTV6058989,80,29,18,11,1
SBI55HQZ4730044,99,20,18,2,1
SBI58QXQ1593450,63,25,14,11,1
SBI38IZU0614752,68,22,20,2,1
SBI85CHY4914557,82,22,15,7,1
SBI74KGO6586369,65,33,28,5,1
SBI73CCF9168815,85,32,25,7,1
SBI19VAH1553058,84,30,24,6,1
SBI82SQH4730506,70,21,15,6,1
SBI95CWG4553335,90,19,16,3,1
SBI59GYB4452945,86,23,12,11,1
SBI65DGC6163539,80,20,14,6,1
SBI57NFT9195546,73,22,19,3,1
SBI98MPV5379415,89,22,12,10,1
SBI80IUP5806055,25,19,15,4,1
SBI98KEJ5859243,96,24,14,10,1
SBI01ATY7738594,82,24,18,6,1
SBI13TRQ3357373,80,21,12,9,1
SBI31QIO3322340,90,19,15,4,1
SBI05FXN2957100,24,22,20,2,1
SBI18JOW5942965,95,20,17,3,1
SBI26DBD9463403,92,22,20,2,1
SBI12IJG7601699,71,31,19,12,1
SBI01JNM1025615,81,27,26,1,1
SBI72PVQ8455914,92,22,13,9,1
SBI52QUF4583485,21,22,14,8,1
SBI54PZT0977806,98,20,18,2,1
SBI61HEN9706453,21,24,22,2,1
SBI14OBV6862387,70,20,19,1,1
SBI06EAM8782832,18,32,29,3,1
SBI20UJB8410553,94,23,22,1,1
SBI62EZQ6736720,20,15,13,2,1
SBI41CZN1897022,18,24,13,11,1
SBI53LNS0057827,82,22,19,3,1
SBI48YZG5493808,61,21,12,9,1
SBI94UME1958497,82,28,25,3,1
SBI07XOC7407233,60,23,18,5,1
SBI77DUI6128388,87,23,21,2,1
SBI33UGL3356489,92,26,17,9,1
SBI52PWG0309498,76,30,18,12,1
SBI12TYS7794137,76,31,20,11,1
SBI39XZO9943540,66,22,15,7,1
SBI33XZV8227601,67,19,15,4,1
SBI15WMV7402682,93,29,15,14,1
SBI41BXM9631662,80,21,17,4,1
SBI69ENR4167671,21,32,20,12,1
SBI84QLW8416279,65,20,14,6,1
SBI16CDJ6373745,96,30,26,4,1
SBI12TWQ0878761,86,25,14,11,1
SBI31UMR6365038,88,29,23,6,1
SBI91OQO3156458,61,19,10,9,1
SBI80VLP3208533,77,28,18,10,1
SBI79IUA7387202,98,29,23,6,1
SBI52COO1789855,91,16,10,6,1
SBI48HBG4662123,62,33,17,16,1
SBI56XTA4865928,84,30,21,9,1
SBI81TPP1894005,93,14,11,3,1
SBI23LLE1909749,92,28,27,1,1
SBI84APL4664271,82,25,22,3,1
SBI44KKB9630821,67,27,18,9,1
SBI88KIG2250372,20,19,12,7,1
SBI41GXF1045862,79,29,23,6,1
SBI73IUG2988828,60,26,16,10,1
SBI73RLK1494500,93,28,20,8,1
SBI01CCS4071792,76,14,8,6,1
SBI40UKL9850416,19,17,16,1,1
SBI38RLV8079018,91,12,9,3,1
SBI14RWH3470356,89,22,15,7,1
SBI49EEK0929688,86,25,19,6,1
SBI07RNI8176014,90,27,23,4,1
SBI22GTT5864337,84,31,21,10,1
SBI79FJL5564909,64,29,22,7,1
SBI02JTQ8073219,85,17,13,4,1
SBI15SVG6776906,21,22,19,3,1
SBI06XFN3030081,83,21,16,5,1
SBI25BUZ6029316,92,21,13,8,1
SBI07TUK6409985,86,29,16,13,1
SBI70TDE6849675,21,24,20,4,1
SBI97MCV5430621,86,27,14,13,1
SBI52RJB1946529,65,26,21,5,1
SBI53YFS2432632,87,23,13,10,1
SBI89JKN6582592,62,23,18,5,1
SBI27ZHP2250830,88,24,17,7,1
SBI48FLH0924789,20,17,13,4,1
SBI92FRC2817714,98,24,16,8,1
SBI42ETX4879273,70,22,13,9,1
SBI76XNV0954530,96,28,20,8,1
SBI41UNV3831605,21,15,12,3,1
SBI24CQO3140401,71,27,23,4,1
SBI58LHA4359171,74,23,20,3,1
SBI10ZHD3125333,83,15,10,5,1
SBI28FUD1601160,64,20,11,9,1
SBI77JGG6590480,91,29,21,8,1
SBI97TPJ7988413,91,22,20,2,1
SBI37LOV5915914,97,24,17,7,1
SBI77QDD9595948,75,29,19,10,1
SBI67AOE1350575,71,22,15,7,1
SBI04OSF2163797,92,27,17,10,1
SBI22QKN0590252,75,32,17,15,1
SBI50LSW0801786,18,14,13,1,1
SBI17LFH5760287,70,30,28,2,1
SBI11XDO3362809,74,9,8,1,1
SBI15YKA3785558,78,23,17,6,1
SBI70JVK2779266,68,21,20,1,1
SBI75BQG6626578,86,24,20,4,1
SBI18CHG7039697,65,22,12,10,1
SBI17LMG2966901,20,27,26,1,1
SBI28VUJ4521512,90,26,19,7,1
SBI94MPF8419235,90,28,24,4,1
SBI04BVX5683067,71,23,14,9,1
SBI66YSH0365377,18,22,19,3,1
SBI26QNZ0436052,90,25,14,11,1
SBI05WKH5117266,96,14,9,5,1
SBI66YBU5127336,81,26,23,3,1
SBI26WNP9846829,95,27,23,4,1
SBI78TLZ3285704,77,24,20,4,1
SBI53EWG1353374,93,19,11,8,1
SBI97QFF8017570,90,29,20,9,1
SBI75YAR1155712,70,17,15,2,1
SBI51RLU3249355,68,20,13,7,1
SBI60LEL1781989,84,21,14,7,1
SBI16XCW6422863,69,23,22,1,1
SBI96MJX7410981,96,18,13,5,1
SBI64UFU8263791,77,37,22,15,1
SBI90XZV5728400,99,24,23,1,1
SBI11YOP4486402,93,26,25,1,1
SBI08NJR7545566,94,25,19,6,1
SBI16OQY4179041,79,16,14,2,1
SBI48BVT2774714,76,18,11,7,1
SBI53RWI1380900,21,27,17,10,1
SBI12LGW0509534,97,25,14,11,1
SBI93WXG4124634,76,20,14,6,1
SBI66IKA9698031,61,29,23,6,1
SBI92UKV3638103,71,25,24,1,1
SBI19VZL4463875,21,29,25,4,1
SBI97SAO4207220,71,31,28,3,1
SBI18FMA2851125,67,13,9,4,1
SBI38TEW1775611,18,20,14,6,1
SBI01CLV4823860,68,23,13,10,1
SBI60VSG7088671,61,29,26,3,1
SBI51HCE3398645,81,30,20,10,1
SBI95FUU2521031,82,31,25,6,1
SBI11UHP8474366,74,24,17,7,1
SBI25MGE1726028,62,22,20,2,1
SBI86WUZ3955181,90,25,13,12,1
SBI92LXH7440048,95,26,16,10,1
SBI29AJN2620983,81,26,14,12,1
SBI73XNG8751682,24,28,24,4,1
SBI44TFD9816834,21,27,25,2,1
SBI93VJA1341113,79,29,25,4,1
SBI17XAX3958302,76,19,11,8,1
SBI09RJH1237250,95,28,21,7,1
SBI54XNW3470109,90,16,15,1,1
SBI19QMD4662203,90,24,13,11,1
SBI30KIQ8287938,99,18,15,3,1
SBI49WUK9567426,78,19,15,4,1
SBI34YOE5995801,20,25,19,6,1
SBI74DRE4927228,87,23,16,7,1
SBI30GYX4008512,90,29,19,10,1
SBI45PDG5318234,98,27,21,6,1
SBI23UHC6699291,67,34,21,13,1
SBI49HHH5104346,74,18,17,1,1
SBI87AUY7409457,19,27,26,1,1
SBI08HUG1959116,22,30,16,14,1
SBI77AJZ6343384,23,29,26,3,1
SBI95ZQE6268015,25,25,24,1,1
SBI92NLM5640012,94,19,11,8,1
SBI08PRV2916818,18,24,21,3,1
SBI52RFW0660175,91,35,33,2,1
SBI88EQY5624331,74,19,10,9,1
SBI17YKP9972692,68,31,25,6,1
SBI46QDI4542717,20,27,14,13,1
SBI71LBD6031928,86,33,28,5,1
SBI49EOL6921993,94,17,16,1,1
SBI34TME8339910,63,35,22,13,1
SBI18QIH0204474,20,22,21,1,1
SBI63XSK4734162,70,30,27,3,1
SBI92VOI8467635,81,22,14,8,1
SBI91MER4616010,22,19,12,7,1
SBI22GUO6121916,74,24,19,5,1
SBI41HLW4516656,61,23,19,4,1
SBI52SNG7331074,90,30,29,1,1
SBI16KUI0589861,19,23,12,11,1
SBI92VEW7886801,92,27,25,2,1
SBI21PCC2953481,71,25,16,9,1
SBI79ZHZ4410903,24,22,15,7,1
SBI75LCR6515600,92,22,14,8,1
SBI43KSC5380247,21,33,21,12,1
SBI25KNG0008350,69,29,15,14,1
SBI24AVE4439683,71,14,10,4,1
SBI49AWB1278205,61,24,18,6,1
SBI44IQM3763494,97,29,17,12,1
SBI21BAT1185764,87,25,19,6,1
SBI51IUT1862900,94,24,15,9,1
SBI61NCS7189518,66,30,17,13,1
SBI11OOX7694887,73,14,9,5,1
SBI35ADZ9722143,96,29,17,12,1
SBI36QEX3116893,81,25,16,9,1
SBI03UCS6602480,74,26,14,12,1
SBI41CXJ7281201,83,31,16,15,1
SBI09KWG6373934,69,23,20,3,1
SBI86PVV8743516,60,16,13,3,1
SBI87TIS4031306,85,29,18,11,1
SBI86OQW0439853,61,27,22,5,1
SBI04WCD3030265,76,15,8,7,1
SBI52NJV0063854,24,15,8,7,1
SBI27KJA9933618,72,18,13,5,1
SBI51QKA9585578,23,17,12,5,1
SBI90TWL0926514,87,27,18,9,1
SBI30VFD4907155,80,27,22,5,1
SBI98EUQ3938387,77,37,36,1,1
SBI43HFS8804316,24,16,14,2,1
SBI41YOO2977309,60,29,18,11,1
SBI19BXJ3291448,75,31,25,6,1
SBI94OZY6541473,62,25,16,9,1
SBI35BWS3073914,81,23,13,10,1
SBI25NAI2962140,67,21,17,4,1
SBI81RZR4814723,70,25,18,7,1
SBI55MYM6604225,99,26,15,11,1
SBI66DWB8125280,64,29,21,8,1
SBI14UXO6228124,19,24,20,4,1
SBI57XZC1743097,24,38,32,6,1
SBI96AYG7216664,77,28,27,1,1
SBI16FHW9832727,81,20,16,4,1
SBI51NZW0152577,71,26,22,4,1
SBI55DXA0345210,96,21,16,5,1
SBI71FKZ3143067,19,20,14,6,1
SBI44RCJ4721459,93,17,13,4,1
SBI54ETT7746843,88,19,14,5,1
SBI35TIP1584413,75,15,12,3,1
SBI98XTJ1728267,78,26,19,7,1
SBI29WIP5940173,89,25,24,1,1
SBI56HEG8099108,21,23,22,1,1
SBI09MXW0410128,74,28,18,10,1
SBI40XYX2060647,73,35,26,9,1
SBI67JAU5178434,96,17,16,1,1
SBI60HAO0520251,99,31,30,1,1
SBI93HDA1550869,61,22,13,9,1
SBI00RQC5139512,68,25,24,1,1
SBI78MIF6157580,91,15,12,3,1
SBI07KWH4692796,96,23,15,8,1
SBI74LII1432112,88,17,9,8,1
SBI68IDV0248374,88,26,18,8,1
SBI40LBB3368490,18,24,20,4,1
SBI58MGM7477642,70,20,11,9,1
SBI84YKE9240088,90,21,18,3,1
SBI56ICH7690647,91,23,16,7,1
SBI02JMS7384427,25,22,19,3,1
SBI12ICB8566553,85,31,24,7,1
SBI42OCX5874507,20,22,15,7,1
SBI74TWQ8783915,66,29,23,6,1
SBI03QLC4899608,88,25,23,2,1
SBI67CUX3277749,24,27,17,10,1
SBI70AVJ9295027,80,20,17,3,1
SBI73GFC2718202,79,27,20,7,1
SBI96ZPI3383201,19,32,19,13,1
SBI08WGI5742879,64,30,29,1,1
SBI83AKK5929208,94,21,17,4,1
SBI22UEK4244160,61,20,17,3,1
SBI01XDS6674025,89,34,22,12,1
SBI66JZD2067877,96,27,20,7,1
SBI13PWU2416690,89,33,19,14,1
SBI24RXY0297510,63,23,13,10,1
SBI25FUD7206780,23,18,11,7,1
SBI01QWX4239492,80,26,17,9,1
SBI48NQH7390247,95,29,20,9,1
SBI33ISM9793085,92,19,16,3,1
SBI71SOC2948475,81,19,11,8,1
SBI91ZRJ6204963,73,25,13,12,1
SBI75XYN5247858,97,27,17,10,1
SBI32KKK8204383,63,25,23,2,1
SBI10PMI9108837,19,22,12,10,1
SBI96ZFN8674381,60,23,19,4,1
SBI73LWF1332978,25,31,18,13,1
SBI49FOI9297139,92,28,22,6,1
SBI02GJJ0158652,20,29,23,6,1
SBI48QEQ1534398,84,27,21,6,1
SBI06JNS7793344,98,23,21,2,1
SBI59MIS3456335,68,25,13,12,1
SBI94EOO5272434,97,26,22,4,1
SBI07GMP6452234,21,26,14,12,1
SBI00YUK7561268,79,25,14,11,1
SBI27KID0502555,77,15,13,2,1
SBI58XOK2001812,82,22,16,6,1
SBI87FLD3958509,96,26,20,6,1
SBI93HAC9712263,21,19,18,1,1
SBI65ZHC8761653,82,21,14,7,1
SBI14RCS1840708,18,25,13,12,1
SBI40UFN9437789,21,29,17,12,1
SBI19XOQ3168512,95,29,27,2,1
SBI39MIE4631057,92,25,15,10,1
SBI67JFC8912217,63,21,16,5,1
SBI70SGF3550801,99,22,20,2,1
SBI42BAZ2439210,88,25,23,2,1
SBI07EWK8694011,23,35,24,11,1
SBI89ZLG1840463,69,27,16,11,1
SBI11IYC9036299,72,27,15,12,1
SBI03CMB9984281,98,33,30,3,1
SBI60QGR5585273,66,19,15,4,1
SBI19JHH8394243,96,30,21,9,1
SBI23PYY6650596,75,22,15,7,1
SBI43TWY2275241,97,17,14,3,1
SBI33XUB1097117,86,32,28,4,1
SBI97TZB2968720,70,24,22,2,1
SBI79GAP2435837,98,17,15,2,1
SBI78XPU2726426,82,24,19,5,1
SBI83TSF3221284,95,27,26,1,1
SBI14ZCL6202320,20,27,20,7,1
SBI92MNQ9444794,98,22,20,2,1
SBI73RWS4848388,88,31,30,1,1
SBI87NGW9256207,22,14,11,3,1
SBI82CSS0079067,87,23,18,5,1
SBI28HMQ9569607,66,26,24,2,1
SBI81UFZ0059903,97,31,30,1,1
SBI41MPW1192484,88,28,20,8,1
SBI47YQK9094291,83,35,30,5,1
SBI20NBR6535386,79,28,16,12,1
SBI34GKJ1446046,97,28,27,1,1
SBI57YMS7120684,73,32,25,7,1
SBI11EOG2318243,22,27,17,10,1
SBI19CKU2754821,99,29,21,8,1
SBI48PTV2382464,61,30,18,12,1
SBI14QLB5527730,67,19,16,3,1
SBI12PPZ3879883,18,27,24,3,1
SBI14BOU5142928,70,32,26,6,1
SBI20TUO3088018,19,28,17,11,1
SBI94SAX9937135,80,18,10,8,1
SBI96MQS4622712,80,19,15,4,1
SBI14SGD9785074,88,20,14,6,1
SBI10RRY0862303,86,31,24,7,1
SBI90ZJO2772757,70,16,10,6,1
SBI71ESV8389237,76,27,25,2,1
SBI43TKK3511367,60,20,11,9,1
SBI52TQX8371166,69,23,19,4,1
SBI96RLS2918019,73,19,10,9,1
SBI00VQS1208389,96,25,14,11,1
SBI49MOZ4370145,79,32,29,3,1
SBI90PKE2713901,22,23,15,8,1
SBI70ENG2143730,62,26,15,11,1
SBI63HCL3619112,78,27,25,2,1
SBI37FZK1348615,68,25,19,6,1
SBI38CXQ2744219,73,22,13,9,1
SBI48JVK3589160,63,22,19,3,1
SBI04PTA5299293,91,34,27,7,1
SBI44FJD2863926,25,26,17,9,1
SBI07HTO3821406,71,28,15,13,1
SBI69BOS0207111,83,29,18,11,1
SBI51JEP4431888,66,32,26,6,1
SBI71UZP5836081,80,20,15,5,1
SBI33UXT5237788,85,32,19,13,1
SBI77GLR5772395,25,36,20,16,1
SBI09YOE0279112,96,23,13,10,1
SBI26AJC3068576,96,26,14,12,1
SBI65YAP1454892,97,22,19,3,1
SBI48ZHW0410364,88,29,23,6,1
SBI01CGD6004745,76,29,28,1,1
SBI88GIM6641571,74,24,17,7,1
SBI22SDY3035953,77,17,13,4,1
SBI78IXJ6823390,80,32,22,10,1
SBI90PWX8100249,69,27,26,1,1
SBI35CQT4142751,19,15,14,1,1
SBI67VSQ2735680,67,24,16,8,1
SBI60GHW4159112,74,27,21,6,1
SBI14YQQ9384026,19,29,17,12,1
SBI19BYN2637229,62,23,21,2,1
SBI42MIN5230749,84,20,18,2,1
SBI80KQM5439201,93,32,26,6,1
SBI31FRF3449301,75,23,13,10,1
SBI63DED4723138,74,27,15,12,1
SBI34EJB4592452,89,26,14,12,1
SBI22UGZ1826504,74,22,13,9,1
SBI83HTN9791115,87,27,26,1,1
SBI94APB0354366,85,34,29,5,1
SBI90KVM1116781,75,24,17,7,1
SBI39BVY2055909,21,22,19,3,1
SBI96WCX8436269,95,27,22,5,1
SBI16QUD9319818,99,23,21,2,1
SBI41HEY9598286,18,21,20,1,1
SBI92PZI5911023,91,11,10,1,1
SBI47LQS3417664,98,25,15,10,1
SBI24HGM2450693,22,28,18,10,1
SBI48CRF3761487,21,20,14,6,1
SBI61ARH0037984,73,23,15,8,1
SBI71ADQ6884988,22,29,23,6,1
SBI06DMY9887866,93,20,12,8,1
SBI65UZW3714170,85,19,17,2,1
SBI16ADN1811937,87,16,10,6,1
SBI57TEK2438150,65,23,13,10,1
SBI41MHR2140644,82,27,26,1,1
SBI78ZEP5243900,87,25,24,1,1
SBI37TVK9597384,87,22,17,5,1
SBI06CGF0224641,60,26,16,10,1
SBI02VFE3929089,62,26,22,4,1
SBI33NCJ6047169,80,32,19,13,1
SBI91QQZ7738409,94,18,12,6,1
SBI48IXH7584436,75,15,8,7,1
SBI98WHU8233814,86,32,22,10,1
SBI76ZOR3139300,92,27,21,6,1
SBI04JLX6470589,60,27,19,8,1
SBI75TER3253482,22,24,16,8,1
SBI78VEG8211803,63,25,13,12,1
SBI63FIJ1029494,60,15,9,6,1
SBI56SKX6065536,82,27,18,9,1
SBI17JXG3964823,76,18,15,3,1
SBI17ISP7187082,18,21,15,6,1
SBI09PTH4459432,93,28,15,13,1
SBI17DMB0314975,99,21,17,4,1
SBI55NVG5499410,67,25,24,1,1
SBI24HSV4491516,74,28,17,11,1
SBI99PVS5323987,98,21,19,2,1
SBI55HZY8040795,21,23,14,9,1
SBI37YEU1876108,72,37,23,14,1
SBI74OGW3419434,65,27,16,11,1
SBI24PNH1605960,99,24,21,3,1
SBI81VXK3183975,68,24,23,1,1
SBI35QGW7855267,22,21,14,7,1
SBI37XDW3115952,73,28,16,12,1
SBI69XAV9251159,71,25,24,1,1
SBI86RRV0915912,73,32,20,12,1
SBI58GTW6002183,62,13,7,6,1
SBI34HSJ8346870,93,24,18,6,1
SBI21IIN5006641,98,28,21,7,1
SBI36BRY5696778,84,30,26,4,1
SBI22ADQ2986891,66,38,29,9,1
SBI88XKL9984205,63,27,26,1,1
SBI04LCB8368642,65,29,22,7,1
SBI23DNM9726927,82,20,15,5,1
SBI67TNT0406550,22,16,12,4,1
SBI79YXH7055903,68,16,14,2,1
SBI09TZI4869317,80,30,28,2,1
SBI84WDW4774286,65,22,17,5,1
SBI77MMY7865583,76,25,13,12,1
SBI99FYH1043309,67,27,22,5,1
SBI48RFW4819379,20,28,15,13,1
SBI78TIW4369479,80,24,16,8,1
SBI97OXD7836298,67,29,23,6,1
SBI78QMP3730237,74,23,22,1,1
SBI29HXM9847434,18,27,20,7,1
SBI03SIK4545096,67,30,18,12,1
SBI19KKA1899101,83,27,14,13,1
SBI50STE5851545,78,27,26,1,1
SBI80CHM2507196,66,23,19,4,1
SBI80SGD1884143,19,25,21,4,1
SBI78JZT4000653,24,22,19,3,1
SBI28HOZ8407556,71,21,12,9,1
SBI20ZNP6462131,22,21,15,6,1
SBI67TNB0872308,67,23,18,5,1
SBI44WYT8751679,82,21,18,3,1
SBI04KOG1007178,79,23,13,10,1
SBI45YDD2261854,75,23,15,8,1
SBI11UWM3777360,88,19,18,1,1
SBI84GCW4420506,74,19,17,2,1
SBI57VVE9300120,75,24,15,9,1
SBI61GAI5652248,87,25,21,4,1
SBI70HCL4104407,86,19,11,8,1
SBI38WKF5915836,71,26,19,7,1
SBI85PBV3943516,67,25,23,2,1
SBI35OEY3832039,98,33,26,7,1
SBI75QTN9793461,97,35,20,15,1
SBI87QXJ0680636,97,30,21,9,1
SBI31DJL5639880,95,26,18,8,1
SBI04OHG4450283,94,30,28,2,1
SBI05DSX3258248,82,22,20,2,1
SBI99NOZ7658568,85,29,16,13,1
SBI05TJK6858551,85,23,17,6,1
SBI55YRS9377253,82,26,24,2,1
SBI70MHP8840799,92,20,17,3,1
SBI91WTH5340063,75,21,12,9,1
SBI38WSA6986488,23,23,13,10,1
SBI93ORZ6534708,64,27,24,3,1
SBI68OXF2140901,83,20,14,6,1
SBI12NVE6851189,99,31,17,14,1
SBI68XAT2997328,71,33,23,10,1
SBI46AZL6541152,67,26,21,5,1
SBI20HMT0105080,77,26,19,7,1
SBI87GQT7311291,66,20,17,3,1
SBI74HKJ8752179,96,26,24,2,1
SBI12XOI3544037,99,25,15,10,1
SBI72HTF7269685,94,22,21,1,1
SBI96QWT5407989,20,27,25,2,1
SBI83UYU5347543,61,23,18,5,1
SBI94SOB7214992,66,33,23,10,1
SBI16TWF6945409,94,28,22,6,1
SBI42ZZG4899040,84,28,19,9,1
SBI01PRO8270230,82,31,27,4,1
SBI92UBA3428492,76,23,19,4,1
SBI74VVD9622315,82,23,15,8,1
SBI11LOF2468803,96,24,23,1,1
SBI94VKS4603334,77,19,11,8,1
SBI90VDL8486847,96,23,14,9,1
SBI01ZUJ7620656,76,26,21,5,1
SBI44PAX6037593,60,28,20,8,1
SBI63UZT7267180,68,25,23,2,1
SBI38DEV4568728,70,34,18,16,1
SBI40VOB8469496,98,21,11,10,1
SBI36HOO9133368,78,22,19,3,1
SBI01KTI1616861,80,31,26,5,1
SBI59NRQ8565546,85,28,18,10,1
SBI02IRJ9879088,89,20,19,1,1
SBI98ISG0925808,88,22,14,8,1
SBI20HNR4621860,74,32,21,11,1
SBI13WKX0806919,82,17,9,8,1
SBI71YUB2514064,20,23,22,1,1
SBI83RXI4030563,91,36,30,6,1
SBI12XIH4481430,85,35,28,7,1
SBI52LFT2422597,98,27,16,11,1
SBI27QUQ0752675,63,24,19,5,1
SBI89UYF8094649,23,25,22,3,1
SBI15YPA8941295,23,24,19,5,1
SBI99ZZV7399618,19,18,17,1,1
SBI26NLH6825528,66,22,13,9,1
SBI32MRS5698076,60,27,25,2,1
SBI39OGQ7301010,86,37,36,1,1
SBI76YVU3215322,94,20,15,5,1
SBI64WFE7692213,98,19,14,5,1
SBI49LWH7232179,74,20,18,2,1
SBI48FCU8000919,21,25,19,6,1
SBI64SAZ7283194,83,22,14,8,1
SBI96IWO4125494,88,24,22,2,1
SBI70IDK9847343,69,27,14,13,1
SBI87OJS5396302,65,25,20,5,1
SBI27CPP7102040,99,20,17,3,1
SBI53TAN8191854,91,15,8,7,1
SBI89JYU1984046,89,24,21,3,1
SBI33BXI4895037,95,23,22,1,1
SBI73MVD2523856,78,24,15,9,1
SBI41FDQ6726484,91,27,15,12,1
SBI41EMK2525276,73,18,12,6,1
SBI51LDA5563947,74,28,20,8,1
SBI67XKM6477469,61,25,22,3,1
SBI70KSF5769775,20,23,21,2,1
SBI74UMX9041401,91,27,18,9,1
SBI45PIE5215303,96,22,17,5,1
SBI07MYH6465117,79,33,18,15,1
SBI70QMV8634412,86,20,12,8,1
SBI58FBB9281321,88,23,16,7,1
SBI29WSI1713199,87,25,19,6,1
SBI79KNC3551887,80,25,17,8,1
SBI72DYR2438838,23,25,18,7,1
SBI05YPZ4558595,67,21,11,10,1
SBI09GME6270206,79,26,23,3,1
SBI03SKH1161600,62,27,23,4,1
SBI85OMR9093939,96,15,8,7,1
SBI35OZI2546826,19,25,24,1,1
SBI73VAI5274228,61,23,16,7,1
SBI47JZA6615865,94,14,13,1,1
SBI26TFX7616910,89,23,15,8,1
SBI03LGW8411314,61,25,24,1,1
SBI32IGH1805175,75,22,21,1,1
SBI47PIS7683080,64,21,17,4,1
SBI52QNY7601936,83,20,11,9,1
SBI15BZW8992524,20,33,25,8,1
SBI83SKO1462067,71,27,23,4,1
SBI93EUP4906349,95,34,19,15,1
SBI42LIR2830219,21,33,18,15,1
SBI77MZL4133319,93,29,24,5,1
SBI77KKB8075917,92,11,8,3,1
SBI36OGL0959352,92,20,18,2,1
SBI14TLY3289048,73,30,28,2,1
SBI02HWV0334767,97,25,15,10,1
SBI50HJL8407403,68,32,21,11,1
SBI25QMB6609640,21,22,17,5,1
SBI70DXI9610342,93,25,15,10,1
SBI21ZIC4729546,64,34,22,12,1
SBI99FFK0961527,25,21,20,1,1
SBI28QWA4782856,25,20,11,9,1
SBI51UOY0092897,63,25,18,7,1
SBI28QUV8505605,24,17,16,1,1
SBI33JRF3498018,84,23,16,7,1
SBI90BKH9075171,97,21,12,9,1
SBI02BYO4811070,20,28,26,2,1
SBI56IUS0635528,64,19,16,3,1
SBI70PDG1679523,93,27,15,12,1
SBI35BOF9651293,78,20,14,6,1
SBI99ZFJ1014945,99,20,13,7,1
SBI01NIB1417310,67,21,13,8,1
SBI94ATO3812655,88,29,26,3,1
SBI62ZGW7493028,88,20,12,8,1
SBI45YEU5928235,97,26,21,5,1
SBI52BVS2762896,76,32,18,14,1
SBI96CCP8955764,22,26,21,5,1
SBI23WJA1351831,18,17,12,5,1
SBI53FUY9165757,63,21,12,9,1
SBI00DVC9325165,89,22,19,3,1
SBI93SBO2374303,19,24,19,5,1
SBI99SWP6460511,79,20,15,5,1
SBI18CJK1621963,22,26,19,7,1
SBI90RSZ5369080,80,24,22,2,1
SBI41JLF9499807,68,26,20,6,1
SBI81QKN6765044,75,23,20,3,1
SBI08YTQ7605999,99,18,17,1,1
SBI24QJU5331814,20,29,23,6,1
SBI01WNI5886037,82,28,20,8,1
SBI90HGP9730471,68,18,17,1,1
SBI32UCB7525242,93,20,19,1,1
SBI28OWA7660823,93,28,24,4,1
SBI69DYY8923006,79,27,24,3,1
SBI64YLK3683580,90,28,25,3,1
SBI60OYC6272046,67,24,16,8,1
SBI88YTK2212911,61,34,19,15,1
SBI94ONY1685985,94,38,37,1,1
SBI71OIS0195659,77,22,12,10,1
SBI84PBR7166782,87,15,13,2,1
SBI20EBR7112110,68,15,10,5,1
SBI62ZMB6604916,73,23,13,10,1
SBI41IBG7152736,91,19,18,1,1
SBI81OVP9924678,80,27,17,10,1
SBI29XUK7033921,85,15,9,6,1
SBI54AZW8799677,70,24,23,1,1
SBI52YYV2689545,74,34,27,7,1
SBI03KHR8583554,73,30,17,13,1
SBI19GHK7888315,95,26,16,10,1
SBI73ROH1084172,75,20,11,9,1
SBI29RPR5001591,78,27,18,9,1
SBI87OTN4781180,83,23,12,11,1
SBI88RJY0034382,97,27,14,13,1
SBI89ZVD6641265,72,22,20,2,1
SBI06WLF5226945,63,24,23,1,1
SBI99RKS6722958,66,20,15,5,1
SBI74CXX1610159,98,30,19,11,1
SBI57HEZ6608786,86,25,24,1,1
SBI71TTU2146856,85,15,14,1,1
SBI20GCZ4693254,95,25,22,3,1
SBI34WUZ8095510,97,22,12,10,1
SBI55ESN1418760,80,13,7,6,1
SBI73LVR4608693,65,23,22,1,1
SBI01QOD1691979,86,25,21,4,1
SBI28PPJ8649763,80,18,10,8,1
SBI41XYK7268613,67,23,16,7,1
SBI90JNB4917843,66,27,25,2,1
SBI67DBB4757820,23,33,22,11,1
SBI23SQE7171195,91,21,15,6,1
SBI39MIH4846054,22,18,15,3,1
SBI13SQB8613307,75,18,13,5,1
SBI11GKH2770630,85,18,10,8,1
SBI23YXJ2742006,61,23,18,5,1
SBI50JPW6311002,87,27,16,11,1
SBI94GXF7276489,90,32,22,10,1
SBI26SMX3955855,25,32,19,13,1
SBI30CJE6117993,69,21,13,8,1
SBI01CHR2174752,66,26,23,3,1
SBI87VCJ0161590,74,22,12,10,1
SBI01SNH0748383,77,27,22,5,1
SBI00THH4781751,66,17,12,5,1
SBI86ZIP4893880,81,23,19,4,1
SBI73OJW9412048,94,27,20,7,1
SBI55EJH0453624,65,22,12,10,1
SBI04TFL1995528,25,27,15,12,1
SBI30RVN9471670,24,32,19,13,1
SBI47UFB5791223,63,26,17,9,1
SBI31EZE4841887,68,23,18,5,1
SBI82AQG9753569,67,15,8,7,1
SBI74WHR8944987,18,24,18,6,1
SBI01HAW4698519,63,15,10,5,1
SBI63MZZ5287957,83,25,20,5,1
SBI46SFC8931393,22,27,17,10,1
SBI93ESI9173365,64,28,18,10,1
SBI51WSO4012137,75,29,22,7,1
SBI80IMT5265010,69,22,13,9,1
SBI43PYC7076507,24,24,15,9,1
SBI34XHZ0714413,67,25,16,9,1
SBI70XUC6138650,63,23,14,9,1
SBI44AFE1712100,65,21,20,1,1
SBI89YDT4943531,22,17,12,5,1
SBI80WVI1134580,78,25,21,4,1
SBI42ZJD4444508,86,23,22,1,1
SBI97HRK9814338,23,25,15,10,1
SBI24ZAN8394108,76,24,21,3,1
SBI57UZA1932153,76,25,16,9,1
SBI02YOP1555027,23,29,19,10,1
SBI01NHA6503323,81,29,20,9,1
SBI23KYB4196009,22,31,22,9,1
SBI97EOY8222511,86,23,21,2,1
SBI54ZGO6342146,76,25,21,4,1
SBI84MVQ4277010,71,26,20,6,1
SBI36LQY5154802,75,18,15,3,1
SBI21XVS5952497,82,22,21,1,1
SBI05RWZ8286532,71,23,18,5,1
SBI42KNC0954183,63,27,24,3,1
SBI00MSM3614338,79,22,12,10,1
SBI69WPQ6408211,84,19,10,9,1
SBI46HMU8112860,86,22,14,8,1
SBI16QSL8495291,70,24,15,9,1
SBI97WEX4344125,91,31,27,4,1
SBI43LVX4723618,23,24,16,8,1
SBI32ZSS2983741,25,25,22,3,1
SBI78QNK2969012,68,22,20,2,1
SBI76UOQ4170807,21,22,17,5,1
SBI34UGK8257099,86,26,14,12,1
SBI92APM9418089,24,20,15,5,1
SBI83WLK3719574,70,19,10,9,1
SBI94IPP0671551,87,24,21,3,1
SBI82IDY4770717,73,24,18,6,1
SBI17GDW3733911,96,21,19,2,1
SBI16KVK2735361,69,19,13,6,1
SBI85TFQ9099999,25,27,16,11,1
SBI81LCZ8301463,23,25,17,8,1
SBI20FFY1445335,77,20,16,4,1
SBI49HBV1057628,72,29,17,12,1
SBI62FCN9097840,78,23,21,2,1
SBI42NVR7945626,67,14,11,3,1
SBI53TTK7471884,97,28,16,12,1
SBI49FSP6159456,99,28,27,1,1
SBI01FPE8303103,81,23,13,10,1
SBI41SGW0390030,64,15,11,4,1
SBI21UNH6798459,81,23,16,7,1
SBI86XYG2154272,65,26,18,8,1
SBI92RWJ3099719,84,31,16,15,1
SBI13PUE6588509,98,25,18,7,1
SBI41RYP3648547,88,38,37,1,1
SBI17REA1067025,24,28,22,6,1
SBI51ADP0125267,21,27,16,11,1
SBI06IQN0249384,73,30,27,3,1
SBI04HDR4020003,25,32,29,3,1
SBI10TXK2202091,95,19,18,1,1
SBI58ACR1647548,81,22,15,7,1
SBI64HPI0150200,23,31,29,2,1
SBI07ZOE1437488,88,27,16,11,1
SBI13IMT3131281,68,28,23,5,1
SBI82BXN5795195,24,29,20,9,1
SBI83EQH4270425,94,27,21,6,1
SBI97ZMX2422109,66,25,23,2,1
SBI83CAQ7760047,87,28,15,13,1
SBI20ZBF4539272,87,32,31,1,1
SBI40NHO9546220,19,24,21,3,1
SBI37XMQ4740392,91,20,17,3,1
SBI75OBW8409687,85,25,19,6,1
SBI77FRA8868213,86,26,20,6,1
SBI13HJD4229474,96,29,25,4,1
SBI27VIP9638507,97,29,16,13,1
SBI82XMI9430535,21,29,19,10,1
SBI45KSS6312936,97,19,17,2,1
SBI74MSA9563648,22,29,19,10,1
SBI35FBZ9135784,71,20,19,1,1
SBI28XPI4240555,75,35,34,1,1
SBI69ZXS1272440,19,26,21,5,1
SBI70NHZ0207977,19,33,25,8,1
SBI09IMX1406639,60,24,20,4,1
SBI04ILZ0570430,69,21,20,1,1
SBI05ZOY7708987,64,24,17,7,1
SBI73IKO2698069,66,29,22,7,1
SBI48EOU9870957,60,26,24,2,1
SBI41XJM4408268,19,26,24,2,1
SBI68XKV4549847,60,25,13,12,1
SBI67PBW2530941,94,28,21,7,1
SBI66JFX5070330,60,20,19,1,1
SBI82ITD8597818,82,30,27,3,1
SBI99PPY2886739,85,23,17,6,1
SBI28EYE6944222,70,30,19,11,1
SBI06SGA8230101,23,38,24,14,1
SBI11URF2905215,67,28,23,5,1
SBI25JFK5257317,94,38,28,10,1
SBI57KXO3962184,71,15,14,1,1
SBI12PRC9132947,70,28,23,5,1
SBI62FDN8306701,25,23,13,10,1
SBI24BUQ3453841,20,25,18,7,1
SBI04YBE3111051,65,23,12,11,1
SBI20KGU3970699,62,23,18,5,1
SBI00VEX9796776,75,24,20,4,1
SBI28SYC2487947,80,23,12,11,1
SBI83GJG8569332,78,23,13,10,1
SBI77WSC9120060,60,23,22,1,1
SBI32OAW9650273,85,33,26,7,1
SBI28DKQ4699226,79,25,21,4,1
SBI49PWR7332870,77,20,12,8,1
SBI42VBU6904072,95,21,20,1,1
SBI01IQS3593656,66,39,21,18,1
SBI73SLU3115747,24,25,16,9,1
SBI28ZGU0128903,84,33,25,8,1
SBI84ELG7788923,24,24,22,2,1
SBI55REH2431610,87,18,17,1,1
SBI85NZS3489703,68,23,13,10,1
SBI87FNO1031935,84,28,18,10,1
SBI39ZGL5837714,71,27,25,2,1
SBI98DCV5063508,60,18,11,7,1
SBI91HSO2365476,89,20,11,9,1
SBI60VLS5490779,95,25,16,9,1
SBI85VRR4634289,79,32,29,3,1
SBI12PQU8338777,81,27,20,7,1
SBI89CPC8270276,77,30,29,1,1
SBI99CTF6090710,64,23,20,3,1
SBI36TEE1478789,23,25,23,2,1
SBI44XQZ6475162,97,26,21,5,1
SBI24YSC7294722,69,33,29,4,1
SBI91DZR1951057,90,29,15,14,1
SBI28YAM1587147,68,23,15,8,1
SBI04ACG0593663,78,27,15,12,1
SBI93OYH0105269,77,24,22,2,1
SBI77LXS9647063,83,22,21,1,1
SBI66MCW1940300,95,23,19,4,1
SBI40CCW4388615,94,23,18,5,1
SBI66LMO4476342,80,24,22,2,1
SBI59LAR3047746,63,24,21,3,1
SBI85DGA3789639,92,21,18,3,1
SBI02KPR3789650,67,24,22,2,1
SBI76FNL4882185,92,30,22,8,1
SBI07NWX9348056,65,28,20,8,1
SBI71SUQ1440688,87,23,17,6,1
SBI97GQS5511828,23,22,13,9,1
SBI52UNY3913740,64,24,20,4,1
SBI84NCY4604306,89,23,17,6,1
SBI21KWH6474726,97,15,13,2,1
SBI16VUY3241323,65,32,23,9,1
SBI30ALE1651209,92,25,16,9,1
SBI90ZBR8971534,71,24,14,10,1
SBI68VFR6294155,60,15,11,4,1
SBI15VDB0875559,72,23,19,4,1
SBI60FCW2876857,78,25,13,12,1
SBI78ONP0535781,88,35,31,4,1
SBI40HXY3021068,64,20,19,1,1
SBI40YTR0607328,76,27,20,7,1
SBI14NKX4899337,97,32,26,6,1
SBI63PLM4271542,71,22,17,5,1
SBI13YBZ7290076,25,26,19,7,1
SBI71BLE4530998,80,18,17,1,1
SBI61SVA0210682,68,20,13,7,1
SBI40QBJ5485644,84,23,14,9,1
SBI54NQY9901540,77,21,12,9,1
SBI91UJE2167865,65,29,28,1,1
SBI11BEB4798213,95,30,18,12,1
SBI24MNX2256965,82,22,13,9,1
SBI11UQF6296568,97,25,14,11,1
SBI84EEO6653888,93,23,20,3,1
SBI50GFD1871899,91,19,13,6,1
SBI25QHZ5831521,71,25,19,6,1
SBI23ITO2680674,85,28,19,9,1
SBI54HNI5548755,98,23,15,8,1
SBI59RDY2572216,81,27,23,4,1
SBI09KAU6260624,98,23,21,2,1
SBI00DGB3540922,89,16,9,7,1
SBI73SJT3413025,97,35,30,5,1
SBI95QNB7797329,94,36,28,8,1
SBI94MRQ2301644,61,31,16,15,1
SBI70UXF9549706,65,20,13,7,1
SBI89QKR8206660,98,24,14,10,1
SBI74UKC5155444,84,21,20,1,1
SBI75WBJ6661805,86,25,19,6,1
SBI05ZVL0948860,24,31,20,11,1
SBI37ELN4686342,72,23,15,8,1
SBI93OTC4620597,65,25,17,8,1
SBI53OIM9521955,75,16,14,2,1
SBI22PGI5400176,76,36,23,13,1
SBI81ZBD4064251,98,21,16,5,1
SBI36FLL8945852,62,30,20,10,1
SBI13MFM4036115,21,22,16,6,1
SBI05YYO1887341,23,28,23,5,1
SBI42CLP6746473,81,26,25,1,1
SBI50SRZ0710958,21,30,16,14,1
SBI16RLF7410210,92,18,12,6,1
SBI73LTW8537696,61,34,25,9,1
SBI09UYN0022701,88,21,17,4,1
SBI98QGF4960568,66,29,25,4,1
SBI87WIF2925972,80,23,12,11,1
SBI90BWT8809379,20,24,20,4,1
SBI20CTJ5185214,78,33,20,13,1
SBI88ZQA4171899,86,20,11,9,1
SBI90RST3562686,76,27,19,8,1
SBI76AKT8537053,91,32,29,3,1
SBI26FNR6850216,73,19,11,8,1
SBI92CRC1373920,97,25,20,5,1
SBI42UQN0651564,97,26,24,2,1
SBI44PFO1990701,20,19,18,1,1
SBI16BWL5891046,99,24,22,2,1
SBI31LUP3379873,80,23,18,5,1
SBI41ZCK3924967,86,16,15,1,1
SBI43PME8323616,67,29,27,2,1
SBI85JNZ0782593,65,22,16,6,1
SBI48TPI6853882,70,35,26,9,1
SBI78OQR5816416,90,28,17,11,1
SBI14XRV1955839,98,26,14,12,1
SBI41YKT7432034,65,21,19,2,1
SBI66KDX3727133,69,24,18,6,1
SBI07MJW1831001,25,15,9,6,1
SBI35ONQ5546032,88,19,17,2,1
SBI82PLG8310626,68,27,24,3,1
SBI14XNC0564575,61,39,36,3,1
SBI64OOU1054974,78,20,19,1,1
SBI66URD4484652,60,28,17,11,1
SBI94ZJV6355015,82,24,21,3,1
SBI09DEV0652537,82,20,15,5,1
SBI78DXS1799096,91,29,18,11,1
SBI27RYM5592475,70,18,12,6,1
SBI32PKS3771779,19,19,10,9,1
SBI99DXC6863427,99,26,19,7,1
SBI41BVG7697235,62,31,23,8,1
SBI98QUL0987292,19,37,22,15,1
SBI05JEZ1895079,72,29,26,3,1
SBI96WHA8497385,72,28,26,2,1
SBI35PTZ8773373,78,26,17,9,1
SBI45BCP7128079,93,22,12,10,1
SBI76EAP3782544,93,23,21,2,1
SBI65AQI7806540,61,23,21,2,1
SBI55AEI9781105,88,22,15,7,1
SBI65LUJ9670760,65,31,16,15,1
SBI70XOX2851277,64,25,18,7,1
SBI88SNT1586271,99,29,24,5,1
SBI14VVX7116350,65,35,31,4,1
SBI98GAX3298118,92,22,19,3,1
SBI47PGJ4366661,62,30,21,9,1
SBI58ARX6561033,79,21,17,4,1
SBI88CJA5588877,98,28,27,1,1
SBI46OFQ9930023,21,21,15,6,1
SBI44ZNM1915219,88,21,20,1,1
SBI05PIB0477898,68,21,12,9,1
SBI38MWL6264851,84,26,15,11,1
SBI90ZQT0526870,61,27,25,2,1
SBI06XRI5803306,64,19,16,3,1
SBI27MED2808052,65,35,21,14,1
SBI24ABQ8403977,73,23,19,4,1
SBI53KRK3158084,74,16,11,5,1
SBI21WDB9125803,60,26,14,12,1
SBI53CHX0434174,25,15,12,3,1
SBI52RVH5016293,90,18,15,3,1
SBI77MEA8083295,92,29,18,11,1
SBI47XOB6400510,93,34,33,1,1
SBI57TNB4101563,88,27,14,13,1
SBI75XXJ3690035,84,20,15,5,1
SBI43CXJ9107008,70,24,23,1,1
SBI64YGU4180259,72,24,19,5,1
SBI56NNS3096588,72,16,15,1,1
SBI88UUF3288973,77,22,19,3,1
SBI47ZDK9164159,65,29,24,5,1
SBI34TCY8733989,19,20,16,4,1
SBI93UCF5068257,96,29,28,1,1
SBI46LEN9168159,99,22,16,6,1
SBI27SOC2808661,62,24,15,9,1
SBI82DAH5985815,85,24,21,3,1
SBI27SZQ2582867,94,22,13,9,1
SBI30GLY8013753,96,20,11,9,1
SBI86CDY2791112,73,21,20,1,1
SBI83ARM0083277,72,29,24,5,1
SBI80TUO8861018,78,21,12,9,1
SBI31FUV9306179,71,25,16,9,1
SBI82JRV2756487,70,24,19,5,1
SBI29ULJ7842832,82,24,13,11,1
SBI85IQN9043060,22,22,21,1,1
SBI58GVM0260785,62,17,16,1,1
SBI83UVM8183774,92,21,12,9,1
SBI35ZRN4050487,91,24,15,9,1
SBI64DWH9355718,65,14,12,2,1
SBI95GQU7221716,61,27,22,5,1
SBI91COC1839944,68,26,20,6,1
SBI48AJC9933208,71,20,14,6,1
SBI73GDU0182580,98,21,17,4,1
SBI56LSI8456344,65,24,18,6,1
SBI69FEZ1853686,62,32,17,15,1
SBI99ITO7380147,70,22,16,6,1
SBI89ZAS0005813,89,27,14,13,1
SBI11OXA6541959,85,29,25,4,1
SBI11AQA9142060,64,30,20,10,1
SBI73OMH1368763,61,17,14,3,1
SBI60GKE6734627,69,19,12,7,1
SBI28QPV8170196,76,15,9,6,1
SBI57ZXC4250871,70,21,20,1,1
SBI57GWS0560572,79,26,14,12,1
SBI93KKO9659964,21,26,19,7,1
SBI53IHD7580754,74,29,22,7,1
SBI50YET1389120,83,25,18,7,1
SBI45QPO6047472,80,25,16,9,1
SBI42MWQ3545127,64,24,22,2,1
SBI80ERK6251734,90,30,21,9,1
SBI59FWD3720434,62,28,16,12,1
SBI94MXV7362733,76,27,15,12,1
SBI13MNY9224799,67,24,19,5,1
SBI73VHP4173921,76,27,19,8,1
SBI14CBQ3978017,72,27,24,3,1
SBI34LZV0927733,74,34,26,8,1
SBI90HOK2824956,89,31,27,4,1
SBI78BRK1281056,68,27,18,9,1
SBI49GDE6980749,88,21,12,9,1
SBI05ECA3868325,89,20,16,4,1
SBI19NKE0455931,62,23,12,11,1
SBI60SMY5886903,95,20,12,8,1
SBI37PNU8612369,71,23,14,9,1
SBI40GHX8157481,66,32,31,1,1
SBI38IRT9496423,82,32,27,5,1
SBI87PFD7992053,62,16,14,2,1
SBI21TZN7687357,82,13,12,1,1
SBI58FIQ4833904,95,26,25,1,1
SBI21FLT9880038,68,19,17,2,1
SBI59GFC5022377,72,20,12,8,1
SBI74WAO3761869,66,29,19,10,1
SBI56XVW1230195,25,21,18,3,1
SBI38FJE3641998,86,19,18,1,1
SBI80EYC3917855,84,28,22,6,1
SBI92VUM0627687,89,29,27,2,1
SBI01HMN4067190,84,29,24,5,1
SBI47IRS6647066,76,27,23,4,1
SBI06GAL0180794,60,23,15,8,1
SBI93SWW0149720,19,31,17,14,1
SBI87HDN9508052,68,27,15,12,1
SBI76MNF5833040,99,28,19,9,1
SBI84HOS7933361,81,28,26,2,1
SBI15IQV2516062,77,24,19,5,1
SBI83NKH6542440,71,19,18,1,1
SBI69PTR9338115,62,27,20,7,1
SBI55ZTF6286577,86,29,15,14,1
SBI59LXB6084778,83,21,17,4,1
SBI52AWH9577932,18,24,19,5,1
SBI40NMR3038270,23,31,21,10,1
SBI84IQD7015695,71,30,19,11,1
SBI26RFG0691457,20,19,13,6,1
SBI67AES2788235,90,28,18,10,1
SBI27AEP9830062,64,18,12,6,1
SBI17KNZ8981190,22,19,16,3,1
SBI96PVU0674021,74,23,21,2,1
SBI85UXB0615772,22,20,13,7,1
SBI06CZJ4828019,83,19,12,7,1
SBI62UJB2275907,95,28,20,8,1
SBI03IIU9704939,62,29,22,7,1
SBI51RUY3297660,79,26,16,10,1
SBI03ZGE2643013,66,24,19,5,1
SBI84HWG9913928,73,17,16,1,1
SBI94HCU4140926,25,26,21,5,1
SBI19WRN7528444,88,29,17,12,1
SBI99HHW4221668,70,27,25,2,1
SBI63YOP7849382,93,31,29,2,1
SBI00AEX3399455,94,27,22,5,1
SBI59GGC3240188,83,20,15,5,1
SBI08XML9948192,20,22,16,6,1
SBI84CIX6650411,88,28,23,5,1
SBI73GGV8369839,99,25,24,1,1
SBI34MZA6969957,80,24,23,1,1
SBI43QTW7976442,24,19,15,4,1
SBI42ZBO3238166,60,17,12,5,1
SBI84QNN0090346,63,14,8,6,1
SBI25CRM5114872,19,23,21,2,1
SBI96BAR1643518,80,17,11,6,1
SBI83NRE7657156,66,24,14,10,1
SBI49CKQ6036329,61,24,18,6,1
SBI44KFV1129978,88,21,20,1,1
SBI01PEH8759725,67,37,22,15,1
SBI30SPF0868320,67,20,12,8,1
SBI87ZRM2503610,69,29,17,12,1
SBI69KRM1196435,64,30,17,13,1
SBI43DRJ4205641,75,23,19,4,1
SBI28KYY8666414,88,25,23,2,1
SBI95BKZ3541868,93,32,19,13,1
SBI45TUO6065672,89,25,19,6,1
SBI14NXJ0704932,83,33,21,12,1
SBI11BWW0791756,94,35,22,13,1
SBI54AOD3860514,91,29,19,10,1
SBI35DSF1725585,71,22,19,3,1
SBI29HTM0146398,82,30,17,13,1
SBI46CCT9828538,21,25,22,3,1
SBI09RCV2631548,80,19,18,1,1
SBI27XHJ6420864,85,25,17,8,1
SBI56DJR0600959,74,28,15,13,1
SBI98UZF2832787,93,24,16,8,1
SBI10OHI9746266,19,18,17,1,1
SBI28ZQP4868398,71,36,26,10,1
SBI35VVX7455637,89,24,14,10,1
SBI15WPZ2061472,19,16,15,1,1
SBI41PYQ4690526,85,25,20,5,1
SBI87HIN1423939,86,13,12,1,1
SBI10ROH7024697,80,27,19,8,1
SBI73ZAH3115373,98,19,10,9,1
SBI55GUE5631825,93,20,17,3,1
SBI35HHJ7365599,97,19,18,1,1
SBI01BWU7033758,87,24,18,6,1
SBI62NMQ8191701,90,23,14,9,1
SBI75BQV9748611,93,38,29,9,1
SBI79LFI4527929,93,13,10,3,1
SBI01CUL8421517,81,23,15,8,1
SBI00KLT8434727,66,30,25,5,1
SBI02LZA0209139,94,30,18,12,1
SBI82XJT6125280,91,25,23,2,1
SBI52POI9114345,94,19,14,5,1
SBI62KXX7229220,66,22,12,10,1
SBI78JDO4266953,88,18,16,2,1
SBI97UPS6217665,91,27,19,8,1
SBI69HDG8251472,98,28,20,8,1
SBI46ILN0158148,72,33,28,5,1
SBI09PYV4770383,91,19,10,9,1
SBI65NAO9931522,95,21,13,8,1
SBI47YYE6243753,73,19,18,1,1
SBI17ZEN2884975,70,22,14,8,1
SBI26UXT2115311,92,25,17,8,1
SBI84ORM1102017,18,29,21,8,1
SBI73QWX7754442,74,22,19,3,1
SBI39ZOH4707252,19,29,21,8,1
SBI61JNK9693457,97,20,11,9,1
SBI20TDU2650653,68,33,24,9,1
SBI16ZOJ0065719,62,29,26,3,1
SBI82MHT0701675,19,22,16,6,1
SBI58ABI0621149,20,28,18,10,1
SBI77LIV1870435,68,23,16,7,1
SBI61HWJ9554534,90,28,15,13,1
SBI70IWK3913833,80,28,23,5,1
SBI53HVY6603130,85,22,12,10,1
SBI84QKF1699709,60,29,20,9,1
SBI95KSQ3058965,78,31,17,14,1
SBI27JNV5138817,77,28,20,8,1
SBI37PQJ6932580,73,33,19,14,1
SBI48XET2817953,93,24,19,5,1
SBI07CVR1972608,25,26,14,12,1
SBI57XNZ8520908,89,13,8,5,1
SBI77SUE7802521,62,26,24,2,1
SBI94OJH7668509,95,25,21,4,1
SBI31NEV5036381,89,24,16,8,1
SBI94TGT5464515,71,20,12,8,1
SBI71OLT8845147,24,25,13,12,1
SBI92PMC1695084,92,34,26,8,1
SBI05UDH0614843,72,26,16,10,1
SBI62WZA9561775,60,24,20,4,1
SBI92YCP2383603,64,29,23,6,1
SBI64OHO1360932,18,28,24,4,1
SBI49BGO1700578,87,23,16,7,1
SBI56VUD4999063,18,28,16,12,1
SBI94VOE3260490,20,27,17,10,1
SBI58JMQ2412858,99,25,24,1,1
SBI19VCK5214343,85,29,22,7,1
SBI36QEM1610240,23,29,16,13,1
SBI57OKS5436637,86,22,17,5,1
SBI88RDI1582197,95,25,14,11,1
SBI69QIZ8557540,98,24,16,8,1
SBI16WND2679892,18,30,27,3,1
SBI36LYY6773886,64,29,16,13,1
SBI19GOK7993659,90,24,19,5,1
SBI01EVK9713524,75,32,28,4,1
SBI03VDF3002421,83,24,19,5,1
SBI06VLO8365543,75,17,9,8,1
SBI13JDJ4331736,88,23,20,3,1
SBI95BLJ5066109,64,26,23,3,1
SBI94WXB4861532,88,29,25,4,1
SBI64UCR3727937,72,25,18,7,1
SBI83CBV3236935,75,27,14,13,1
SBI26UGT0356501,62,20,12,8,1
SBI07PIG9008514,95,23,22,1,1
SBI56YXQ0519201,74,22,16,6,1
SBI88MIB3293151,86,26,18,8,1
SBI26KZY0335378,63,16,11,5,1
SBI92ALB2077393,76,19,10,9,1
SBI88WKK8901042,24,33,23,10,1
SBI58PFV5154803,62,25,15,10,1
SBI04DBX5258512,76,30,28,2,1
SBI58TGQ3408155,86,22,17,5,1
SBI79ESR2397834,64,27,14,13,1
SBI37KRO8919624,24,25,15,10,1
SBI44RKN5564301,64,26,14,12,1
SBI06UGI1251030,24,21,14,7,1
SBI65OVL9084569,77,22,12,10,1
SBI46OWQ0159326,20,23,12,11,1
SBI77ASM8522530,89,30,17,13,1
SBI66QEX3789337,93,33,29,4,1
SBI14RMV4544004,92,29,27,2,1
SBI43OTZ6356169,61,23,20,3,1
SBI38CSZ9194432,75,28,27,1,1
SBI81NAM2850360,65,22,16,6,1
SBI26UTO3736164,23,20,17,3,1
SBI31BXX4985186,71,18,17,1,1
SBI96FCU7052714,89,27,18,9,1
SBI89HXU7465406,18,25,14,11,1
SBI37SFH6083477,98,30,19,11,1
SBI16HWE4543168,72,21,14,7,1
SBI62AAG9484287,63,26,21,5,1
SBI20AEA5771511,85,18,15,3,1
SBI59FVW8222159,84,13,10,3,1
